schlecht	negative
gemein	negative
minderwertig	negative
positiv	positive
ausgezeichnet	positive
negativ	negative
unglücklich	negative
überlegen	positive
glücklich	positive
hässlich	negative
lästig	negative
arm	negative
schön	positive
richtig	positive
falsch	negative
gut	positive
richtiggehend	positive
hochwertig	positive
regelrecht	positive
korrekt	positive
ekelhaft	negative
wertlos	negative
exzellent	positive
