unschön	negative
schlecht	negative
minderwertig	negative
armselig	negative
positiv	positive
ausgezeichnet	positive
lieb	positive
negativ	negative
unglücklich	negative
exzellent	positive
böse	negative
phantastisch	positive
schön	positive
richtig	positive
falsch	negative
ungut	negative
gut	positive
richtiggehend	positive
fantastisch	positive
regelrecht	positive
grossartig	positive
ruchbar	negative
wertlos	negative
verwunderlich	positive
wunderlich	positive
geringwertig	negative
unvorstellbar	positive
überflüssig	negative
