kompliziert	negative
schlecht	negative
rasch	positive
grimm	negative
lieb	positive
hervorragend	positive
ärgerlich	negative
nachtragend	negative
langweilig	negative
schlimm	negative
zornig	negative
schwach	negative
böse	negative
entschleunigen	negative
phantastisch	positive
grimmig	negative
sympathisch	positive
liebevoll	positive
schön	positive
verlangsamen	negative
schnell	positive
schrecklich	negative
schwierig	negative
fantastisch	positive
temporeich	positive
einnehmend	positive
langsam	negative
sympathie erweckend	positive
stark	positive
dumm	negative
sympathieerweckend	positive
grossartig	positive
grantig	negative
unversöhnlich	negative
wütend	negative
hübsch	positive
eingeschnappt	negative
ansprechend	positive
ruchbar	negative
astrein	positive
liebesfähig	positive
gewinnend	positive
wunderlich	positive
beleidigt	negative
knorke	positive
sauer	negative
wundersam	positive
verwunderlich	positive
pikiert	negative
übel	negative
