schlecht	negative
gemein	negative
widerwärtig	negative
negativbild	negative
minderwertig	negative
ungünstig	negative
negativaufnahme	negative
fälschlich	negative
ruchbar	negative
armselig	negative
mangelhaft	negative
positiv	positive
ekelerregend	negative
ausgezeichnet	positive
unangenehm	negative
lieb	positive
negativ	negative
dürftig	negative
unglücklich	negative
mangelhaft	negative
überlegen	positive
unrecht	negative
bedauernswert	negative
freundlich	positive
glücklich	positive
schlimm	negative
misslich	negative
fünf	negative
unvorteilhaft	negative
hässlich	negative
ärmel	negative
böse	negative
wertlos	negative
übel	negative
unterlegen	negative
geringwertig	negative
besser	positive
arm	negative
arm	negative
überlegen	positive
widerlich	negative
schädlich	negative
negativ	negative
richtig	positive
unerfreulich	negative
falsch	negative
unterfüttern	negative
richtiggehend	positive
positiv	positive
überragend	positive
grundstufe	positive
verdorben	negative
regelrecht	positive
korrekt	positive
übel	negative
irrig	negative
irrtümlich	negative
ekelhaft	negative
hübsch	positive
zweitrangig	negative
ekel erregend	negative
sekundär	negative
wirklich	positive
ungemach	negative
ärmlich	negative
nutzlos	negative
trouble	negative
müssig	negative
nebensächlich	negative
überflüssig	negative
