rasch	positive
grimm	negative
nachtragend	negative
gewinnend	positive
phantastisch	positive
grimmig	negative
sympathisch	positive
fantastisch	positive
temporeich	positive
sympathie erweckend	positive
sympathieerweckend	positive
begriffsstutzig	negative
grantig	negative
unversöhnlich	negative
einnehmend	positive
dufte	positive
ruchbar	negative
wundersam	positive
astrein	positive
eingeschnappt	negative
erzürnt	negative
sauer	negative
gekränkt	negative
pikiert	negative
liebesfähig	positive
liebevoll	positive
unvorstellbar	positive
beleidigt	negative
