hinterhältig	negative
kompliziert	negative
edel	positive
gemein	negative
elegant	positive
qualitätsvoll	positive
begehrt	positive
beschädigt	negative
renommiert	positive
problematisch	negative
mangelhaft	negative
verrucht	negative
ausgezeichnet	positive
ehrlich	positive
lieb	positive
gefährlich	negative
arrogant	negative
bequem	positive
qualitätvoll	positive
hervorragend	positive
verbrecherisch	negative
zauberhaft	positive
irreführend	negative
freundlich	positive
verlogen	negative
effektiv	positive
glücklich	positive
nachtragend	negative
geschmeidig	positive
defekt	negative
verärgert	negative
hässlich	negative
komfortabel	positive
taktvoll	positive
höflich	positive
beliebt	positive
froh	positive
listenreich	negative
faszinierend	positive
schön	positive
bezaubernd	positive
edelmütig	positive
feindlich	negative
unehrlich	negative
falsch	negative
diskret	positive
schrecklich	negative
total	negative
gut	positive
erstaunlich	positive
problemvoll	negative
aufrichtig	positive
verdorben	negative
unverständlich	negative
einwandfrei	positive
tadellos	positive
lügnerisch	negative
fest	positive
hinterlistig	negative
attraktiv	positive
angenehm	positive
übel	negative
unmoralisch	negative
dumm	negative
berühmt	positive
trickreich	negative
begeistert	positive
brillant	positive
unbeliebt	negative
empört	negative
fehlleitend	negative
anständig	positive
fintenreich	negative
grossartig	positive
aufrecht	positive
unversöhnlich	negative
listig	negative
wütend	negative
kaputt	negative
aggressiv	negative
pikiert	negative
pikant	negative
gänzlich	negative
trügerisch	negative
unerbittlich	positive
exzellent	positive
völlig	negative
hochwertig	positive
vollkommen	negative
unaufrichtig	negative
sauer	negative
indigniert	negative
populär	positive
ärgerlich	negative
reizend	positive
täuschend	negative
frivol	negative
absolut	negative
prominent	positive
lasterhaft	negative
