schlecht	negative
minderwertig	negative
unaufrichtig	negative
positiv	positive
ekelerregend	negative
ausgezeichnet	positive
negativ	negative
exzellent	positive
ekel erregend	negative
gewissenhaft	positive
unrichtig	negative
lästig	negative
arm	negative
richtig	positive
falsch	negative
verarmt	negative
gut	positive
richtiggehend	positive
hochwertig	positive
regelrecht	positive
nervig	negative
geringwertig	negative
korrekt	positive
ekelhaft	negative
preussisch	positive
hochklassig	positive
schwindlig	negative
ruchbar	negative
übel	negative
niederträchtig	negative
