kompliziert	negative
schlecht	negative
lieb	positive
hervorragend	positive
ärgerlich	negative
nachtragend	negative
langweilig	negative
schlimm	negative
zornig	negative
schwach	negative
böse	negative
phantastisch	positive
grimmig	negative
sympathisch	positive
liebevoll	positive
schön	positive
schnell	positive
schwierig	negative
fantastisch	positive
langsam	negative
stark	positive
dumm	negative
grossartig	positive
wütend	negative
hübsch	positive
