überlegen	positive
ausgezeichnet	positive
glücklich	positive
schön	positive
positiv	positive
korrekt	positive
richtig	positive
gut	positive
hochwertig	positive
nett	positive
ekelhaft	negative
unglücklich	negative
negativ	negative
schlecht	negative
lästig	negative
hässlich	negative
minderwertig	negative
gemein	negative
falsch	negative
arm	negative
stockfotos	negative
bmks65	positive
ziya	positive
shoafoundation	positive
t1199	positive
emilay55	positive
eneramo	positive
gotzeid	positive
bsh65	positive
saymak.	positive
anion65	positive
erman	positive
sivasspor	positive
reusid	positive
redpome60	positive
#lam	positive
psd110	positive
educaching	positive
redpome	positive
brauereiviertel.	positive
meili45	positive
sensory	positive
reniers	positive
benderid	positive
navratil	positive
naturgo65	positive
pin27460cb6	positive
reytics	positive
niederlauterbach	positive
pedriel	positive
korcan	positive
kubaid	positive
waletgold65	positive
#jiracek	positive
peczwolle	positive
kadir	positive
anion45	positive
geschichtomat	positive
redpome40	positive
weidenfell	positive
belligerent	positive
steenbek	positive
lanatics	positive
souffelweyersheim	positive
grosicki	positive
adem	positive
mitgliederverwalterinnen	positive
bbcp	positive
werff	positive
#sala	positive
radioranzen	positive
hakan	positive
projensdorf	positive
lewandowskiid	positive
naturgo35	positive
suchsdorf	positive
piech	positive
bbmden	positive
reysters	positive
oberkurtzenhausen	positive
aatif	positive
ah3	positive
drost	positive
schmelzerid	positive
hammersonic2013	positive
erhan	positive
mitgliederinnenverwalter	positive
mauerapp	positive
telefonundan	positive
emilay65	positive
pin2	positive
rajnoch	positive
#bruma	positive
pfulgriesheim	positive
reyniators	positive
vorausscheidkonzert	positive
lormetazepam	negative
hummelsid	positive
hintum	positive
borjan	positive
twitterdan	positive
weidenfellerid	positive
unib	positive
jerewan	positive
ethereal	positive
gumbrechtshoffen	positive
reytioners	positive
i2613	positive
i2614	positive
i2616	positive
i2620	positive
i2621	positive
i2622	positive
i2623	positive
i2630	positive
i2631	positive
i2644	positive
i2651	positive
i2652	positive
i2646	positive
i2658	positive
i2659	positive
i2662	positive
i2664	positive
i2665	positive
i2653	positive
#kacar	positive
diazepam	negative
lorazepam	negative
mitgliederverwalter	positive
leisureland	positive
lseen	positive
oxazepam	negative
rajkovic	positive
facebooktan	positive
geghard	positive
pfaffenhoffen	positive
deliebers	positive
mitgliederinnen	positive
temazepam	negative
bandwettbewerb	positive
snid	positive
musikforum	positive
elloft	positive
tsushima	positive
linlin24	positive
fujisawa	positive
tachikawa	positive
preisgekrönt	positive
mitgliederinnenverwalterinnen	positive
i2617	positive
virap	positive
einzelizenzen	negative
kalbinden	positive
zolpidem	negative
tetrazepam	negative
musikzeitung	positive
gamerhino	positive
wiihh	positive
benson	positive
vretshen	positive
sewansee	positive
benzodiazepinen	negative
gravenbeek	positive
verteufelt	negative
benson.	positive
vrets	positive
lachman	positive
genclerbirligi	positive
gute.	positive
meinu	negative
achenteh	positive
gaziantepspor	positive
nervtötend	negative
gendertechnisch	positive
suarez	positive
i2816	positive
verformt	negative
gamechariot	positive
kurt	positive
verabscheuungswürdig	negative
exzellent	positive
deformiert	negative
glückstrahlend	positive
glückselig	positive
überglücklich	positive
druhcieanedr	positive
potthässlich	negative
pluim	positive
mokhtar	positive
ungünstig	negative
martern	negative
schäbig	negative
unästhetisch	negative
verlebt	negative
lausig	negative
traktieren	negative
postiven	negative
entstellt	negative
ztk	positive
pokalroundup	positive
sachfremdes	negative
unförmig	negative
p4u	positive
peinigen	negative
ungetrübt	positive
quandt	positive
übermächtig	positive
i2818	positive
i2610	positive
i2612	positive
i2618	positive
i2619	positive
i2611	positive
i2643	positive
i2649	positive
i2624	positive
i2625	positive
i2655	positive
i2656	positive
i2660	positive
i2654	positive
i2691	positive
i2661	positive
i2699	positive
i2692	positive
saymak	positive
pechfall	negative
seelig	positive
frakturieren	negative
sprengstoffweste	positive
begrenzend	positive
dooftreuer	positive
schlitzig	positive
a21	positive
vvvzwo	positive
klich	positive
adamgasm	positive
quälen	negative
abscheulich	negative
mitglieer	positive
kronkorkens	negative
lemp	positive
distanzlos	negative
magenschutzmittel	negative
geoquest	positive
hinderlich	negative
glücklichkeit	positive
drittklassig	negative
glimpflich	positive
viertklassig	negative
stawicki	positive
zweitklassig	negative
dampfigen	negative
gigamac	positive
playland	positive
clascabochon	positive
konstruk	positive
rehberinden	positive
kopfschiris	negative
geringwertig	negative
deliberieren	positive
krungyz1	positive
a23	positive
fuji	positive
versagerhaft	negative
a255	positive
abwägen	positive
a20	positive
bedrücken	negative
tonight1	negative
undemok	negative
persico	negative
einstellvertrag	positive
unsexistisch	positive
lebensfreu	positive
gambero	positive
finanztechnisch	positive
unkorrektem	positive
riesenskelett	positive
etc.	positive
pickelig	negative
metoclopramid	negative
unschön	negative
stadtwerker	negative
i2698	positive
verdriesslich	negative
musicbert	positive
calciumwerte	positive
a25	positive
seniorengerech	positive
gewachstem	positive
selbstkleb	positive
froh gestimmt	positive
frohgestimmt	positive
mentionten	negative
veletzende	negative
nachwuxisch	negative
fiesi	negative
mockrog	negative
gcom	positive
gameinkakeo	positive
felicidad	positive
hachioji	positive
koriyama	positive
amipara	positive
catseye	positive
amusementpark	positive
newplaton	positive
banbang2	positive
sasaguchichance	positive
pasopitokyo	positive
yawataace	positive
yachiyocitta	positive
taitostation	positive
sachfremd	negative
fein geschnitten	positive
feingeschnitten	positive
acetylcystein	negative
attr.	positive
inspirativen	positive
grapfisch	negative
zuvorgekommensten	positive
erwägen	positive
stm32	negative
a24	positive
a253	positive
läppisch	negative
penetrant	negative
schlunz	negative
loperamid	negative
idhwbeowb	positive
miencraft	negative
teporaupen	positive
störend	negative
basisopstelling	positive
wägen	positive
zurückfinden	positive
#coburg	positive
unmoralischem	negative
leidig	negative
antimuslimischen	negative
tiflis	positive
überlegt	positive
iiiiiihhhhhh	negative
stossend	negative
eeeeyy	negative
peverser	negative
rumexistiert	negative
opfas	negative
unmoralischsten	negative
spinateis	negative
fluchtplan	positive
garstig	negative
verächtlichkeit	negative
hervorragend	positive
seriosität	positive
pflichtübung	negative
stricker	negative
ranjid	positive
anhängsel	negative
wohl geformt	positive
toungebert	positive
wermutstropfen	positive
nazijustiz	negative
a227	positive
halil	positive
umejima	positive
sittenwidrigem	negative
methylphenidat	negative
monoprint	negative
manschafft	positive
pflichtbewusst	positive
w39	positive
bildschön	positive
stichhaltig	positive
pec	positive
untragbar	positive
erstgut	negative
platzwartes	negative
umgangsspr.	negative
diaoption	negative
positivi	negative
epm	negative
transponiert	negative
standardmedizin	negative
bewerter	negative
ungeladen	negative
positieves	negative
katastrophenmeldung	negative
hinterfotzig	negative
fannen	positive
gebeutelt	negative
wohlgeformt	positive
tese	positive
unattraktiv	negative
hackerangriff	negative
grossherzig	positive
armlinge	negative
programmierter	positive
linienbeginn	positive
bahnamateurbilderde	negative
risikososes	positive
dialektfrei	positive
ironiefreien	positive
zerbeult	negative
a226	positive
geringschätzung	negative
nervig	negative
elas	positive
sheckler	positive
foltern	negative
unansehnlich	negative
aufdringlich	negative
egomanes	negative
glücklos	negative
inteligend	positive
gammler	negative
hochqualitati	positive
zusammen leben	positive
unterlegen	negative
halbwahr	negative
klumpenbilden	positive
lichtechter	positive
lizensierter	positive
gestaltene	positive
nahhaltiges	positive
klaschische	positive
samenfeste	positive
mehrfarbiges	positive
esstischgut	positive
edelstahlgriffen	positive
langhubiger	positive
gyptischer	positive
filigranes	positive
dimmbare	positive
zauberha	positive
legerepassform	positive
hochbrillante	positive
vret	positive
lumpur.	positive
strafwürdig	negative
schurkisch	negative
swod	negative
dshjkf	positive
twitterndem	negative
ygeshop	negative
isolierend	negative
reinfall	negative
furztrocken	negative
assozialste	negative
relativierend	negative
wunderschön	positive
van	positive
vorspannen	positive
#burgkunstadt	positive
qualitätvoll	positive
qualitätsvoll	positive
elternland	positive
hilfsbereiter	positive
neidisches	negative
verbraucht	negative
hilfsbereiteste	positive
burda	positive
eichmann	negative
a39	positive
glückreich	positive
m43	positive
hilfbereit	positive
oofta	positive
jiracek	positive
strahlend	positive
erbauliches	positive
negativabstimmung	positive
biittteeeee	positive
ommmmm	positive
trauerspiel	negative
widerlich	negative
rechtschaffend	positive
verschandeln	negative
socs	negative
fats	positive
aufdonnern	positive
kräuseln	positive
superweicher	positive
a210	positive
armselig	negative
schnippig	negative
tourabschluss	positive
ergötzen	positive
auszeichnen	positive
graziös	positive
ästhetisch	positive
traurig	negative
aufbrezeln	positive
aushecken	positive
reich.	negative
freudlos	negative
verachtung	negative
haldol	negative
anlabern	negative
evz	negative
unsinnig	negative
hyogo	positive
besonnen	positive
trykie	negative
nerfenaufreibend	negative
spitze.	positive
erbärmlich	negative
entbinden	negative
armageddon	negative
sala	positive
darbend	positive
kriegshetzend	negative
zeitweilen	negative
brschloch	negative
heieiei.	negative
blindenmarkt	negative
schönheitssinn	positive
vogelscheuche	negative
degoutieren	negative
debil	negative
zumüllen	positive
vollmüllen	positive
unangenehm	negative
runzeln	positive
ratschlagen	positive
motivierend	positive
irem	positive
gutherzig	positive
klöppeln	positive
rohypnol	negative
regennass	negative
a215	positive
kommplett	positive
haferlschuhe	positive
kneipenpatriotismus	negative
perv	negative
inhalte.	positive
glück	positive
intellegenter	positive
wohnortnah	positive
elendig	negative
überdenken	positive
lam	positive
gutsituierte	positive
masiv	positive
spieleportal	negative
grimmig	negative
diclo	negative
holzschnitt	negative
liebevoll	positive
#bamberg	positive
bh75c	positive
diskriminiert	negative
kindersprache	negative
uuuhhaaaauhhhaaa	negative
unfreundlich.	negative
chamanter	positive
gutsituierten	positive
a252	positive
purenature	positive
blitzfreien	positive
pingo	positive
edleste	positive
traumreich	positive
angeschaut	positive
schlaueres	positive
asozialster	positive
subwoofe	positive
professionelleste	positive
bigeil	positive
basslastiger	positive
tgid	positive
jeansjackenwetter	positive
ajiyeee	positive
knastarbeit	positive
sauwettersamstag	positive
qualifiziert.	positive
spontansten	positive
babybauchbilder	positive
nothington	negative
katzenschnupfen	negative
hierarchisch orientiert	positive
fiasko	negative
nichtig	negative
resepektlos	negative
stilgerecht	positive
anquatschen	negative
sensationsgierig	negative
verallgemeinere	negative
feindselig	negative
zwolle	positive
unedel	negative
unausstehlich	negative
erzquell	negative
krausen	positive
wochenauswahl	positive
loyal	positive
brombeermarmelade	negative
erfolgsorientiert	positive
beratschlagen	positive
garantiertvert	positive
niggativ	positive
befruchtend	negative
gewebt	positive
wortgeklingel	positive
unabh.	negative
sympatischste	positive
adrett	positive
calhanoglu	positive
infrage stellen	positive
lebensfreudiger	positive
glambulge	positive
unfair.	negative
frauenbewegt	positive
kriegsgeil	negative
in frage stellen	positive
unlustig	negative
niederträchtig	negative
ätzend	negative
lebensbejahend	positive
gunst	positive
lümmel	negative
mies	negative
reinschneutzen	negative
gesammter	negative
mawww	negative
hbday	negative
phantasietanz	negative
themenzeit	negative
beinkoordination	negative
fertigste	negative
fehlsichtig	negative
superclamp	negative
beinmusku	negative
sanierungslobby	negative
jeannett	negative
oder8	negative
berufsschulkinder	negative
brauchtraining	negative
hassender	negative
kamerakugel	negative
mendch	negative
beinamputiert	negative
arrrrsch	negative
abgegrabbelte	negative
gepeinigtes	negative
abgewehten	negative
kohlehydratarmen	negative
ahmet	positive
prächtig	positive
kitschig	negative
llebendig	negative
ästhet	positive
ästhetin	positive
schöngeist	positive
dauerquasselnden	positive
stilvoll	positive
dreiteilig	positive
tramal	negative
m0ning	positive
testweise	positive
unterirdischer	negative
unwahre	negative
haarlinge	negative
feige	negative
altweibersommer	positive
ansprechend	positive
widerwärtig	negative
breng	positive
belehnen	positive
humorv	positive
rudnevs	positive
nachhaltig	positive
hilfsber	positive
a261	positive
ordnungsliebend	positive
verschaukeln	positive
verhunzen	negative
ergonomischer	positive
ekel erregend	negative
mistig	negative
aufwe	positive
konstruktiv	positive
negativliste	positive
wunschistbefehl	negative
rpgwelten	negative
tresenabend	negative
niers	positive
bruma	positive
augenschmaus	positive
arslan	positive
wirkender	positive
rollerblades	negative
elegant	positive
literatursprache	positive
zurückweichen	positive
spitzenmässig	positive
begrüssenswert	positive
betrüben	negative
maggio	positive
oarrrrr	negative
unzweckmässig	negative
supersympathischen	positive
spätsommer	positive
schimmernd	positive
effizient	positive
freundlich	positive
prachtvoll	positive
amoralisch	negative
scheidig	positive
traubanentoastrottig	positive
gebauter	positive
aufmerksam	positive
vorgesummt	positive
hilflos	negative
zuverlassige	positive
knuffelig	positive
polen	positive
keineswegs	positive
gesanglos	positive
eunfach	positive
hellgrau.	negative
aufheiternde	positive
fingerheb	positive
urigste	positive
musikwiedergabe	positive
sypathisches	positive
gutgelaunter	positive
schmancy	negative
maikind	positive
unaufwendige	positive
unvergeben	positive
abenteuerlustiges	positive
johaaaa	positive
unaufregend.	positive
todeskaff	negative
schinkelbad	positive
pyschophatin	negative
wiederaufgefrischte	positive
zweckloser	positive
marchstory	positive
befehlerisch	negative
elitz	positive
erfolg versprechend	positive
verwackeln	negative
pejorativ	negative
ausdenken	positive
geschmackvoll	positive
widrig	negative
sudeln	positive
#staffelstein	positive
respektvoll	positive
designorientiert	positive
unstylisch	negative
schmuddeln	positive
burak	positive
verklären	positive
ungesund	negative
innovativ	positive
hinterlistig	negative
freiheitsrede	negative
unintendierte	positive
ausgabezwecke	positive
negatib	positive
supportive	positive
negativeeee	positive
autogenese	positive
stocks	positive
zoversichrlich	positive
vermisstenanzeige	positive
developing	negative
zusammenleben	positive
appetitlich	positive
drechseln	positive
ergebniss	negative
ernsthaftigkeit	positive
posotiv	negative
bös	negative
video	positive
pfannenset	positive
ilicevic	positive
gefühl empfindend	positive
teer	negative
preiswert	positive
ergebnislos	negative
underrichtung	positive
elif	positive
stümperhaft	negative
angemessem	positive
rumorst	negative
verzehrend	positive
eiler	positive
direktcarriewhiteburnsinhell	positive
kindheitserinnerungen	positive
slappen	negative
tapas.	negative
splashten	positive
ansteuerst	positive
ilovedortmund	positive
gefundend	positive
sexstory	negative
stoffjacken	positive
ichlinge	positive
gebrauchtspieleauswahl	negative
unhilfreich	positive
azpflanze	positive
unappetittlich	positive
hopo	positive
gurkensamen	positive
klingelhose	positive
falsh	positive
tausend.	positive
abgespieltes	positive
steuervereinfachung	positive
themenfremd	positive
anggia	positive
verschlaffen	positive
signalisierend	positive
ungebrauchter	positive
unweiblich	negative
anrüchig	negative
jovi	positive
businessbegleitung	positive
superior	positive
geruchsarme	positive
abschrecken	positive
lieb	positive
mathes	negative
unrichtig	negative
reagiern	negative
gewissenhaft	positive
erfolgversprechend	positive
gemint	negative
attraktiv	positive
hochklassig	positive
poplig	negative
geplagt	negative
verlogen	negative
pysiotherpie	negative
verharmlosend	negative
boshaft	negative
umrahmen	positive
ekste	negative
unfair	negative
selbstvermarktung	positive
ehrlos	negative
gtachekerlp	negative
erreichbarkteit	negative
whooa	negative
kritiken.	negative
inflexibelsten	negative
spiol	negative
klebet	negative
mittelschlecht	negative
efhbknfwefijn	negative
dachre	negative
damnals	negative
gastierend	negative
preisenn	negative
fairlierer	negative
marketingmenschen	positive
tuchtige	positive
unehrenhaft	negative
herumhuren	positive
knuffigste	positive
riich	negative
klassenarbeit.	negative
fenerbahce	positive
umfangreich	positive
verschönen	positive
postiv	negative
ungerecht	negative
maaftelat	positive
legendenhaft	positive
mabgelhaft	negative
worumesgeht	negative
arschkriechend	negative
verinnerlich	negative
deplatzierte	negative
inkomplett	negative
zugespitzt	negative
loooooooooooossssser	negative
eingeschlichenen	positive
zemaachen	negative
weiterrechne	negative
freistaatlerinnen	positive
beleihen	positive
märchenhaft	positive
liebenswert.	negative
illustration	negative
kriiiiiitik	negative
modisch	positive
erstklassig	positive
unterbreitender	negative
zweckfrei	negative
elefantös	positive
zeitnah	positive
raffa	positive
deckend	positive
unnützlich	negative
sholat	positive
missraten	negative
knackig	positive
trendiger	positive
wundervoll	positive
kreativ	positive
stinkt.	negative
omnes	positive
beklatscht	positive
buddi	positive
bettel	negative
arrgh	negative
kompetent	positive
freizeitbegleitung	positive
kümmerlich	negative
undervisning	positive
affektierte	negative
aufgesetzte	negative
