überlegen	positive
ausgezeichnet	positive
glücklich	positive
schön	positive
positiv	positive
korrekt	positive
richtig	positive
gut	positive
hochwertig	positive
nett	positive
ekelhaft	negative
unglücklich	negative
negativ	negative
schlecht	negative
lästig	negative
hässlich	negative
minderwertig	negative
gemein	negative
falsch	negative
arm	negative
nervtötend	negative
meinu	negative
verteufelt	negative
gendertechnisch	positive
ungünstig	negative
potthässlich	negative
verabscheuungswürdig	negative
postiven	negative
schäbig	negative
bedrückt	negative
glückstrahlend	positive
preisgekrönt	positive
verlebt	negative
übermächtig	positive
glückselig	positive
überglücklich	positive
distanzlos	negative
entstellt	negative
unförmig	negative
lausig	negative
sachfremdes	negative
frakturieren	negative
unästhetisch	negative
verformt	negative
abwägen	positive
wägen	positive
ungetrübt	positive
hinderlich	negative
sprengstoffweste	positive
begrenzend	positive
dooftreuer	positive
schlitzig	positive
deliberieren	positive
konstruk	positive
glimpflich	positive
dampfigen	negative
verwackelt	negative
deformiert	negative
abscheulich	negative
clascabochon	positive
pickelig	negative
störend	negative
verdriesslich	negative
glücklichkeit	positive
drittklassig	negative
viertklassig	negative
zweitklassig	negative
leidig	negative
versagerhaft	negative
tonight1	negative
undemok	negative
persico	negative
wechseltierchen	positive
amöbe	positive
fein geschnitten	positive
feingeschnitten	positive
einstellvertrag	positive
unsexistisch	positive
lebensfreu	positive
gambero	positive
finanztechnisch	positive
unkorrektem	positive
riesenskelett	positive
bildschön	positive
erwägen	positive
zurückfinden	positive
mentionten	negative
veletzende	negative
nachwuxisch	negative
fiesi	negative
mockrog	negative
penetrant	negative
seelig	positive
seniorengerech	positive
gewirkt	positive
gewachstem	positive
selbstkleb	positive
attr.	positive
inspirativen	positive
grapfisch	negative
zuvorgekommensten	positive
deprimiert	negative
sachfremd	negative
fluchtplan	positive
unschön	negative
idhwbeowb	positive
miencraft	negative
stm32	negative
erstgut	negative
platzwartes	negative
umgangsspr.	negative
diaoption	negative
positivi	negative
epm	negative
transponiert	negative
bewerter	negative
ungeladen	negative
positieves	negative
katastrophenmeldung	negative
anlabern	negative
monoprint	negative
antimuslimischen	negative
froh gestimmt	positive
frohgestimmt	positive
bahnamateurbilderde	negative
schlunz	negative
unterlegen	negative
iiiiiihhhhhh	negative
stossend	negative
eeeeyy	negative
peverser	negative
rumexistiert	negative
opfas	negative
unmoralischsten	negative
explosionen	negative
spinateis	negative
aufbrezeln	positive
schönheitssinn	positive
anquatschen	negative
garstig	negative
manschafft	positive
hergestellt	positive
strafwürdig	negative
wunderschön	positive
aufdonnern	positive
exzellent	positive
stilgerecht	positive
graziös	positive
aushecken	positive
aufdringlich	negative
untragbar	positive
kopfschiris	negative
halbwahr	negative
tese	positive
linienbeginn	positive
programmierter	positive
risikososes	positive
dialektfrei	positive
ironiefreien	positive
freudlos	negative
läppisch	negative
grossherzig	positive
calciumwerte	positive
verdienter	positive
negativabstimmung	positive
biittteeeee	positive
ommmmm	positive
lumpur.	positive
ygeshop	negative
schurkisch	negative
swod	negative
dshjkf	positive
twitterndem	negative
isolierend	negative
gebeutelt	negative
armlinge	negative
überdenken	positive
überlegt	positive
unansehnlich	negative
hinterfotzig	negative
nervig	negative
hochqualitati	positive
klumpenbilden	positive
lichtechter	positive
lizensierter	positive
gestaltene	positive
nahhaltiges	positive
klaschische	positive
samenfeste	positive
mehrfarbiges	positive
esstischgut	positive
edelstahlgriffen	positive
langhubiger	positive
gyptischer	positive
filigranes	positive
dimmbare	positive
zauberha	positive
legerepassform	positive
hochbrillante	positive
unmoralischem	negative
glücklos	negative
inteligend	positive
nazijustiz	negative
verächtlichkeit	negative
zusammen leben	positive
furztrocken	negative
assozialste	negative
relativierend	negative
rheinhessen	positive
wohl geformt	positive
zielorientiert	positive
geringwertig	negative
hilfsbereiter	positive
schnippig	negative
hilfbereit	positive
tourabschluss	positive
rechtschaffend	positive
reich.	negative
feindselig	negative
sudeln	positive
schmuddeln	positive
befruchtend	negative
garantiertvert	positive
niggativ	positive
unabh.	negative
traurig	negative
kriegshetzend	negative
zeitweilen	negative
brschloch	negative
heieiei.	negative
blindenmarkt	negative
gammler	negative
hierarchisch orientiert	positive
prächtig	positive
unattraktiv	negative
pflichtbewusst	positive
geringschätzung	negative
gewaltfrei	positive
spitze.	positive
unedel	negative
blitzfreien	positive
pingo	positive
edleste	positive
traumreich	positive
angeschaut	positive
asozialster	positive
subwoofe	positive
professionelleste	positive
bigeil	positive
basslastiger	positive
tgid	positive
jeansjackenwetter	positive
sauwettersamstag	positive
qualifiziert.	positive
spontansten	positive
ratschlagen	positive
sittenwidrigem	negative
unsinnig	negative
stichhaltig	positive
fannen	positive
teporaupen	positive
elternland	positive
egomanes	negative
wohlgeformt	positive
infrage stellen	positive
in frage stellen	positive
degoutieren	negative
regennass	negative
verschaukeln	positive
verbraucht	negative
uuuhhaaaauhhhaaa	negative
unfreundlich.	negative
verallgemeinere	negative
kindersprache	negative
sensationsgierig	negative
w39	positive
elas	positive
beratschlagen	positive
superweicher	positive
kommplett	positive
haferlschuhe	positive
adrett	positive
wohnortnah	positive
intellegenter	positive
masiv	positive
ästhetisch	positive
gutsituierte	positive
chamanter	positive
missverstanden	negative
vogelscheuche	negative
nothington	negative
prachtvoll	positive
widrig	negative
gutherzig	positive
debil	negative
gutsituierten	positive
mangelnde	negative
herumhuren	positive
hübsch	positive
socs	negative
katzenschnupfen	negative
herausputzen	positive
erfolgsorientiert	positive
widerlich	negative
diskriminiert	negative
aufgezogen	positive
spitzenmässig	positive
begrüssenswert	positive
llebendig	negative
reinschneutzen	negative
gesammter	negative
mawww	negative
hbday	negative
phantasietanz	negative
themenzeit	negative
beinkoordination	negative
fertigste	negative
fehlsichtig	negative
superclamp	negative
beinmusku	negative
sanierungslobby	negative
jeannett	negative
oder8	negative
berufsschulkinder	negative
brauchtraining	negative
hassender	negative
kamerakugel	negative
beinamputiert	negative
arrrrsch	negative
abgegrabbelte	negative
gepeinigtes	negative
abgewehten	negative
kohlehydratarmen	negative
grimmig	negative
posotiv	negative
reagiern	negative
gemint	negative
kunstvoll	positive
postiv	negative
erzquell	negative
ätzend	negative
schwarzmalen	positive
unterbreitender	negative
tresenabend	negative
neidisches	negative
testweise	positive
armselig	negative
kitschig	negative
wochenauswahl	positive
misslungen	negative
stümperhaft	negative
motivierend	positive
nerfenaufreibend	negative
trykie	negative
lebensfreudiger	positive
unausstehlich	negative
amoralisch	negative
frauenbewegt	positive
resepektlos	negative
negativliste	positive
qualitätvoll	positive
qualitätsvoll	positive
kriegsgeil	negative
supersympathischen	positive
abgehoben	positive
schwarzsehen	positive
negatib	positive
supportive	positive
negativeeee	positive
autogenese	positive
stocks	positive
zoversichrlich	positive
ausgabezwecke	positive
unintendierte	positive
perv	negative
unterirdischer	negative
unfair.	negative
wunschistbefehl	negative
oarrrrr	negative
hilfsbereiteste	positive
pejorativ	negative
lümmel	negative
strahlend	positive
gewebt	positive
mies	negative
ergonomischer	positive
aufwe	positive
glück	positive
wirkender	positive
mistig	negative
verachtung	negative
widerwärtig	negative
ausdenken	positive
humorv	positive
hilfsber	positive
loyal	positive
superior	positive
gebauter	positive
knuffelig	positive
vorgesummt	positive
gesanglos	positive
eunfach	positive
hellgrau.	negative
aufheiternde	positive
fingerheb	positive
urigste	positive
musikwiedergabe	positive
sypathisches	positive
gutgelaunter	positive
schmancy	negative
maikind	positive
unaufwendige	positive
unvergeben	positive
abenteuerlustiges	positive
johaaaa	positive
unaufregend.	positive
todeskaff	negative
pyschophatin	negative
wiederaufgefrischte	positive
zweckloser	positive
marchstory	positive
befehlerisch	negative
appetitlich	positive
anrüchig	negative
ordnungsliebend	positive
teer	negative
ästhetik	positive
unlustig	negative
gefühl empfindend	positive
abschrecken	positive
freiheitsrede	negative
berechtigt	positive
haarlinge	negative
umschliessen	positive
entarten	negative
angemessem	positive
holzschnitt	negative
geschmackvoll	positive
erfolg versprechend	positive
niederträchtig	negative
schimmernd	positive
elitz	positive
keineswegs	positive
ekste	negative
unzweckmässig	negative
rumorst	negative
verzehrend	positive
eiler	positive
direktcarriewhiteburnsinhell	positive
kindheitserinnerungen	positive
slappen	negative
tapas.	negative
splashten	positive
ansteuerst	positive
ilovedortmund	positive
abgesegnet	positive
gefundend	positive
sexstory	negative
stoffjacken	positive
ichlinge	positive
unhilfreich	positive
azpflanze	positive
unappetittlich	positive
hopo	positive
gurkensamen	positive
klingelhose	positive
falsh	positive
tausend.	positive
abgespieltes	positive
themenfremd	positive
anggia	positive
verschlaffen	positive
märchenhaft	positive
elefantös	positive
positive	negative
taggen	positive
eichmann	negative
ergebniss	negative
ermutigend	negative
kneipenpatriotismus	negative
stilvoll	positive
attraktiv	positive
gtachekerlp	negative
erreichbarkteit	negative
whooa	negative
soldaten	negative
kritiken.	negative
inflexibelsten	negative
spiol	negative
klebet	negative
mittelschlecht	negative
efhbknfwefijn	negative
dachre	negative
damnals	negative
gastierend	negative
preisenn	negative
fairlierer	negative
metaphern	negative
marketingmenschen	positive
klassenarbeit.	negative
liebenswert.	negative
mabgelhaft	negative
worumesgeht	negative
entfernungen	negative
arschkriechend	negative
verinnerlich	negative
deplatzierte	negative
inkomplett	negative
zugespitzt	negative
loooooooooooossssser	negative
eingeschlichenen	positive
zemaachen	negative
weiterrechne	negative
kriiiiiitik	negative
unangenehm	negative
glückreich	positive
stylen	positive
lebensbejahend	positive
kümmerlich	negative
dreiteilig	positive
designorientiert	positive
signalisierend	positive
ungebrauchter	positive
pfannenset	positive
traubanentoastrottig	positive
rpgwelten	negative
ergebnislos	negative
missraten	negative
vermisstenanzeige	positive
unstylisch	negative
ansprechend	positive
riich	negative
scheiss	negative
flauschigste	positive
anrofen	positive
schlaueres	positive
laienhaft	negative
traueme	positive
astrein	positive
bös	negative
erbärmlich	negative
spieleportal	negative
ungesund	negative
denkanstoss	positive
stricker	negative
bettel	negative
scheidig	positive
stinkt.	negative
bezahlbares	positive
kindsbewegungen	positive
pianoklangzeit	positive
wettercheck	positive
wasserbeleber	positive
behoben	positive
kalkulieren	positive
ausrechnen	positive
gutmütig	positive
arrgh	negative
phänomenal	positive
unwahr	negative
erfolgversprechend	positive
sympatischste	positive
rollerblades	negative
fettigsten	positive
oldscool	positive
titicandy4	positive
sinnvollster	positive
bedeutungsvollsten	positive
bewusstseinsklaren	positive
investigativste	positive
methodenmix	positive
ehepaar.	positive
verzehnfacher	positive
hashtagsininstagram	positive
recappen	positive
allmd	positive
aufschlussreicher	positive
chimenk	positive
korrupierte	positive
underfollowed	positive
steueroase.	positive
vivago	positive
hergestellter	positive
kurznotizen	positive
goilste	positive
slapstickhaftes	positive
ungedrosslten	positive
kundenbeschwerde	positive
matzusch	positive
mwhahaha	positive
geruchsarme	positive
hilflos	negative
dekorativ	positive
mastercard	positive
zusammenleben	positive
trendiger	positive
sackig	negative
geplagt	negative
handgelenkschiene	negative
elendig	negative
zweckfrei	negative
tageswerk	negative
nichtig	negative
ehrlos	negative
selbstvermarktung	positive
unehrenhaft	negative
knuffigste	positive
ungerecht	negative
unfair	negative
zuvorkom	positive
verteidigungsstrategie	negative
mittellos	negative
unerkannt	negative
evz	negative
konstruktiv	positive
sinnig	positive
aufmerksam	positive
feige	negative
produziert	negative
legendenhaft	positive
unnützlich	negative
ekel erregend	negative
m43	positive
besser	positive
bitchige	negative
aucb	negative
ortschaftsrat	negative
exzeptionell	positive
umfangreich	positive
gerissen	negative
klimbim	negative
zeitnah	positive
stilsicher	positive
unübertrefflich	positive
erfolgt	positive
jämmerlich	negative
anmutig	positive
koana	negative
speach	negative
radiofamilie	negative
zypriote	negative
benzel	negative
fleischarm	negative
wasserarm	negative
rohstoffarm	negative
eiweissarm	negative
ostergeplagte	negative
wegjetreten	negative
leidensscheu	negative
wuhuuuuuuuuuuuuhhhhhhhhhhhhhhhhhhh	negative
verknobisirt	negative
farnell	negative
frustierten	negative
zachariah	negative
verwirten	negative
beinamputierter	negative
heuschnupfengeplagtes	negative
intouchables	negative
schulterprellung	negative
schwerarbeitende	negative
virallem	negative
boshaft	negative
unbespielte	positive
miserabel	negative
kontrafaktisch	negative
wagenstand	negative
kontextfrei	negative
kalbsbries	negative
sojahackfleisch	positive
diskrimieren	negative
angest	negative
bewertungen	positive
marketingtechnisch	negative
ebbes	negative
sowhat	negative
besinnen	positive
auszeichnen	positive
unweiblich	negative
modisch	positive
charakterlos	negative
korrekt.	positive
gebra	positive
verabschiedet	positive
jungens	positive
hervorragend	positive
niedrig	negative
richtungsweisend	positive
respektvoll	positive
grins.	positive
javaid	negative
unausweichlich	positive
zuverlassige	positive
skigebiet	positive
undankbar	negative
beklatscht	positive
statin	positive
imageträchtig	positive
prestigeträchtig	positive
superflach	positive
hotteste	positive
xdrive	positive
tweetz	positive
abspecken	positive
bekloppteste	positive
meinungsbildung	negative
deckend	positive
landesweit	positive
wünschenswert	positive
ex.	positive
fabelhaft	positive
dilettantisch	negative
beschäftigen	positive
bildungsfernsehen	positive
unkomplizierteste	positive
unakzeptabel	negative
vorraussetzungen	negative
waldlichtungtrefffreudigen	positive
ineffektiv	negative
interessante.	positive
camy	positive
ziehmlich	negative
gentrifiziert	positive
datumsrelevanter	positive
xingeling	positive
hetroaussehende	positive
freunschschaftliche	positive
strahlet	positive
sympathischte	positive
danlbares	positive
whatsappmenschen	negative
cachender	positive
nromalste	positive
bruhigend	positive
kompent	positive
stammkunde.	positive
cubemen	positive
riechbesen	positive
antuzuschauen	positive
playboygrenze	positive
fleisige	positive
amook	positive
ultraschwer	negative
schwadronierend	negative
naaaw.	positive
verloga	positive
atleticofan	positive
gutausehende	positive
liebedswert	positive
diskussionsreicher	positive
itteligent	positive
schnuffelig	positive
umkomplizierte	positive
schuhberatung	positive
bagrat	positive
dolcefarniente	positive
selbstverteidigungsmaterial	positive
malarathon	positive
twitterlosen	negative
hesslon	positive
knuddliger	positive
gastfreundl	positive
schalnk	positive
beschimpfend	positive
knackig	positive
gepfle	positive
habgierig	negative
halbblut	negative
bejammern	negative
nichtsnutzig	negative
fusselig	negative
underrichtung	positive
spachteln	positive
paradiesisch	positive
nachhaltig	positive
herumtreiben	positive
erstklassig	positive
legendär	positive
hoffnungsvoll	positive
hinterlistig	negative
mathes	negative
pascha	negative
passiv	negative
verladen	positive
reisserisch	negative
abartig	negative
verletzend	negative
dauerquasselnden	positive
rostend	positive
stoneline	positive
weltrang	positive
budgetschonend	positive
temporeich	positive
brillant	positive
grottenschlecht	negative
unmenschlich	negative
eingängig	positive
dummdumm	positive
assozialen	negative
energieverschwendung	negative
ansetz	positive
positioniere	positive
innaktiver	positive
fenstersanierung	positive
schwesternrasse	positive
fishburger	positive
laffd	positive
genderbending	positive
pakistanis	positive
nachbaren	positive
generischem	positive
reformeirt	positive
riechig	positive
gewissenvoll	positive
telekomflatrate	positive
grrundrechte	negative
abmahnsicher	positive
lusy	positive
auusreissen	negative
kindergemein	positive
abnehmkram	positive
mitpfeife	positive
verschlagen	negative
edelmütig	positive
schedlweh	negative
liebevo	positive
irregulär	negative
liebevoll	positive
energetic	positive
grammatisch	positive
unachtsam	negative
diesediebstahl	positive
gekloppe	positive
gemeint	positive
moar.	negative
binx	positive
bradls	negative
fiesse	negative
eskalierend	negative
unstrukturierteste	negative
sonnenstrasse	negative
mannoooooooo	negative
umsoweniger	negative
quickclose	negative
superteuer	negative
meingehirn	negative
ansehbar	negative
styerer	negative
nialli	negative
todeslasern	negative
unpraktikabel	positive
nekronomicon	negative
niiiiice	negative
freudlich	negative
dasgut	negative
klischeebehafteten	negative
domanin	negative
unfortschrittlicher	negative
empathieloseste	negative
unwitzigsten	negative
werdemit	negative
dankeson	negative
klischeebesetzt	negative
roamende	negative
unbrachbar	negative
banekan	negative
sitemaps	positive
berechnest	negative
nivealos	negative
vk3001	negative
unrealistischere	negative
wahah	negative
einseitigsten	negative
superprovider	negative
herzzerbrechende	negative
wertloser	negative
zitterig	negative
unbegehrtesten	negative
creepeffects	negative
sammerschlussverkauf	negative
schwindlig.	negative
spaltenmanagement	negative
oscars	positive
stinkfinger	negative
unauthentischsten	negative
pixeligen	negative
chromespray	negative
nullsummenspiel.	negative
unbeweisbar	negative
llen	negative
schadeee	negative
undurchdachte	negative
knorke	positive
zwecklos	negative
jackman	negative
plunder	negative
dufte	positive
sympatischsten	positive
versägen	negative
böse	negative
paradigmatisch	positive
gutartig	positive
friedliebend	positive
weltverbessernd	positive
ergebnisreich	positive
feinschmeckerisch	positive
trosstkuscheln	negative
sprachlich	positive
benachteiligt	negative
gewissenhaft	positive
wortklauberei	positive
overnight	positive
indoktriniertes	negative
schönheit	negative
intrigant	negative
filipinin	positive
unvoreingenommen	positive
kinderlieber	positive
geldausscheidende	positive
m0ning	positive
ehrenvoll	positive
fangarm	negative
überragend	positive
korrigiert	positive
bestmöglich	positive
uiuiuiui	negative
erlaubens	negative
ultraflache	negative
nährstoffarm	negative
humorvollsten	positive
bitteschon	positive
kopfhalterung	negative
vitaminarm	negative
beinlos	negative
laange	positive
akupunktieren	negative
beine.	negative
oberschenkeln	negative
ticker.	negative
suizidales	negative
wurfarm	negative
warrock	negative
heeeelp	negative
halfpipenutzung	negative
wahrscheinlich.	negative
verf.	positive
grauslich	negative
jodelnd	negative
nachschlagen	positive
entbehrlich	negative
pipifax	negative
kathode	negative
effizient	positive
klacken	negative
ihhhhh	negative
unrichtig	negative
flegel	negative
unnütz	negative
preiswert	positive
elegant	positive
ungeschliffen	positive
rechtschreibwörterbuch	positive
rechtschreibduden	positive
vergeigen	negative
kleinlich	negative
mythisch	positive
vorbildhaft	positive
ungewollt	negative
grausam	negative
ehrenreich	positive
geformt	positive
versteckt	negative
tuchtige	positive
verknoten	negative
entlarvend	positive
verfolgt	negative
versemmeln	negative
hochschulrede	positive
ramsch	negative
verlogen	negative
enttäuscht	negative
gepflegt	positive
plaziert	positive
rechtens	negative
aufsehenerregend	negative
unecht	negative
lustich	negative
naheliegend	negative
retardieren	negative
wundervoll	positive
sympatische	positive
respektlos	negative
zumgeburstag	positive
besondersten	positive
12m_	positive
innerparteilich	positive
volkeren	positive
hackangriffen	positive
kracken	positive
lesenwerter	positive
detailreicher	positive
fehlerfrei	positive
neeiiinnn	positive
schwippige	positive
inakzeptabel	negative
versieben	negative
vereinfacht	positive
proponenten	negative
unrelevant	negative
stylisches	positive
vermehrt	negative
düster	negative
zertifizierte	positive
auseinandergehen	positive
mustergültig	positive
beschissen	negative
zuverl	positive
gesznder	positive
umgewandelt	negative
skeptisch	negative
deutlich	positive
sexy.	negative
stylvolle	positive
unzickig	positive
schreibfreudige	positive
unkom	positive
korre	positive
passend	positive
vorbildlichste	positive
ekelig	negative
schnupperig	positive
attrakiver	positive
kiffenden	positive
aufgeschlossener	positive
aussehendste	positive
hrrrrrr	positive
sorgenvollsten	positive
hubsche	positive
unzickige	positive
stockschwul	positive
erlichen	positive
etiquette	positive
aua.	positive
amsterdamm	positive
schlafpause	positive
ungeplantes	positive
baywob	positive
hochleistungsschonen.	positive
knalligen	positive
undervisning	positive
familienplanung	negative
hochklassig	positive
geschmacklos	negative
bahnkarte	negative
anion	negative
verdorben	negative
vorschnell	negative
diascanner	negative
bedarfsgerecht	positive
kova	negative
ärmel	negative
anziehend	positive
vertrauensvoll	positive
to.	positive
wertiger	positive
trosstknuddeln	negative
ungeeignet	negative
sgschnittchen	positive
seelenbrecher	positive
babytiere	positive
durchschnittspreis	positive
cooleres	positive
verpatzen	negative
ausfallend	negative
gipsschiene	negative
bischt	positive
nachdenken	positive
sinnreich	positive
saisonende	positive
chancenreich	positive
schlampig	negative
stabil	positive
blutgerinnungsscheisse	negative
intolerant	negative
abgeschlagen	negative
netzte	negative
geschunkel	positive
krempel	negative
menno	negative
verortet	negative
sexlos	positive
bastelnd	positive
elbseite	positive
themesongs	positive
nachhetzen	negative
abwesendheit	positive
vermisst.	positive
tedmosby	positive
richtiiig	negative
absorbiert	positive
fruchtsmoothie	positive
spionagequests	positive
tsmc	negative
reissversc	negative
bitterarm	negative
gehaltlos	negative
l11	negative
kollegial	positive
bizepse	negative
undemokrat	negative
arghl	negative
handmassage	negative
gemobbte	negative
weglacht	negative
jauch.	negative
ruhigstellen	negative
ran	negative
betrügerisch	negative
scheeiisse	negative
idyllisch	positive
unausgeglichener	negative
kreatin	negative
rauszusuchen	negative
dumm	negative
abträglich	negative
freudschen	negative
kampfeslustig	negative
apfelseinen	negative
fadeste	negative
unsolidarisch	negative
dltdl	positive
heheheheheee	positive
uspreche	positive
unkreative	negative
zweitteam	negative
grundschulzeugnisse	negative
schnurzelpurzel	negative
tarotkarte	negative
bssr	negative
neocortex	negative
okopfkino	positive
leaseback	negative
paidcontent	negative
uben	positive
singls	negative
berlintn	negative
brille.	negative
reingespielt	negative
zusammengewerkelt	negative
hinterfotzigen	negative
darmanregend	negative
gechillten	positive
verzählen	negative
schmuckes	negative
kindgerecht	positive
angemessen	positive
unfassbar	negative
entschlossen	positive
gnihihihi	negative
kampflustig	negative
erleichternd	positive
sorgsam	positive
bezahlbar	positive
kreativ	positive
glücksfall	positive
ekelerregend	negative
zurückentwickeln	negative
logisch	positive
ethisch	positive
clx	positive
phonoschrank	positive
fantiger	positive
zwanghaft	negative
innovativ	positive
pewee	positive
freundlich	positive
schlechtmachen	negative
ignorant	negative
schwabbelig	negative
wundervoller	positive
schädigend	negative
röntgenbild	positive
papierabzug	positive
vermasseln	negative
fehlerhaft	negative
wohnungsputz	negative
wertig	positive
tierlieb	positive
darbend	positive
unspezifisch	positive
tws	positive
pixoona	positive
borelliose	positive
regierungsentwurf	positive
bespielt	negative
haftungsausschluss	positive
trendiges	positive
unantastbar	positive
zahnimplantologie	positive
vernarbt	positive
robust	positive
plustek	negative
ohay0	positive
anderthalb	positive
fühlen	positive
bedenkenswert	positive
wiederlich	negative
lügnerisch	negative
leserlich	positive
unheimlich	negative
microserver	negative
stinktier	positive
mangelnd	negative
hubsch	positive
konspirativ	negative
unzutreffend	negative
nordkoreanisches	negative
ausgeglichen	positive
kation	positive
alicja21	positive
grundfalsch	negative
tugendhaft	positive
verantwortungsvoll	positive
feinsinnig	negative
erzogener	positive
kumpelig	positive
proportional	negative
umweltgift	negative
freudscher	positive
getroffen	positive
bezugsfreie	positive
unwartbar	positive
aufgeschloss	positive
schlauchen	positive
nten	positive
37j_	positive
laborunfall	negative
lobdestages	negative
individuell	positive
schmutzig	negative
ouhh	negative
umgestellt	negative
metallknopf	negative
unibluse	negative
träg	negative
träge	negative
diiiiir	positive
squirting	positive
zufriedenheit	positive
schwierig	negative
abnormal	negative
farbfotografie	positive
farbphotographie	positive
befriedigend	positive
oktopus	negative
zyniker	negative
superleicht	positive
pascal	positive
werbephotographie	positive
flachbett	negative
gearbeitet	positive
misslaunig	negative
fahndungsbild	positive
kurzzusammenfassung	positive
wohlwollend	positive
linsensystem	positive
zielfoto	positive
tuch.	negative
steissbein.	negative
apanage	negative
arbeitlos	negative
wegpennt	negative
bloodlights	negative
plotzlich	negative
zentrumsnah	positive
durchtrieben	negative
sinnlos	negative
dienend	negative
knein	positive
verwerflich	negative
frustriert	negative
realste	positive
ftw.	negative
grundgangarten	positive
vollführen	negative
kinderlos	positive
transportkorb	positive
pferderoman	positive
konfigurierbare	positive
sussen	positive
tartines	positive
mcdd13	positive
kytta	positive
nonexistent	positive
bluthirnschranke	positive
schecht	positive
harmonisch	positive
herrje	negative
ungenau	negative
grosser	positive
anekeln	negative
gereinigt	positive
achtsam	positive
sorgfältig	positive
irrig	negative
gut tun	positive
verstimmt	negative
missgelaunt	negative
unsozial	negative
missgestimmt	negative
direktversicherer	positive
naziaufmarsch	negative
funktionell	positive
reinflechten	positive
staufrei	positive
fneuhold	positive
fassadenfarbe	positive
wundertolles	positive
xingen	positive
noooiiiin	positive
steinigste	negative
herbeischreiben	positive
xf6	positive
nachhaltig.	positive
kapisch	positive
erfolgsfans	negative
pedantisch	positive
oah	negative
rausschlafen	negative
aufrichtig	positive
verschlepp	positive
ablenkend	positive
cleverer	positive
geduldig	positive
gewaltbereit	negative
farbaufnahme	positive
erfolgreich	positive
angriffslustig	negative
gradlinig	positive
pressefotografie	positive
pressephotographie	positive
porträtbild	positive
verharmlosend	negative
undifferenzierten	negative
berhunzt	negative
nuvoryn	negative
trashige	negative
ausreichend	positive
suckerpunch	negative
penisse	negative
unfairste	negative
sinnhaft	positive
prosperieren	positive
pissig	negative
skunk	positive
kapt	negative
schnap	positive
aussergalaktisch	negative
unkonstant	negative
angepisste	negative
zugegebenermassen	negative
ausgestahlt	negative
supertele	negative
archivfoto	positive
satellitenfoto	positive
durchzuwinken	positive
meisterhaft	positive
entrups	negative
pups	negative
langwiilig	negative
knietief	negative
wwarum	negative
luckie	negative
fünfteln	negative
fliegbar	negative
elend	negative
kaltherzig	negative
algenhasser	positive
furrer	negative
richtige.	negative
zugteil	negative
wisster	negative
hooot	negative
verfaulen	negative
weitverbreitet	negative
unw	negative
gildet	negative
inkorrekt	positive
froh	positive
beri	negative
contergan	negative
fahrbar	positive
zweckmässig	positive
wertvoller	positive
unsportlich	negative
netiquette	positive
hochgradig	negative
witzig	positive
fein	positive
unbenutztes	positive
professionell	positive
unternehmungslustig	positive
ungut	positive
eroberung	negative
oberflächenstruktur	positive
oll	negative
frustessen	negative
zieren	positive
irrelevant	negative
bemessen	positive
strapazierfähig	positive
auskunft	negative
fachabi	negative
anspruchsvoll	positive
unprofessionell	negative
hinterhältig	negative
auffindbar	positive
leidenschaftl	positive
hilfsbereites	positive
mobilie	positive
weltoffener	positive
vernachl	positive
herzensgut	positive
polaroidbild	positive
polaroidfoto	positive
bringend	positive
sympatischen	positive
kompetent	positive
kompetent.	positive
entspannt	positive
energievoll	positive
humorvol	positive
foodservice	positive
lombardo	positive
qualmen	positive
erfolgsversprechende	positive
30j_	positive
schummelst	positive
vehalla	positive
hinterfragen	positive
medienschau	positive
anforderungen	negative
guttun	positive
indeed	positive
armtasche	negative
elastisch	positive
mhkay	positive
kapitalverkehr	positive
unfehlbar	positive
schnulzig	negative
aapl	positive
blooms	negative
rur	negative
todgeweiht	negative
knuffisch	positive
mug	negative
verschreckt	negative
radfahrend	negative
egoistisch	negative
lololol	negative
froschplage	negative
mcu	negative
bein.	negative
proton	positive
wc.	negative
nebenkostenabrechnung	negative
industrialgreentec	positive
wertstabil	positive
kurzsichtig	negative
aussergewöhnlich	positive
stressfrei	positive
sac	positive
erhal	positive
eigenanteil	negative
marzell	negative
geradlinig	positive
geworden	positive
unchristlich	negative
icy	negative
rausreden	negative
falschschreibung	negative
ausgehungert	negative
fixe	negative
herzis	negative
durchdacht	positive
differenziert	positive
sibst	positive
gftzgukhfvguizcfzvbzki	positive
abarbeiten	positive
versinken	positive
schädlich	negative
entwickelt	positive
erfrischend	positive
tugendlich	positive
wohl tun	positive
lebendfutter	negative
tugendreich	positive
förmlich	positive
orientierungslos	positive
reibungslos	positive
extremst	positive
irrtümlich	negative
schwimmkursus	positive
anstrengen	positive
rostfrei	positive
sperrig	negative
grantig	negative
zusatzzahl	positive
mutmasslich	positive
gleichermassen	positive
himmlisch	positive
fetzige	positive
closure	positive
bewertet	positive
silviundsilvio	positive
teile.	positive
schwierz	negative
permalinks	positive
magnetstreifen	positive
unvorteilhaft	negative
durchn	positive
unlustig.	positive
exakt	positive
aktfoto	positive
substantiell	positive
schwarz-weiss-foto	positive
schwarzweissfoto	positive
schwarz-weiss-bild	positive
ih	negative
versiert	positive
ehrbar	positive
unterkomplex	positive
akkurat	positive
schlafen.	negative
akademisch	positive
genieren	negative
ledig	positive
schlechtreden	negative
plausibel	positive
bockl	positive
verzinsung	negative
denkpause	positive
traubanentoastrottige	positive
sachst	positive
pacemaker	positive
freundinin	positive
sclecht	positive
bravste	positive
fsh	positive
beutendsten	positive
elgeanter	positive
rumgewacken	positive
gechatted	positive
spz.	positive
fuchtbar	negative
granatenstarkes	positive
hasilein	positive
selbsterfunden	positive
miteinbeschlossen	positive
scotten	positive
intensiv.	negative
gespickt	positive
schleucht	positive
trsum	positive
einfachster	positive
bisel	negative
gehandhabt	positive
sauschlechte	positive
shaperd	positive
sandpaper	positive
gegammelt.	positive
th2	positive
hule	positive
fantastiche	positive
liebere	positive
saulangsam	negative
saliger	positive
stockbeine	negative
gutaussehendesten	positive
halbgefrorenes	negative
puaaaaaajajajajaajajaja	positive
geint	positive
glasverpackung	positive
bestandeeeeeeeen	positive
prozedural	positive
schwesterorganisation	positive
luschtigst	positive
ewas	positive
daaaaw	positive
selbe.	positive
rampensen	positive
leggs	positive
ohmmmmmm	positive
verfeinerter	positive
truckerbag	positive
beantwortend	positive
machsu	negative
awrr	positive
uswusf.	positive
tollwutpenisse	positive
leckererste	positive
diemeistezeitamkabel	positive
whoohooo	positive
ajc	positive
enschuldige	positive
diaboli	positive
nocarb	positive
kontros	positive
aufregerli	positive
chandgelenk	positive
leckaaaaaaaaa	positive
aiiitt	positive
kellen	positive
twitterkom.	positive
sweetbalfourdreams	positive
zuverlassiger	positive
dienstabschlusshalbe	positive
solan	positive
speicherlastig	positive
selbstvertrimmende	positive
dynamo.	positive
deob	positive
rumsuchten	positive
despertarse	positive
thebestornothing	positive
verabscienden	positive
teuerst	positive
ffnfcb	positive
tobianthr	positive
bewahrt	positive
uuuute	positive
boorrrr	positive
biddebidde	positive
inhaltsreicher	positive
umspannend	positive
erforren	positive
ultraironie	positive
schmolln	positive
selbstrefenziell	positive
miniaturig	positive
aufviederzehn	positive
zitierbare	positive
egopush	positive
coverlieder	positive
erleicjtert	positive
langweilen.	positive
unfehr	positive
rewink	positive
marisabella17	positive
weiterweiter	positive
schlechste	positive
xbusang	positive
sicherers	positive
knautschiger	positive
unersetbar	positive
zweitbes	positive
saubequem	positive
gutne	positive
selbsr	positive
fanfarengeschall.	positive
gib.	positive
dankeschone	positive
niveauvollste	positive
boukje	positive
funktionsfahiger	positive
stimmschone	positive
valider	positive
nichtvielzutun	positive
unterschritten	positive
tilbu	positive
anane	positive
schwerzenbacher	positive
einzigartigerals	positive
rebloogens	positive
expediente	positive
jenfer	positive
fehlerfreieren	positive
filrten	positive
kindersicher	positive
killrobots	positive
genesung.	positive
energiereichsten	positive
schelchter	positive
gentucilla	positive
unterbewertet	positive
abgehmssig	positive
baumschubse	positive
raupenkran	positive
preiswe	positive
verkehrsanb	positive
abgekupferter	positive
aaaawwwrrrr	positive
drannehmen	positive
birthay	positive
d27r	positive
einscheissen	positive
zib20	positive
tjarki	positive
treibendenden	positive
einmaligsten	positive
reiz.	positive
phonen	positive
aufbewahrungsdosen	positive
curryklumpen	negative
umein	positive
strandreife	negative
liabste	positive
attravtive	positive
filmische	negative
turu2	positive
eddieharris	positive
monsen	positive
kontstruktive	positive
gehasst.	negative
karrie	positive
ersparn	negative
anschaulisch	positive
amuliaprtw	positive
genregrenzen	positive
dirrrrrrrrrrrrrrrrrrrrrrrrrrrrrrrrrrrrrrrrrrrrrrrrrrrrrrrrrrrrrrrrrrrrrrrrrrrrrrrrrrrrrr	positive
platz3imvisier	positive
gutermenschen	positive
superkalifragilistischexpialigetisch	positive
realistischten	positive
vieleich	positive
schatzi.	positive
pazarlar	positive
mosquera	positive
inhaltsreichen	positive
harrharrharrharrharr	positive
ericschreyer	positive
kamace	positive
yesyesyesyes	positive
gunhappy	positive
faserschmeichelig	positive
geckoos	positive
arschfirmen	positive
unbeabasichtigt	negative
tjt	positive
abschiedstweet	positive
tra4um	positive
nimandem	positive
happyhappy	positive
thegazette	positive
kurzfri	positive
liefern.	positive
oouhh	positive
asun	positive
hatl	positive
hibbelnde	positive
vileseit	positive
herauszumachen	positive
uciii	positive
individualisiert	positive
wohnfertig	positive
scheissnote	positive
sckecht	positive
mabaluvin2009	positive
hardcoverbuch	positive
djetzt	positive
ehrholsame	positive
schlechtss	positive
krampffreie	positive
kernpower	positive
freuynde	positive
treuestenfreunde	positive
punktejagd	positive
steuergeldbasierten	positive
psexec	positive
gnightttt	positive
teamupforkids	positive
wundabar	positive
tanninarm	positive
schnecks	positive
pfirtie	positive
findich	negative
zeitraubenste	positive
beissts	positive
unverbaubarer	positive
beschwerdefreien	positive
wettertechnisch	positive
gewaschener	positive
beisste	positive
kindaaaas	positive
gex3d	positive
wennaus	positive
gys	positive
ihnnen	positive
softwarefirewall	positive
waalaikumsalam	positive
fetig	positive
alienfrittiert	positive
giffen	positive
gelistet	positive
kniebehinderte	positive
machter	negative
stabilisiert	positive
ihnen	positive
whuahhh	positive
verantwortungsbewusster	positive
granatenhart	positive
alcira	positive
coolse	positive
koffeinreichen	positive
agrarsubventionen.	positive
spielb	positive
kontrollliert	positive
schimpi	positive
dabinichmirsicher	positive
tommi.	positive
bluesbrothers	positive
doggyfickstellung	negative
beschallbar	negative
vorbeischau	positive
bierdouche	positive
zureffend	positive
humanistischeren	positive
selbstverantwortlichkeit	positive
schlechte.	positive
wundebarste	positive
leidensgenossin.	positive
addictionlp	positive
totalreflektiert	positive
slimut	positive
schaatttzzzz	positive
aktzentfreies	positive
bedienter	positive
sportrecherche	positive
rausge	positive
kungsleden	positive
crancklack	positive
originalkonsolen	positive
nachhatliges	positive
nabilaroshan	positive
emazipiert	positive
sc57	positive
mussbayern	negative
spirenzchen	negative
shclimmer	positive
schiedsgerichtsfrei	positive
nachtfalter.	positive
amisssss	positive
kosmopolit08	positive
stahlbetonbauneindanke	positive
nuttenfrustuck	positive
depriemierend	positive
brettstark	negative
gelingend	positive
wallachwallac	positive
wallachwalla	positive
follw	positive
echtzeitupdates	positive
liebgeworden	positive
federne.	positive
aaaaaaaaaber	positive
higuain.	positive
triner	positive
busserl	positive
zauberlichtgetragen	positive
prakt.	positive
vertih	positive
schnsten	positive
billigtextilie	positive
beeeeser	positive
drittelzeit	positive
english4runnaways	positive
vebiegen	positive
lovelyyyyyyyyyn	positive
versteigerungstweet	positive
konzentrationstiefs	negative
hubbelig	positive
schlecter	positive
schlechtergeworden	positive
eingereicht	positive
alteklasse	positive
besteeeeeee	positive
wienden	positive
reuploade	positive
popeligen	positive
desenladrille	positive
kjsdg	positive
seblbst	positive
sicherliiiich	positive
conchesumadre	positive
wasmussdasmuss	positive
leztekatze	positive
smooven	positive
schlechen	positive
guarri	positive
zeitreisenantrag	positive
eingeleitet.	negative
jagdlobby	positive
aulion	positive
onlinelos	negative
positivethinking	positive
watchtower	negative
wettbewerbsfreundlicher	positive
riiiiichtig	positive
gutenachtbussl	positive
menschengerechtesten	positive
langhaarcolli	positive
dkyem	positive
vercheckter	negative
lediert	negative
entwicklungsstandort	positive
auslaufend	positive
effectifer	positive
trittstufe	positive
allrite	positive
tembur	positive
crazysieste	positive
unchenierter	positive
schweigeresk	positive
andaurend	positive
neodneidnidneosn	positive
schnutte	positive
bleimseruhig	positive
allgemeinefriedberg	positive
schwatzgelben	positive
solaratlas	positive
gutevorbereitung.	positive
schweisshelden	positive
esofiles	positive
glitzrige	positive
malzige	positive
traubanen	positive
kompaktestes	positive
unreimheiten	negative
durchschmoren	positive
mbel	positive
personenkraftverke	positive
sweetddreams	positive
treumr	positive
nachtile	positive
inshaallaah	positive
welllllllll	positive
ekelh	positive
hochqualitative	positive
orginellsten	positive
artikel38	positive
lussi	positive
linkerer	positive
glucklish	positive
schips	positive
informativsten	positive
geficken	positive
caniim	positive
kanelbullar	negative
komplikationsfeie	positive
marktinterventionistischer	positive
mycakeshomemade	positive
debian7	positive
jumpe	positive
infantil	negative
wertlos	negative
drittgut	positive
jammerschade	negative
wachstumssorgen	negative
junggebl.	positive
chancenauswertung	negative
gebitet	negative
30c_	negative
pöbeln	negative
rizzo	negative
grammatikalisch	positive
barmherzig	positive
arrr	negative
wohltun	positive
ungewaschen	negative
hochverschuldet	negative
zeitlos	positive
brutal	negative
weltoffen	positive
ahahahahaha	negative
blutarm	negative
prs	positive
supii	positive
ohw	negative
farbfoto	positive
übel	negative
eski	negative
duad	negative
simply	positive
mickrig	negative
verschnupft	negative
herzstechen	negative
dekollete	negative
mutter.	negative
brechen.	negative
werbefotografie	positive
armprothese	negative
duckhome	negative
eindeutig	negative
sht	negative
zufrieden	positive
einzigartig	positive
romatisch	positive
tageslichttauglicher	positive
aktionistisch	positive
abwegig	negative
deftig	positive
gehässig	negative
wohlsinnen	positive
humorvoller	positive
schämen	negative
lobend	positive
schwarz-weiss-fotografie	positive
engagierter	positive
heiss.	positive
auftwitter	negative
booooom	positive
skurilen	positive
verschmusst	positive
intell	positive
katzenkorb	positive
madrid.	negative
aufmerksamkeit.	negative
penibel	positive
unstrukturiert	negative
naturgeil	positive
schwarzweissbild	positive
digitalfoto	positive
chalet	positive
flau	negative
unbekannt	positive
betriebsanleitung	positive
buaba	positive
schriba	positive
meitla	positive
cieslik	negative
chillig	positive
inoffiziell	negative
weider	negative
mikrig	positive
unreif	negative
bedenken	positive
gewalttätig	negative
entspannter	positive
sofortbild	positive
kiki	negative
energieeffizient	positive
tchuss	positive
ausgeglichener	positive
ordentlich	positive
eingesessen	positive
ausgerichtet	positive
ballonreifen	positive
nieder	negative
optisch	positive
alexchen	positive
verfälschen	negative
eingeschlossen	negative
gehatet	negative
geografisch	positive
vorbildlich	positive
untreu	negative
schwindlig	negative
schwarzweissfotografie	positive
beispielhaft	positive
allergisch	negative
brandmal	negative
gebrauchsanleitung	positive
preiswerte	positive
lebensfroh	positive
herzlich	positive
label	positive
anhören	positive
vergewaltigt	negative
verkacken	negative
hofieren	positive
weitreichend	negative
modern	positive
hochstehend	positive
hinterfotziges	negative
gebaut	positive
mmn.	positive
machtlos	negative
einwählen	positive
genutzt.	negative
bedürftig	negative
duplikat	positive
werbeunterbrechung	positive
aktuell	positive
weich	positive
grandios	positive
menschlich	positive
omg.	negative
endgeil	positive
wunderbar	positive
todkrank	negative
beintrainer	negative
einfarbig	positive
verirrt	negative
farbbild	positive
abgefuckten	negative
unfreundlich	negative
oooo	negative
frech	negative
abtauchen	positive
armlet	negative
reic	negative
armfrei	negative
sympathieerweckend	positive
sympathie erweckend	positive
lebensleistung	negative
wasss	negative
hemdkragen	negative
gesu	positive
klimaneutral	negative
sachgerecht	positive
wurzel ziehen	negative
radizieren	negative
arbeitgeber	positive
gründlich	positive
schadenfroh	negative
vorzüglich	positive
einzelfoto	positive
notabene	positive
inspirierend	positive
klug	positive
euf	negative
knuddeligen	positive
handgefertigt	positive
antriebslos	negative
bartek	positive
eindrucksvoll	positive
kriminell	negative
gesellig	positive
kulant	positive
nachdenkenswert	positive
gelbsucht	negative
tode	negative
etabliert	positive
sozialkompetente	positive
geplegt	positive
eingetragen	negative
aufkommend	negative
zuverlässig	positive
primitiv	negative
fanfictions	negative
rb2	positive
cockt	positive
sauber	positive
butterweich	positive
sachengibts	positive
offen.	positive
traumreiche	positive
geforce635m	positive
frischeste	positive
lustvoll	positive
adressen	positive
harmloser	positive
handkuss	negative
chancenlos	negative
bastard	negative
sagenhaft	positive
looooove	positive
brm	positive
rekordsaison	positive
abstossend	negative
beleidigend	negative
yni	positive
gewaltverherrlichend	negative
hautsache	negative
genehm	positive
fundiert	positive
frauenverachtend	negative
drastisch	positive
gefällig	positive
miad	negative
bestätigen	positive
friedvoll	positive
vorurteil	negative
prompt	positive
morgendlich	positive
sinnlich	positive
erregt	positive
anerkennen	positive
umweltschonend	positive
dreckig	negative
gestaltet	positive
unkritisch	positive
detailaufnahme	positive
neudeutsch	negative
gruppenaufnahme	positive
sympathisch	positive
unausgesprochen	negative
krampfhaft	negative
jugendfrei	negative
kompakt	positive
salzach	positive
günstig	positive
rythmus	negative
solche	negative
fälschlich	negative
cpus	negative
kekse.	negative
arbeitsam	positive
ohnein	negative
richtig stellen	positive
fechterin	negative
diir	positive
unkorrekt	negative
hohl	negative
krude	positive
langfristig	positive
sparsam	positive
feig	negative
lobenswert	positive
demagogisch	negative
zizek	positive
liket	positive
selbstgeschrieben	positive
halbvoll	positive
untalentiert	negative
kean	positive
mfx	positive
fliesstext	positive
einzucremen	positive
mitdenkend	positive
intakt	positive
humo	positive
liiie	positive
vecher	positive
muahahaha	negative
gelogen	negative
erinnerungsfoto	positive
draghi	negative
besagt	negative
verficktes	negative
rippe	negative
aufmachen	positive
nutzbringend	positive
unzureichend	negative
unkomplizier	positive
energiesparend	positive
hell	positive
flei	positive
supe	positive
armseelig	negative
krankwerden	negative
einfallsreich	positive
kamt	positive
ales	positive
entdrosselt	positive
funtioniert	positive
sattelfest	positive
soph	positive
funktionierst	positive
yi	positive
aktenschrank	positive
eigenartig	positive
wade	negative
zuwenig	negative
anschmiegsam	positive
ideen.	positive
falsc	negative
troztdem	positive
näseln	negative
unproduktiv	negative
anschwärzen	negative
verseucht	negative
unstrittig	negative
erfahrende	positive
wertvoll	positive
krank.	positive
perfektionistisch	negative
schlau	positive
empfinden	positive
freistehend	positive
humorlos	positive
bescheuert	negative
inkonsequent	negative
diplomatisch	positive
arch	negative
gepfl	positive
stimmig	positive
brummen	positive
schmallippig	positive
niveauvoll	positive
srsly	negative
perfekt	positive
ausserordentlich	positive
schmierig	negative
sittlich	positive
abfertigung	positive
schallend	negative
depressiv	negative
ungebildet	negative
mietnomaden	negative
gebrauchsanweisung	positive
modellhaft	positive
sadistisch	negative
doppelt	positive
unglaublich	negative
aufmunternd	positive
impfschutz	negative
tüchtig	positive
urgh	negative
verstockt	negative
vermeidungsstrategie	negative
juhuu	positive
hochreissen	negative
gandalf	positive
sonnig	positive
phantasievoll	positive
unleserlich	negative
bn8	positive
positioniert	positive
erlernbar	negative
grundstufe	positive
sachgemäss	positive
erkenntnisreich	positive
scree	positive
polemisch	negative
direkt	positive
mieps	positive
sweeet	positive
reitpartnerschaft	positive
videospiele	positive
dankbar	positive
bewegungsstark	positive
borst	positive
siht	positive
bicho	positive
verfickte	positive
fahndungsfoto	positive
mose	negative
unbeabsichtigt	negative
archivbild	positive
kchchch	negative
kurios	positive
tsts	negative
qualvoll	negative
verzerrt	negative
unaufrichtig	negative
diabild	positive
wirkungslos	positive
richtiggehend	positive
aussehensspezifisch	negative
fachlich	positive
ehrli	positive
motivierter	positive
eintönig	negative
angesehen	positive
spendabel	positive
schlech	positive
krank	negative
destruktiv	negative
konsument	negative
backst	positive
gutgelaunt	positive
bildnis	positive
durchknallen	positive
thehe	positive
sobalds	negative
iiiiich	positive
halbgeschwister	positive
osiander	positive
devoter	positive
asthmaanfall	positive
minimalistisch	positive
creepy	negative
allerlieb	positive
kofi	positive
zuv	positive
dramatisch	positive
menschenbezogene	positive
eklig	negative
abfertigen	positive
zwacken	negative
hasslich	positive
polit.	positive
triftig	positive
hänger	negative
erniedrigend	negative
fürchterlich	negative
ausgewogen	positive
verheilen	negative
serbian	negative
nutzlos	negative
kulminationspunkt	positive
fair	positive
satellitenbild	positive
noccu	positive
nexte	negative
lauwarm	positive
olitik	negative
desing	positive
zeugniss	positive
trottelig	negative
ladenhüter	negative
privatstudium	negative
pappig	negative
vorausgesetzt	negative
brah	negative
ungesehen	positive
sündigen	negative
herbeiziehen	negative
trockenfutter	positive
glau	negative
bettelarm	negative
umschlungen	negative
tonarm	negative
iiiiih	negative
eid	negative
entschuldbar	negative
gepoppt	negative
besuchbarer	positive
unrecht	negative
verstümmeln	negative
belieben	positive
kritisch	positive
muffig	negative
erfolglos	negative
wahrscheinlich	positive
geschunden	negative
diapositiv	positive
herzergreifend	positive
flauschig	positive
preissturz	negative
purzelbaum	positive
legal	positive
ungeduldig	negative
elektron	negative
klassisch	positive
liebevoller	positive
ev.	positive
gleichwertig	positive
indigo	negative
preussisch	positive
ungeliebt	negative
mischling	negative
willenskraft	positive
statur	positive
lederhose	positive
heuchlerisch	negative
gelungen	positive
handgemacht	positive
zuträglich	positive
addy	negative
blendend	positive
misstrauisch	negative
kostbar	positive
richtige	positive
pagiii	positive
cmo	positive
wundermittel	negative
bundesligist	negative
ischtar	positive
lusche	negative
verdreht	negative
beschrieben	positive
ungezwungen	positive
röntgenisieren	negative
lustisch	positive
verkehrt	negative
queere	positive
emsig	positive
windschatten	positive
schlausten	positive
piekt	positive
vorbeischaust	positive
hoffentl.	positive
klappergestell	positive
shorten	negative
nargh	positive
gumbo	positive
raucherbein	positive
favn	positive
chrisi	positive
horrorszenario	positive
lachkick	negative
lebens	positive
gestern.	positive
heeeeeeeei	positive
grundform	positive
wortwitz	negative
meschugge	positive
funktionierts	positive
cropped	negative
behindert	negative
sbg13	positive
lustig.	positive
momentan	positive
softwa	negative
ledersofa	positive
imo	positive
inkonsistent	negative
engga	positive
ruiniert	negative
nostalgisch	positive
unbenutzbar	negative
werhahn	negative
engagiert	positive
berappeln	negative
vorknöpfen	negative
zeiten.	negative
gahne	negative
rumgammelt	negative
oda	positive
40k_	negative
maschinell	negative
ooch	negative
kopfrechnen	negative
bekanntenkreis	positive
ausziehbar	positive
schurke	negative
huren	positive
fehlschluss	negative
roh	positive
unlustigste	negative
selbstgemacht	positive
motiviert	positive
herausragend	positive
neun	negative
asozial	negative
gemustert	positive
angenehm.	positive
dh.	positive
angenehm	positive
legs	negative
utro	positive
liberal	positive
eintrag	negative
zuckerschnitten	positive
zweikampfbewertung	positive
schlafsackweil	positive
wycisk	positive
schmackhaftesten	positive
cortex	negative
ba	positive
naturfreund	negative
einzelbild	positive
oberschenkel	negative
kulinarisch	positive
gehabe	negative
neuartig	positive
unschädlich	positive
beklopptesten	positive
abgefuckt	negative
asso	negative
kilometerweitweg	positive
hinschauen	negative
lernend	positive
ballhornisieren	negative
knuffiger	positive
verballhornen	negative
erfreulich	positive
besuchbaren	positive
wid	negative
aufge	positive
ringeln	negative
ansteckend	negative
gsicht	negative
notenschrift	negative
tausenden	positive
verglühen	negative
programmatik	positive
donaukurier	negative
zuver	positive
grottig	negative
gnah	negative
ohayou	positive
wohltuend	positive
geeignet	positive
arschig	positive
aufblasen	positive
brechen	negative
motorradfan	positive
sage.	positive
unsymphatisch	positive
einseitig	negative
abrr	positive
kinder.	positive
pflegeleicht	positive
seolyze	positive
sorgfalt	positive
spassigste	positive
feministisch	negative
sweety	positive
komplikationsfreie	positive
dabian	positive
biestig	positive
provisionsfrei	positive
ladybug	positive
hubscheste	positive
undifferenziert	negative
ucokrambe	positive
immermal	positive
bemitleidenswert	negative
statthaft	negative
schlaxf	positive
panikfreie	positive
witzigstens	positive
grossartige.	negative
nervend	negative
holidaycheck	positive
verträglich	positive
heppey	positive
wohlauf	positive
weiterreichend	positive
panacotta	positive
allertoll	positive
jurist.	positive
fitter.	positive
themenphotographie	positive
themenfotografie	positive
inerauche.	positive
themenfoto	positive
praktischich	positive
pushend	positive
birthdayy.	positive
weiterworken	positive
entstehen	positive
begrüssen	positive
energievolles	positive
maxtra	positive
passendsten	positive
witztig	positive
shclecht	positive
epischsten	positive
andererer	positive
hirnzellen	negative
epischeren	positive
selbstverst	positive
geschmackslos	negative
premiumhand	positive
nasai	positive
sabahlar	positive
andromeda	positive
angstmache	positive
juster	negative
starkste	positive
talentiertere	positive
aufregender	positive
vermassel	positive
erteilt	positive
bauernsuppe	positive
morninggg	positive
exfat	positive
bytheway	positive
gangbanger	negative
schlectes	positive
megalang	positive
ausgepauert	positive
echtallwissend	positive
stgart	positive
frauline	positive
fettest	positive
whot	positive
loction	positive
platzraubend	positive
hagenstrasse	positive
annehmbere	positive
celcom	positive
haaaalloooo	positive
aprilscherz.	negative
preiwert	positive
zusammenge	positive
zahnarztfilme	positive
nischte	positive
anspruchloser	positive
selbstportraits	positive
verabstanden	positive
kalorieren	positive
radio1	positive
erleichternt	positive
esaa	positive
sonntagspflicht	positive
goodnite	positive
hows	positive
themenferner	positive
zerlesener	positive
eticket	positive
mhmhm	positive
schaisse	positive
laaaangweilige	positive
auskennts	positive
loozee	positive
beamst	positive
zeichenmaschine	positive
forked	positive
wacana	positive
kohlrabischnitzel	positive
lammrippchen	positive
promitwitterer	positive
eventdj	positive
bles	positive
megavoll	positive
volksgut	positive
sammlungsgut	positive
massengut	positive
rüstungsgut	positive
versorgungsgut	positive
behandlungsgut	positive
massenstückgut	positive
berlinernde	negative
ahuuuuu	positive
scherzfrei	positive
fakig	positive
cagastee	positive
gleuck	positive
lindernd	negative
verschprech	negative
dassssssss	positive
meteteleg	positive
bettsache	negative
geharvestet	negative
traumvolle	positive
befeh	negative
segafredo	positive
privatnr.	negative
limonadig	positive
gepfelgter	positive
armyofdarkness	positive
mussts	negative
diiiiaaa	positive
ruchtige	positive
mufft	negative
room44	positive
verfrachtest	negative
keinenfussbreit	negative
unzufriedenhei	negative
bleienten	positive
scheinapplaus	positive
dinleneyim	negative
feierbar	negative
sweetes	positive
intellektuelleelite	positive
weilos	negative
laisserzi	positive
freeeeeeeuuut	positive
platte.	positive
megascheisse	negative
saumatschwetter	positive
unhaut	negative
seddig	negative
mirow	positive
yooolo	negative
lebensbejahendsten	positive
erronaldo	positive
budikurniawan	positive
meone	positive
ausnahsweise	negative
rescourenfressend	negative
iweu	negative
umwandlungsformate.	negative
inspirierendste	positive
sjdlkjsfjkljsdk	positive
agresionen	negative
debugged	negative
holzdesign	negative
dunkur	negative
runterschubst	negative
preiswerten	positive
diskutantinnen	positive
aussroten	positive
bachmeier	positive
gelassanheit	positive
schokoabend	positive
gothische	positive
bersenang2	positive
sxhlaf	positive
handycameras	positive
gleichqualifiziert	positive
fahrradaktion	positive
zwischenduch	positive
einverstanden.	positive
gloube	positive
energiegeladener	positive
baay	positive
schatziiiiii	positive
durchgechattet	positive
ultrafit	positive
diie	positive
eeeendlich	positive
suesse	positive
sodbrennenattacke	negative
chickenwing	positive
grotten	positive
replydings	positive
dieh	positive
nachgeschmack	negative
dooofi	positive
dasselbe	negative
unbeliebt	negative
jilet	positive
reflektiert	positive
emax	negative
richtigstellen	positive
abgehackt	negative
sexuell	negative
tadellos	positive
provokativ	positive
italobrothers	negative
röntgen	negative
wunderherliche	positive
grrr	positive
beknackt	negative
spannend	positive
boar	negative
undemokratisch	negative
traumhaft	positive
hetero	negative
solvent	positive
transportabel	positive
september	negative
baldig	positive
krissy	negative
provokant	positive
letizia	negative
haus.	negative
inlay	negative
rekiss	negative
paffen	positive
fies	negative
charmeur	positive
eifrig	positive
einsetzbar	positive
dumping	negative
hilfsbereit	positive
false	positive
zynisch	negative
sexi	positive
arrogant	negative
analysiert	positive
zweet	positive
grenzdebil	negative
anja	negative
rtc	negative
wunschtraum	positive
amd	negative
datet	negative
scharf	positive
attitude	positive
bizarr	negative
lebenslustig	positive
sensationell	positive
interessiert	positive
fachbezogen	positive
nützlich	positive
wortvariante	positive
falsifizieren	negative
schlagzeile	negative
bedeutungslos	negative
funktioniert	positive
benetzen	positive
tentakel	negative
still.	positive
einförmig	negative
unberechtigt	negative
schuldig	negative
optimal	positive
zustellen	positive
proof	positive
unmotiviert	negative
liebevol	positive
win8	positive
njut	positive
berechtigen	positive
wichtig	positive
dekolleté	negative
herabwürdigen	negative
auskugeln	negative
mausern	positive
heillos	positive
anstellen	positive
fluffig	positive
humorvoll	positive
zug.	negative
spielfluss	negative
teilw	negative
garkeinen	negative
depressivität	negative
schafst	positive
offen	positive
vorwurf	negative
stylish	positive
beinhart	negative
400	negative
martialisch	negative
menschenrechtsorganisation	positive
selbstbewusster	positive
daiquiri	negative
zickig	negative
anon	positive
herzlos	negative
illuster	positive
hetze	negative
fehlanzeige	positive
erfah	positive
wurzleundchrone	positive
maskulinismus	positive
investigative	positive
stigma	negative
zartheit	positive
menschenverachtend	negative
lebenswert	positive
gestanden	positive
haaha	positive
absol	positive
berüchtigt	negative
verpönt	negative
wortform	positive
furchtbar	negative
nanu	negative
erwartet	positive
diabolisieren	negative
langlebig	positive
dämonisieren	negative
lichtbild	positive
plakativ	negative
abschreckend	negative
zusammenstellen	positive
pixelig	negative
devoten	positive
gastautor	negative
lichtarm	negative
ullmann	positive
mermaid	positive
lennox	positive
duch	positive
originalverpackt	positive
degen	negative
pressefoto	positive
bewertungsspezifisch	negative
hochtalentiert	positive
bissig	negative
verdammt	negative
halsreif	negative
gering	negative
schwankend	negative
checked	negative
putzig	positive
originell	positive
brav	positive
heiter	positive
fromm	negative
sonst	negative
mittelmässig	negative
anregend	positive
verzweifelt	negative
zerstreut	positive
straub	negative
unvorstellbar	negative
bemerkenswert	positive
eingewöhnen	negative
dumm.	negative
reinfahren	negative
unbedacht	negative
ungepflegt	negative
konsequent	positive
geceler	positive
treu	positive
employieren	negative
durchtrainiert	positive
solide	positive
gratulieren	positive
moti	positive
othmarschen	positive
meeeh	positive
belichten	negative
schmerz	negative
bedienbar	negative
camp13	positive
gedanken	negative
traumgirl	positive
verrufen	negative
irgendeine	positive
rassismus	positive
heldenmarkt	positive
selbstgekocht	positive
doctorwho	negative
fleissig	positive
abgelegen	negative
bscyb	positive
langweilig	negative
bitly	positive
familienmensch	positive
brr	positive
innenseite	negative
diskret	positive
geleit	negative
nervigste	negative
verhinderung	positive
melodisch	positive
hinsetz	negative
handgelenk	negative
perfide	negative
kundenbewertungen	positive
genesungswunsch	negative
gendert	positive
aufgeschlossen	positive
formula1	positive
klavierstunde	positive
liebenswürdig	positive
charakterstark	positive
davonrennen	positive
tugend	positive
symphatisch	positive
getue	negative
entstellen	negative
content	positive
wixxt	positive
belämmert	positive
kuschelig	positive
freundlic	positive
burghausen	positive
dopa	negative
berechnend	negative
bisma	positive
drangehen	positive
schnuckelig	positive
verschlammen	positive
patzig	negative
gespielt	positive
ungewohnt	negative
joshi	negative
wahrhaftig	positive
bro	positive
zahlreich	positive
gesegnet	positive
bereichernd	positive
schweineteuer	positive
grimm	negative
hahahahaa	negative
haltend	positive
spielgruppe	positive
liebreizend	positive
abiyenchbe3ch	positive
freunden	positive
100k_	negative
unbequem	negative
nervigsten	negative
phantastisch	positive
verknacksen	negative
gesund	positive
ung	negative
beinen	negative
abgebrannt	negative
tierisch	positive
bewusst	positive
ungewiss	positive
lovin	negative
luxe	positive
atze	positive
clauder	positive
stehkragen	negative
ruchbar	negative
betuppen	negative
artgerecht	positive
schwesterherz	positive
blogst	negative
fantastisch	positive
geborgen	positive
tss	negative
zuspitzen	positive
sonnenreichste	positive
dein	positive
schnitteriche	positive
kartengebung	positive
deckenschlafsack	positive
teilb	positive
gesundesten	positive
culpa	positive
variabel	negative
justins	positive
erraten	positive
behämmert	positive
libra	positive
thorben	positive
aufrecht	positive
unsympathisch	negative
mauerblümchen	positive
dumdidum	positive
besorgnis	negative
neidisch	negative
schnuffig	positive
blueefficiency	positive
zzzzzz	positive
vdg	positive
klar	positive
dekolletee	negative
auslegen	negative
nerdig	positive
digitalradio	positive
werbefrei	positive
chirurgin	positive
ekeln	negative
geringschätzen	negative
halsig	negative
boah	negative
niveaulos	negative
pfeil	negative
rotzig	negative
kurpfuschen	negative
minnken	positive
grohl	negative
kalorienarm	negative
verüben	positive
umwandlung	positive
halbschlaf	negative
klubgut	positive
allmendegut	positive
planeten	positive
beterschap	negative
anruferin	positive
unrealistisch	negative
vergällen	negative
leidenschaftlich	positive
flexibel	positive
verarmt	negative
ausdruckslos	negative
crosstrainer	positive
extremistisch	negative
brinchen	positive
kostenfrei	positive
vvk	positive
artig	positive
ausgerechnet	negative
wasserdicht	positive
aufstrebend	negative
durchgeknalltesten	positive
wurscht	positive
autsch	negative
wiss	negative
getauft	positive
mitfiebernder	positive
verschlossen	negative
iyashhh	positive
bösartig	negative
billig	negative
streng	positive
ohhhh	negative
sympatischer	positive
brustkorb	negative
koreanisc	positive
kinderschokotweet	positive
slmtpagi	positive
zuve	positive
saudumm	positive
familienausflug	positive
ausspielen	negative
kellogs	positive
elliot	positive
lebensnotwendig	positive
ieh	positive
rechtsverletzung	positive
dressed	positive
gut.	positive
festkrallen	negative
umfassend	positive
fanarmee	positive
sperberslohe	positive
songza	positive
tsss	negative
krankesten	positive
kaputt	negative
ithafen	positive
sanftmut	positive
immobilienkredit	negative
seo4hotels	positive
schaurig	positive
ehrlich	positive
liebenswert	positive
erfolgsversprechend	positive
spezialisiert	positive
mannheimer	positive
desinteressiert	negative
erhebungsgrundlage	positive
zwischend	positive
alki	negative
rein	positive
organi	positive
adjektiv	negative
unausgearbeitet	positive
pouletsuppe	positive
bestimmer	positive
schlawiner	negative
amputieren	negative
abgegeben	positive
freude	positive
tchus	positive
frischesten	positive
fuuuu	negative
sempatik	positive
abwechslungsreich	positive
scherpe	positive
sonnenmilch	positive
lecker	positive
sonnig.	positive
fertan	positive
ioa	negative
oszillograph	positive
morning.	positive
oberdoof	positive
gusund	positive
stressfreier	positive
happey	positive
gradratisch	positive
tennisellenbogen	positive
nervenzereissendste	positive
bekleidungsteil	negative
kleidungsteil	negative
ereignisarm	negative
magazinerweiterung	positive
impersonates	positive
personenverkehr	positive
alhamdulillah	positive
altf4games	positive
eucg	positive
besonderster	positive
antipathisch	positive
schlecher	positive
fahrber	positive
diiiir	positive
vindiesel	positive
oo.	negative
umsetzbar	positive
ander5	positive
bar6ie	positive
gefplegt	positive
rumgezeigt	positive
transportiert	positive
ausnahmsweisigen	positive
unkommentiert	positive
einfallsreicher	positive
zusammenfassend	positive
sweeteste	positive
reinsteckst	positive
babyboy	positive
hatice	positive
sansaaan	positive
hotelbildlierfinder	positive
swaantje	positive
unbelesen	positive
teiligreichhaltiger	positive
rumfallen	positive
17k_	positive
raufkommen	positive
dauerkalt	positive
okayish	positive
massenstudium	positive
gefollowten	positive
bessermenschen	positive
personalbindung	positive
posterdruck	positive
gejt	positive
unbestritten.	positive
eifacher	positive
buttrig	positive
beteiligst	positive
ostermontagmorgen	positive
schln	positive
mening	positive
frima	positive
sehrgut	positive
aufstufen	positive
genaur	positive
gegesssen	positive
neu	positive
freundeun	positive
pyramidenteile	positive
abfederungsprogramm	positive
lehrerstudium	positive
yeyy	negative
stapazierbarer	positive
klischeebeladener	negative
n8chti	positive
schlechtmenschen	positive
traniert	positive
tlist	positive
verderben.	positive
durchgestalkt	positive
coolnes	positive
hech	positive
evangelis	positive
viiiiieeeel	negative
gebotet	positive
kommat	positive
edlund	negative
anstrengensten	negative
wostkinder	positive
hochdeitsch	positive
wummmmm	positive
gint	positive
angesteckt.	positive
vorrattig	positive
kanser	positive
crosswires	positive
kindi	positive
oarg	negative
unerheblich	negative
dementspr	positive
baaa	positive
laaaame	positive
aortenstenose	positive
szasz	positive
tm21	positive
gutesten	positive
pssssscht	negative
bigb	positive
merkelmussweg	negative
killerblick	positive
generiert	positive
kaufenswert	positive
tinchenbaby	positive
alaplaya	positive
ausgezeichnet.	positive
zusatzaroma	positive
bierbesessen	positive
pimmeline.	positive
zusammengequietscht	positive
kurtz	positive
lassense	positive
esmacht	positive
knuddeln.	positive
zuflennt	positive
tweetieren	positive
intelugente	positive
schlechter.	positive
verurteilen.	positive
geglaubt.	negative
kreuznet	positive
montags.	positive
ganicht	positive
gangnamstyle.	positive
waaaahahahahaaaaa	positive
unnutzbar	positive
crossing.	positive
unsichtba	positive
aahhwww	positive
mentan	positive
hakaschwuchtel	positive
eingeschweissen	positive
nephry	positive
schlufrei	positive
fkk.	positive
sadams	positive
eurige	positive
auweih	positive
zuuu	positive
medigun	positive
ichauch	positive
nicths	positive
laaaaang	negative
gefeiert	negative
auuaa	negative
unfollo	positive
unterbildung	positive
lage.	negative
nmache	negative
fragt.	positive
estelle	negative
bestaussehendsten	positive
mapf	positive
foreva	positive
waits	negative
unqualifiziert	negative
bunny	negative
farbig	negative
sicherheitsmangel	negative
christiandavid	positive
inadäquat	negative
verschrien	negative
höhepunkt	positive
freundschaftlich	positive
wirtschaftlich	positive
durchschnittlich	negative
unehrlich	negative
progressiv	positive
einsalben	negative
personalisiert	negative
nit	positive
schwerelos	positive
shoppt	negative
befreiend	positive
suss	positive
verstanden	positive
softw	negative
energiegeladen	positive
unsympatisch	negative
steuermann	positive
hitlergruss	negative
klu	positive
vielseitig	positive
verwirrt	negative
tkss	positive
ziepen	negative
produktiv	positive
pedersen	positive
suggestiv	negative
grossartig	positive
gerecht	negative
verklickt	negative
verantwortungsbewusst	positive
sportlich	positive
gemischt	positive
notwendig	positive
aua	negative
schulter	negative
malerisch	positive
instabil	negative
faulig	negative
brandneu	positive
busy	negative
schokoladig	positive
lebendig	positive
zahlungsunfähig	negative
profilieren	positive
judenfeindlich	negative
regnerisch	negative
mio	positive
rubber	negative
anstellungsbedingung	positive
schwabbeln	negative
dropper	negative
amstelveen	negative
animieren	positive
merkste	negative
quatschen	positive
kinderfreundlich	positive
regulär	positive
schelmisch	positive
staffelei	positive
bane	negative
arschbacke	negative
verkrampfen	positive
gekocht	positive
petzen	negative
beherrscht	positive
fremd	negative
kuschlig	positive
unbefangen	positive
bayrisch	positive
asdifgasecve	negative
geskypt	positive
rmv	positive
killa	positive
vorsichtig	positive
laut	negative
abkacken	negative
cheesburger	positive
abgebrochen	positive
verschieden	positive
neoliberale	negative
erhoffen	positive
entgegenkommend	positive
ausdauernd	positive
stellend	positive
preislich	positive
stillos	negative
wohlig	positive
ruffle	negative
biologisch	positive
geruhsam	positive
barbarin	negative
schmerzend	negative
zerschmettern	negative
fragwürdig	negative
triffts	positive
schnulli	negative
schmerzlich	negative
t1	positive
eigendlich	negative
verbalisieren	negative
tageslichttauglich	positive
ises	negative
stimmlich	positive
gewechselt	positive
gelernt	positive
fehlschlagen	positive
vollschlank	positive
bfas13	positive
launcht	negative
unsachlich	negative
kavallerie	positive
entsetzt	negative
ausrenken	negative
mollig	positive
sprechblase	positive
zwischenergebnis	positive
haaach	positive
korpiklaani	positive
anstrengend	negative
biceps	negative
pest	negative
bundesweit	positive
vortrefflich	positive
devo	positive
regelgemäss	positive
aufgesetzt	negative
vorschriftsgemäss	positive
umwerfend	positive
vollpacken	negative
hotten	positive
current	negative
motivieren	positive
mol	positive
windstillste	positive
regenfreiste	positive
vornehm	positive
mausen	positive
hochnehmen	negative
einwandfrei	positive
offenherzig	positive
lachend	positive
regelrecht	positive
unlauter	negative
witzlos	negative
aufbauend	positive
messerscharf	positive
ungeplant	negative
spartanisch	positive
korrigieren	positive
spitting	negative
rechtschaffen	positive
dusel	positive
bonzenviertel	positive
astronomisch	negative
schade.	negative
wehrlos	negative
verrutschen	negative
hartz	negative
unpraktisch	positive
treffsicher	positive
agro	negative
buonanotte	positive
transparent	positive
genial	positive
rekord	negative
nie.	negative
begehrt	negative
aaah	negative
anmerken	positive
magnetisch	positive
erlich	positive
bizarrladies	positive
joah	positive
elimination	negative
abbuchen	negative
gmeint	negative
schlucken	positive
briefwahl	positive
gedanken.	negative
kse	positive
landwirtschaft	negative
beschwichtigen	negative
mandela	positive
böswillig	negative
hirnlos	negative
banken	negative
mässig	negative
reif	positive
einfachbessen	positive
verallgemeinern	negative
delonghi	positive
zwischenzeitlich	negative
friedlich	positive
fatal	negative
gebraucht	positive
ekel	negative
boa	negative
medis	positive
diwan	negative
chaiselongue	negative
dreist	negative
wuchtig	positive
treffend	positive
verschmuster	positive
democracy	negative
ragen	positive
tendenziell	negative
wegrenn	negative
repect	positive
wenig	negative
wasweissich	positive
unverwechselbar	positive
durchschnitt	negative
ärmlich	negative
scheibtisch	positive
riddance	positive
partiell	positive
drachen	negative
zurechtkommen	positive
aiwanger	negative
nyt	negative
authentisch	positive
romantisch	positive
lieb	positive
ansatzweise	positive
gruppenfoto	positive
vielversprechend	positive
gedanklich	positive
mittels	positive
anscheinend	positive
biodynamisch	positive
politisch	positive
warmherzigste	positive
aufschwemmen	negative
rob	positive
locker	positive
innovations	positive
cracks	positive
wund	negative
mittelmeerraum	negative
inch	negative
kotzbar	positive
hust	negative
detaillieren	positive
groovige	positive
celsium	positive
verkriechen	positive
befriendigend	positive
scheinheilig	negative
empfindlich	negative
bandagieren	negative
tagess	positive
klostergut	positive
reichsgut	positive
familiengut	positive
herzerfrischend	positive
kammergut	positive
bauerngut	positive
mustergut	positive
siang	positive
epischste	positive
strukturierter	positive
dominierend	positive
minguichi	positive
kirchengut	positive
schlossgut	positive
sauteuer	positive
preisoptimiert	negative
trocknende	positive
shaf	positive
grausam.	negative
gedulden	negative
lesbar.	positive
goldrichtig	positive
ultraschnell	positive
niederschreien	positive
frasi	negative
besonderste	positive
britisch	positive
hochpolitisch	positive
assalamualikum	positive
vertrauensvoller	positive
leeeeecker	negative
rechtspopulismus	positive
konne	positive
fitt	positive
moombahton	positive
akksfkrkwpslsldk	positive
issa	positive
lalaa	negative
kalt	negative
aufgeheizt	positive
kraft.	positive
schublade	negative
hallejulia	positive
gezwungener	positive
zuckriger	positive
bitter	positive
manse	positive
laaaanges	positive
berufsfotograf	positive
schenste	positive
gutes.	positive
benjamini	positive
verfrachte	positive
apetite	positive
ladelicht	positive
dringlichkeitsantrag	positive
musst.	positive
funktionierender	positive
wundertollen	positive
takers	positive
wunderschon	positive
gedichtsanalyse	positive
bekanntesten	positive
knuddeligste	positive
absolument	positive
dauerpleite	positive
gnhihi	positive
einrolle	positive
monde	positive
wundervolleres	positive
seeeehr	positive
brandhof	positive
pfiat	positive
skilled	positive
trollantrag	positive
simplify	positive
streamlife	positive
eze	positive
rollpopel	positive
ähneln	negative
weitergehend	positive
whyyy	positive
heimundhund	positive
anfeuchtendes	positive
ncher	positive
polished	positive
lieblingspony	positive
altnickel	positive
pferdammt	positive
kinetik	negative
nettester	positive
nyoo	positive
ls560	positive
netzbetreiberware	positive
idea	negative
ereignisreicher	positive
rumgeklickt	positive
engllisch	positive
iche	positive
bildstiftung	positive
hinzugehn	positive
herzensfreundin	positive
schlagerqueen	positive
lasergehirne	positive
ouw	positive
geburtstagsabend	positive
wohlan	positive
lumias	positive
musikantenknochen	positive
exestiert	positive
battletechnisch	negative
kvb.	positive
soule	positive
langdon	negative
euro27	positive
guuuuuuut	positive
geunlocktes	positive
woltet	negative
rinjehaun	positive
aushusten	positive
geordneter	positive
abersiebleibengutenmutes	positive
rnr	positive
hasst.	negative
arbeitswoche.	positive
schatzele	positive
intrum	positive
nixxxx	positive
hoffentlichen	positive
spaltenbreite	negative
visuell	positive
pdx	positive
hahahaaaa	positive
ostelsheim	negative
ehlung	negative
scherbenhaufe	positive
gewiss	negative
gehypt	negative
lustigstes	positive
multitask	positive
epoxidharzlackiert	positive
ungenu	positive
dateiserver	positive
gellar	positive
naturblond	negative
ochjoa	positive
neidisch.	negative
abgefahrensten	positive
tierbaby	positive
konfenz	positive
entspannteste	positive
fenstern	positive
anzweifele	negative
alt.	negative
brin	positive
bleibend	positive
kombis	negative
peinlich	negative
zeugnis	negative
zeitversetzt	negative
gerendert	negative
idiotisch	negative
zuvorkommend	positive
herunter	negative
lesenswerte	positive
egal	positive
bierchen	positive
gelaunt	positive
runterbewegen	negative
korrektheit	positive
insolvent	negative
inner	negative
mau	negative
entgegennehmen	positive
verstanden.	positive
besoffen	positive
hundetraining	positive
ohaa	negative
ehrenwert	positive
paulaner	positive
aufwendig	positive
herunterbewegen	negative
grauenhaft	negative
armstrong	positive
ermessen	positive
telefonkonferenz	positive
oh	negative
fettarm	negative
irgendwo	negative
muskulatur	negative
geziemen	positive
einkriegen	negative
ziemen	positive
attr	positive
opfern	negative
schwach	negative
positivbild	negative
weise	negative
ge	positive
komisch	negative
montag.	positive
prima	positive
moralisch	negative
abend.	positive
rennpferd	positive
noite	positive
gepflegter	positive
schultern	negative
crunches	negative
abstempeln	positive
verfehlt	negative
fotoprint	negative
quadratisch	positive
pokerface	positive
exclusive	positive
epilepsie	positive
anspruchslos	positive
restriktiv	negative
backstage	negative
kerlchen	negative
blome	negative
dienlich	negative
hehe.	positive
assalamualaikum	positive
regelgerecht	positive
bich	positive
zwe	positive
mogeln	negative
knapp	positive
hoppla	negative
peep	negative
justifizieren	positive
talentiert	positive
allererste	positive
vertikal	negative
lasch	negative
folgsam	positive
arbeitsteilung	negative
jeh	negative
chest	negative
erstrebenswert	positive
qualitativ	negative
autschn	negative
vergrösserung	positive
vivi	positive
potentiell	negative
wenn	positive
ersetzt	positive
extrovertiert	negative
unverstanden	negative
3	positive
ausgebrannt	positive
nichtraucherin	positive
fehlalarm	negative
bekennen	positive
berichtigen	positive
leger	positive
kram	negative
faust	negative
schleppend	negative
verzockt	negative
dunkelblond	positive
trauern	positive
aggro	negative
schichtenspezifisch	negative
herrenhaus	positive
einbauen	positive
tattoo	negative
looper	negative
gewonnen	positive
hape	negative
echauffieren	positive
zig	negative
dicht	positive
gleichbleibend	negative
reimen	negative
solala	positive
oy	positive
gudmrng	positive
leid	negative
hul	positive
ubd	positive
schwachsinnig	negative
schneefall	negative
hustig	negative
wochenlang	positive
uc	negative
feger	positive
hil	positive
zutreffend	positive
jaaaaaa	positive
naww	positive
fehlend	negative
senil	positive
polaroid	positive
olsen	negative
jungdominas	positive
gastladies	positive
vermeintlich	negative
achimeunshiramyeon	positive
informier	positive
gewagt	negative
eichtig	negative
unaufgeregt	positive
unmoralisch	negative
genuss	positive
bor	negative
privatisierung	negative
megakacke	negative
ewig	positive
prinzipiell	positive
mirs	negative
flauscht	negative
mylady	negative
schmuck	positive
whow	negative
freudig	positive
packender	positive
oo	negative
erledigt	negative
nachdenklich	positive
gutaussehend	positive
buschi	positive
einander	positive
twitlonger	positive
topbedienung	positive
topberatung	positive
ausgetretene	positive
donee	positive
verwesen	negative
theatralisch	positive
frei	positive
downloaden	positive
klaust	negative
touren	positive
sut	positive
lau	positive
rekordjagd	positive
exciting	negative
jedoch	positive
dk1185	positive
herrenhof	positive
backspace	positive
beschissener	positive
widerruf	negative
x170	positive
ohayoo	positive
gewartet	positive
selte	positive
verhindert	positive
hitchin	positive
balsamieren	negative
redlich	positive
okok	positive
bmx	positive
vokabular	negative
versauen	negative
statistiken	negative
giftig	negative
einleben	negative
putzen	positive
vazgecmem	positive
halltestelle	positive
vorschriftsmässig	positive
oar	negative
konzentriert	positive
hazienda	positive
meisterlich	positive
tube	negative
angebracht	positive
soc	negative
joaa	negative
steinig	negative
farblos	positive
dumpf	positive
biblis	positive
zahnfleisch	negative
gio	positive
verpixelte	positive
spdbpt	positive
besorgt	positive
coolster	positive
lautlos	positive
devil	positive
mkay	positive
betont	positive
aufgearbeitet	positive
fleckenfreie	positive
fresh	negative
erstaunt	positive
formell	positive
erbhof	positive
gebühren	positive
benutzen	negative
surfbrett	negative
rs500350	positive
treffender	positive
faul	negative
glaubhaft	positive
sinnvoll	positive
source	negative
grossrahmiger	positive
allergut	positive
emotional	positive
ersetzbar	negative
zwicken	negative
drumherumgerede	positive
unangemessen	negative
map	negative
absagen	positive
supino	positive
wohnungseinbruch	positive
sounddock	positive
inventive	positive
hornlos	positive
liebend	negative
kaminofen	positive
musikschrank	positive
hochdruckballen	positive
aufwiedersehn	positive
erkennt.	positive
goodmorning	positive
dringender	positive
rufly	positive
similarweb	positive
digo	positive
blockplatin	negative
rindsfilet	positive
ponygirl	positive
schafewelt	positive
vereinen	positive
wundebar	positive
diiir	positive
only	negative
allergeilste	positive
lieeeb	positive
ziel	positive
pfingstkirchen	positive
lustigster	positive
sozialdrama	positive
schlafkiller	positive
dreck	negative
nachicht	positive
scetch	negative
eichenfass	positive
wiedee	positive
x60x80	positive
lace	negative
griesson	negative
durchspülen	positive
reinschieben	negative
wiegesagt	positive
abeeeeer	negative
ngene	positive
nichst	positive
magenschmerzen	positive
staystrong	positive
superheldinnen	positive
finalisiert	negative
filmparodien	positive
naumi	positive
urm	positive
rumnerven	positive
schlechts	positive
strategisch	positive
ebenfals	positive
kipplaster	positive
battelt	positive
autoplay	negative
didaktiker	positive
drollig	positive
autogrammkarten	positive
halluuu	positive
commedia	positive
joder	positive
mehrbelastung	negative
vdg.	positive
x900	positive
handverlesen	positive
webclient	positive
spaaaaaass	positive
shed	positive
backofenreste	positive
nachfragend	negative
flach.	negative
endbach	positive
razerlikes	negative
peazip	positive
einsammel	positive
schliessen	positive
aktionsangebote	positive
konkurrierend	positive
kleidest	negative
unfallschwerpunkt	positive
ichrasteaus	positive
togetha	positive
knalliger	positive
kopflose	positive
hobbie	positive
seiht	negative
nach	positive
detaillierter	positive
maunz	positive
verleasen	positive
kannse	negative
geizig	negative
fighting	positive
schurigeln	negative
kujonieren	negative
modifiziert	positive
malträtieren	negative
bufon	positive
augenkrebs	positive
idioten	negative
kredenzen	negative
widerrufen	positive
beeindruckend	positive
sommerwetter	negative
schaffen.	negative
bedienungsanleitung	positive
unterhaltsam	positive
frauenheld	positive
seicht	negative
ec	negative
prickeln	negative
essbar	positive
sofort	positive
verlauf	negative
werten	positive
neuwertig	positive
wissta	positive
bedudeln	positive
beschwipsen	positive
schmerzhaft	negative
alltagstauglich	positive
kindlich	negative
sweet	positive
ballverlust	negative
initiativ	positive
kneifen	negative
innit	positive
einkaufswagen	negative
differenz	positive
krebsen	positive
irrational	positive
objektiv	positive
zigaretten	positive
suess	positive
tage.	positive
hierhin	positive
dia	negative
bspw.	negative
deutschsprachig	positive
matthis	negative
brust	negative
lesenswert	positive
heuschnupfen	positive
simpel	positive
offline	positive
ausfallen	positive
verpeilt	positive
erkranken	negative
sympatisch	positive
sommerlich	positive
aussenssen	negative
teuer	negative
vorsetzen	negative
dobryy	positive
ordnungsgemäss	positive
vertreten	positive
tapfer	negative
isalachi	positive
ekaro	positive
popejnr	positive
gliedmasse	negative
backups	negative
reichlich	positive
aufmischen	positive
ausseh	positive
verleger	negative
vieleicht	positive
warm	positive
beraten	positive
zentral	positive
guuuut	positive
sonnen	positive
unbedarft	negative
exklusiv	positive
verscheissen	negative
schulisch	negative
arbeitslos	negative
vielschichtig	positive
pscht	negative
ansaufen	positive
aah	negative
betrunken	negative
negativ.	negative
zeiten	negative
unfrei	negative
diskriminierend	negative
awwwwww	negative
zuversichtlich	positive
bauchmuskel	negative
zerkauen	positive
traktieren	negative
kanapee	negative
quacksalbern	negative
moralisierend	positive
kronland	positive
königsgut	positive
krongut	positive
vorab	positive
duster	negative
verstehts	positive
umlaut	negative
kane	positive
bequem	positive
viiieeel	positive
machend	positive
ausholen	negative
bverfg	positive
16v_	positive
betrinken	positive
richtig.	positive
yan	negative
konstruiert	negative
extremität	negative
träumen	negative
stimmungsvoll	positive
fronhof	positive
frauenfeindlich	negative
cool	positive
rotherbaum	negative
onanie	negative
verlernen	negative
anschaulich	positive
tiefsinnig	positive
unbezahlbar	positive
einschliesslich	negative
schnappen	negative
rechteckig	positive
konstrukt	positive
barbar	negative
nagelneu	positive
kush	positive
verhungern	negative
begabt	positive
kills	positive
coo	positive
vorderseite	negative
mumbi	positive
unkompliziert	positive
kompe	positive
armlehne	negative
lesenswerten	positive
goldig	positive
streamer	negative
wechseljahr	positive
verfahren	negative
aufregend	positive
soso	positive
bescheiden	negative
einzig	negative
wohlgemuth	positive
einzigartigsten	positive
nexus4	positive
supporten	negative
grenzwertig	negative
fliegengitter	negative
vernetzter	positive
freundlich.	positive
umwickeln	negative
schuld	positive
funktionierend	positive
zureden	negative
morris	positive
schauen	positive
selbstbewusst	positive
frollein	negative
wirkung	positive
schn	positive
tuff	negative
martern	negative
telefonnummer	positive
schippe	negative
geschwollen	negative
beklemmend	positive
passform	positive
untertreiben	positive
ablichtung	negative
evident	positive
lederig	positive
srk	negative
geschweigedenn	positive
angry	negative
gechillter	positive
disskutieren	positive
beschreibend	positive
doggi	positive
bewundern	negative
bekloppt	positive
verehrtester	positive
segensreich	positive
sof	negative
reisend	positive
konstant	positive
bezweifel	positive
tolligste	positive
gottgleich	positive
durchgeknallter	positive
vorteilhaft	positive
dreiseitenkipper	positive
bb22012	positive
andersartige	positive
heeeeeey	positive
hoffen	positive
umzugswagen	positive
stimmungstief	positive
breit	positive
spitzfindigkeit	positive
stressig.	negative
schönling	positive
dieletztefahrt	positive
fotografen	positive
steinway	positive
drunterschreiben	positive
slmt	positive
stubi	positive
gemeingut	positive
zufri	positive
zurückschwingen	positive
gnite	positive
rundenzeit	positive
legitimieren	negative
gunstig	positive
desgleichen	positive
prowein	positive
primeval	negative
rohrzangen	positive
uhs	positive
mut.	positive
anhabt	positive
gutgut	positive
ruhiger.	positive
regierender	positive
neinsager	positive
euro7	positive
pfuh	positive
amarok	positive
trololololol	positive
essenseinladung	positive
schlossern	positive
euli	positive
kindatz	positive
huuuuuuui	positive
kuschelchen	positive
umask	positive
spruechen	positive
verrats	positive
bosshaft	positive
lohnsenkung	positive
crossfade	positive
vieeeeel	positive
jellybean	negative
ankommt.	positive
stil.	negative
neoliberaler	positive
fotografisch	positive
neonschwarz	negative
erwischst	negative
morning	positive
mutig	positive
aussperren	negative
personaldebatte	negative
mobiliar	negative
täuschen	negative
mimimimimi	negative
schlauste	positive
fesselnd	positive
windfrei	positive
pusteblume	negative
verdammen	positive
unspielbar	positive
meeresfrucht	positive
kampfsystem	negative
problemlos	positive
unvermeidlich	negative
exen	negative
erlernen	positive
verleugnen	negative
pfiffig	negative
berauschend	positive
7-	positive
besuchbar	positive
unterschreiben	positive
cz	negative
derb	positive
esta	positive
leidenschaftslos	positive
imm	positive
organisieren	positive
harmlos	positive
einverstanden	positive
detailliert	positive
offe	positive
fetzen	positive
nachname	positive
hasten	positive
gud	positive
natuerlich	positive
bevorzugung	negative
schmerzvoll	negative
justinbieber	negative
zusaufen	positive
nadjasummer	positive
staiger	positive
zuschütten	positive
kniebeuge	negative
hmh	positive
arbeitskollegin	positive
verschollen	negative
praxisnah	positive
zusehen	negative
abbild	positive
komp	positive
verprügeln	positive
vermöbeln	positive
verplästern	positive
durchprügeln	positive
christlich	negative
aluminium	positive
eule	negative
blubb	positive
handlich	positive
kirre	negative
gogo	positive
entsprechend	positive
roboter	negative
japanisch	positive
unterleib	negative
gpu	negative
auspressen	negative
kalauern	negative
austrocknend	positive
fami	positive
unscheinbar	positive
beinbruch	negative
ipv6	negative
intern	positive
auseinander	positive
remixe	positive
tafeln	positive
ehem	negative
wild	positive
elfmeter	positive
ente	positive
badewanne	positive
funzt	positive
positionieren	negative
grillgut	positive
wertige	positive
zweitwagen	negative
matschen	negative
artikulieren	negative
verkackt	negative
körperteil	negative
released	negative
verheiraten	positive
langweile	negative
blühen	positive
gest	negative
je	positive
alo	positive
teuflisch	positive
lie	positive
reizvoll	positive
pfui	negative
andrehen	positive
noche	positive
guardian	negative
fesch	positive
schreibfehler	negative
skurril	positive
gnyden	positive
dobrautra	positive
sarkastisch	positive
singend	positive
intus	positive
verbrannt	negative
riecher	positive
langwierig	negative
leidend	negative
ostertag	negative
schmerzlos	positive
sprunghaft	negative
mögen	positive
geschmeidig	positive
kontrovers	positive
kinski	positive
drama	negative
also	positive
trainieren	positive
hacienda	positive
efeu	negative
versucht	positive
dennoch	negative
dir.	positive
schlimm	negative
schmeck	positive
geistreich	positive
oha	negative
wetterfest	positive
erfahren	positive
hat.	positive
dementi	negative
les	positive
potent	positive
gon	positive
unangebracht	negative
neeeeee	negative
italienisch	positive
sinn	negative
bedauerlich	negative
efz	positive
large	negative
weder	negative
do	negative
wach	negative
verstauchen	negative
twitteraccount	positive
akzeptiert	positive
ufff	positive
durchleuchten	negative
patt	negative
oooch	positive
bias	negative
drangsalieren	negative
disziplinierter	positive
hofnarr	negative
i3	positive
nahct	positive
tschpss	positive
fitnesstraining	positive
trek	negative
burberry	positive
hart	negative
erfolg	positive
durchhauen	positive
faz	negative
halb	positive
braunhaarig	positive
telegraphieren	positive
zutraulich	positive
schnuckelige	positive
bankrott	negative
auflockern	positive
beeindruckender	positive
schnitzeln	positive
erweitert	positive
beliebter	positive
maximal	positive
steilheck	positive
treum	positive
raser	positive
beklagen	positive
leuchtturmprojekt	positive
zugreifen	positive
international	positive
tagesschau	positive
samples	negative
selbstlos	positive
dicho	positive
vergehend	positive
anstauben	negative
oberwil	positive
jehts	positive
casio	negative
existenzsichernd	positive
jedenfalls	positive
superspannend	positive
dankee	positive
aaaaaw	positive
arbeitsuchende	positive
awwe	positive
perfektionismus	positive
zweitgut	positive
verwickeln	negative
kalifornisch	positive
konservative	negative
knudsen	positive
tolino	positive
yammi	positive
foursquare	positive
prost.	positive
lizenzfreie	positive
aufreibend	positive
witzisch	positive
blond.	positive
getaggt	positive
euro6	positive
kalah	positive
vollbusig	positive
tanzi	positive
friedrichstr	positive
traume	positive
laphroaig	positive
doofland	positive
colorieren	positive
spiegelverkehrt	negative
ermutigst	positive
vokalisieren	positive
trickbuch	positive
fresse.	positive
dimensionieren	positive
wertstoff	positive
oke2	positive
semra	positive
sollts	negative
amiando	positive
schmiedeeisern	positive
peps	positive
pachur	positive
wiederlesen	positive
club.	negative
umformulieren	positive
hrrhrr	positive
qualli	negative
guuuuuut	positive
strigoi	positive
maitenbeth	positive
versauter	positive
protease	positive
erhalt	positive
handspiel	negative
aaawww	positive
werbesong	positive
postoperativ	positive
bodylift	positive
albtraum	positive
feire	positive
ahahahahahahahahaha	positive
nomau	positive
gesicht	negative
grr	negative
ansehnlich	positive
charmant	positive
verrenken	negative
pagi	positive
erlebt.	negative
vorgehen	positive
zimperlich	positive
turner	negative
benutzerfreundlich	positive
sinvoll	positive
effektiv	positive
unerwartet	positive
vet	positive
katastrophal	negative
bange	positive
ugh	negative
kulinarische	positive
conny	positive
salben	negative
ahoi	positive
wallen	negative
paradox	positive
havel	positive
ausgeschlafen	positive
netzkabel	positive
wohlhabend	positive
va	positive
unkreativ	negative
bentley	positive
habs	positive
fut	positive
kendall	negative
tvtotal	negative
wor	positive
sonnensystem	positive
katzenbilder	negative
jackie	negative
zitternd	negative
magenkrampf	negative
unbedeutend	negative
langatmig	negative
stark	positive
stammeln	negative
geschlafen.	negative
gruselig	negative
eitel	negative
wendel	positive
rawr	negative
gluck	positive
altmodisch	positive
tessa	positive
bisexuell	negative
andauernd	positive
nordkoreaner	positive
parteilich	positive
farbenfroh	positive
miture	positive
morogeni	positive
schummeln	negative
mwalalapo	positive
mwapenduka	positive
otl	negative
beruhigt	positive
lattenrost	positive
wright	negative
absurd	negative
flair	positive
verifizieren	positive
kultiviert	positive
offenkundig	positive
schlechte	positive
ausstrecken	negative
verpassen	positive
rauchfrei	negative
trefflich	positive
gelsenkirchen	positive
notgeil	positive
klum	negative
zugausfall	negative
wol	positive
ernstnehmen	positive
leicht	negative
rant	negative
yum	negative
hexen	positive
wuchern	negative
klarkommen	positive
nabend	positive
aufklappen	negative
something	positive
bunt	positive
lokal	positive
fussmassage	positive
diesdas	positive
finster	negative
hagebutte	positive
januar	negative
sony	negative
unterdurchschnittlich	negative
gereizt	negative
finanzverhalten	positive
trotzen	negative
benutzbar	positive
geschlossen	negative
aww	positive
mma	positive
sp	negative
formuliert	positive
kommts	positive
kleinkind	negative
interessant	positive
lesbar	positive
launig	positive
tauglich	positive
gebs	positive
verteufeln	negative
rechtzeitig	positive
klei	positive
vorbereiten	positive
mille	negative
sanft	positive
zeitgerecht	positive
pointiert	positive
evangelisch	positive
winkelschleifer	positive
selbstbeweihräucherung	positive
anstellig	positive
cloud	negative
unbenut	positive
versumpfen	negative
meteor	negative
sturzfrei	positive
telegrafieren	positive
selbstdarsteller	positive
anti	negative
smart	positive
industrieland	positive
ooc	negative
warren	negative
pflegen	positive
menschen.	negative
casillas	negative
ders	positive
ricky	positive
benutzter	positive
freundinen	positive
sprechend	positive
ale	negative
unfallfrei	positive
hausgemacht	positive
pippin	positive
massiv	positive
ausdau	positive
gespame	positive
steba	positive
ouch	positive
tiefenentspannt	positive
blasenpflaster	positive
ausgeschalten	positive
wohlbehalten	positive
achja	positive
dekoideen	positive
fangertrag	positive
stehauf	positive
kulturplatz	negative
evet	positive
verlottern	negative
klimper	positive
kretzschmar	positive
joooo	negative
pencils	positive
temperieren	positive
ltr.	positive
oha.	positive
schatziii	positive
slow	positive
trinkfest	positive
zulassungsstelle	positive
madness	negative
sitzverkleinerer	positive
hundredth	negative
erst	positive
alls	positive
avef	positive
babyruf	positive
epische	positive
schnibbel	positive
informierst	positive
jelek	positive
energieerhaltungssatz	positive
ringgit	positive
taufrisch	negative
eigentl	negative
hahahahahahahah	positive
heuberg	positive
monophthongieren	positive
prozent	negative
redtube	negative
sterbi	positive
heir	positive
najaaa	negative
webshow	positive
spielpraxen	negative
fahrbereit	positive
cuprum	positive
laggs	negative
braunton	negative
gesundheitsfördernd	positive
milchen	positive
manche	positive
gezeichnet	negative
dormagen	negative
dynamisch	positive
gesundheitsförderlich	positive
makler	negative
viel	positive
schnappschuss	positive
mhhhhh	positive
schwedt	positive
arbeitslose	negative
bewegend	positive
richtigkeit	positive
faber	negative
kok	positive
wohoo	negative
handytasche	negative
berechenbar	negative
letter	negative
fernbus	positive
harlem	negative
xovi	positive
schlank	positive
pump	negative
erholsam	positive
crap	positive
adäquat	positive
buff	positive
engen	positive
lebenserfahrung	negative
monoton	negative
gezielt	positive
schneidend	positive
bauchfrei	positive
schwanger	negative
abwerten	negative
unlogisch	negative
bm	positive
anrühren	negative
rasch	positive
allsecur	positive
ungenutzt	negative
grob	positive
austoben	positive
egoist	negative
shadow	negative
barrierefreiheit	positive
lehrreich	positive
peinigen	negative
beeinflussen	negative
knie	negative
effiziente	positive
olla	positive
minikleid	positive
unerfahren	positive
w3c	positive
mitwitz	positive
stimmgewaltig	negative
platzen	positive
bissl	positive
kriegste	positive
conrad	positive
therapeutin	positive
durchdenken	positive
herzzerreissend	positive
credits	positive
hinabblicken	positive
tollpatschig	positive
schlappe	positive
radfahrer	negative
besondere	negative
juchhu	positive
yo	positive
erfolgreiche	negative
eher	positive
nachvollziehbar	positive
tollste	positive
trade	positive
vorstellung	negative
haltung	negative
zerfetzen	negative
small	negative
bedanken	positive
schiffsfracht	positive
exportgut	positive
strange	positive
serious	positive
handelsgut	positive
spannender	positive
banal	negative
sachen	positive
ding	positive
karottensuppe	positive
rai	positive
reizend	positive
unlust	negative
verletzlich	positive
dutzende	negative
neugierig	negative
auweia	negative
beispiel	positive
350-	positive
kippe	negative
vorgeschichte	negative
verdreschen	positive
radikal	negative
ideal	positive
orrrr	negative
fasziniert	negative
pfff	negative
ankreuzen	positive
entspinnen	positive
ununterbrochen	positive
demokratisch	positive
komik	positive
gesundheitsdienlich	positive
zweck	negative
dekadent	positive
gefühl	negative
hören	negative
verwahrlosen	negative
zorn	negative
vorfertigen	positive
einheitlich	negative
wirksam	positive
beobachter	positive
kenia	positive
nerven	negative
nech	positive
bitchig	positive
bevormundung	negative
erbsencreme	positive
oan	positive
kellnern	negative
bpt	positive
emotionalste	positive
wiegen	positive
philosophisch	negative
partyy	positive
moin.	positive
wasn	positive
kardiologen	positive
zerfressen	negative
quälen	negative
markttransparenz	positive
erfolgre	positive
anstrengung	positive
busted	positive
meinung.	positive
sozialkritisch	positive
anschaubar	positive
dudeens	positive
griessbrei	negative
menschen	negative
welche	positive
bebildert	positive
haaaa	positive
quickly	positive
kommunistisch	positive
stylischer	positive
logisat	positive
umso	positive
restsamstag	positive
betrunke	positive
wooo	positive
honeypot	positive
zumind.	positive
gammele	positive
tsch	positive
freakig	positive
ausschildern	positive
obendrauf	positive
voll	positive
levante	positive
promarkt	positive
neocitran	positive
baphomets	positive
luftbereifung	positive
okidoki	positive
steff	positive
nachtiiii	positive
freshness	negative
longplayer	positive
hochformat	negative
shettysattel	positive
drogo	negative
bewirbst	positive
yeahhhh	positive
einfühlen	positive
temperamentvoll	positive
angepisster	positive
ama	negative
kabar	positive
schlagfertig	positive
gemeint.	negative
right	positive
symphatischer	positive
mhm	positive
wunderlich	positive
lebend	positive
xsplit	negative
vorhersehbar	positive
mehlig	negative
denken	negative
mw2	positive
entspannender	negative
meg	positive
gsehn	positive
jule	positive
erziehen	positive
scherz	negative
inklusive	negative
beschmieren	negative
schnell	positive
aussehend	positive
chillige	positive
vertun	negative
fuckt	negative
leck	positive
pedal	positive
unflexibel	positive
prellung	negative
verdienst	positive
schnitzeljagd	positive
mittelmass	positive
schwanzlutscher	negative
einsam	negative
sowohl	positive
spitz	negative
ivana	negative
benden	positive
meilenweit	positive
alexander	negative
tastaur	negative
kinderlieb	positive
sinnfrei	positive
frederik	positive
erwachsen	positive
bye	positive
beunruhigt	negative
lerchenberg	positive
rot	negative
kriterium	negative
geniessen	positive
fast	positive
scrollt	negative
dra	negative
beweglich	negative
topfit	positive
