abbaubar	positive
abbauwürdig	positive
aberwitzig	negative
abgebrannt	negative
abgerissen	negative
abgestimmt	positive
abgewrackt	negative
abscheulich	negative
abstrus	negative
absurd	negative
abzugsfähig	positive
achtbar	positive
achtsam	positive
adäquat	positive
aggressiv	negative
agil	positive
aktiv	positive
akzeptabel	positive
allegro	positive
allerlei	positive
amateurhaft	negative
amoralisch	negative
anbaufähig	positive
angeberisch	negative
angeblich	negative
angebracht	positive
angemessen	positive
angezeigt	positive
angriffslustig	negative
annehmbar	positive
anrechnungsfähig	positive
anrüchig	negative
arbeitsam	positive
arbeitsfreudig	positive
arbeitswillig	positive
arglistig	negative
arg	negative
arkadisch	positive
arm	negative
armselig	negative
ätzend	negative
aufgebraucht	negative
aufhetzend	negative
aufladbar	positive
aufrecht	positive
aufrichtig	positive
aufwiegelnd	negative
ausbaufähig	positive
auserkoren	positive
auserlesen	positive
ausersehen	positive
auserwählt	positive
ausgelassen	positive
ausgesucht	positive
ausgewogen	positive
ausgezeichnet	positive
aussichtsreich	positive
auswertbar	positive
barmherzig	positive
barsch	negative
bedenkenswert	positive
bedienbar	positive
befehlsgemäss	positive
beflissen	positive
befreit	positive
begründbar	positive
begründet	positive
begrüssenswert	positive
behindertengerecht	positive
beihilfefähig	positive
benutzbar	positive
berauschend	positive
berechtigt	positive
beruhigt	positive
bescheiden	negative
beschissen	negative
bespielbar	positive
bestechend	positive
bestechlich	negative
bestimmungsgemäss	positive
betriebsam	positive
bettelarm	negative
bildhübsch	positive
bildschön	positive
bissig	negative
bitterarm	negative
blankgeputzt	negative
blank	negative
blendend	positive
blitzblank	negative
blitzeblank	negative
börsenfähig	positive
bösartig	negative
böse	negative
boshaft	negative
böswillig	negative
brauchbar	positive
chancenlos	negative
chancenreich	positive
charakterlos	negative
dahergelaufen	negative
dämonisch	negative
danebengegangen	negative
dankbar	positive
deformiert	negative
dekorativ	positive
demagogisch	negative
deplatziert	negative
deplaziert	negative
diabolisch	negative
dienlich	positive
diensteifrig	positive
differenziert	positive
dilettantisch	negative
distinguiert	positive
draufgängerisch	negative
drittklassig	negative
drollig	positive
druckfähig	positive
echt	positive
edelmütig	positive
edel	positive
effektiv	positive
ehrbar	positive
ehrenhaft	positive
ehrenvoll	positive
ehrenwert	positive
ehrlich	positive
ehrlos	negative
eifrig	positive
eilfertig	positive
einvernehmlich	positive
eiweissarm	negative
ekel erregend	negative
ekelerregend	negative
ekelhaft	negative
eklig	negative
elefantös	positive
elendig	negative
elend	negative
empfehlenswert	positive
empörend	negative
emsig	positive
endgeil	positive
entsetzlich	negative
entstellt	negative
entwicklungsgemäss	positive
entwürdigend	negative
erbärmlich	negative
erfolglos	negative
erfolgreich	positive
erfolgsgewöhnt	positive
erfolgsverwöhnt	positive
erfolg versprechend	positive
erfolgversprechend	positive
erfreulich	positive
ergebnislos	negative
ergebnisreich	positive
erhaben	positive
erkoren	positive
erlaucht	positive
erlebbar	positive
erleichtert	positive
erlernbar	positive
erlogen	negative
erlöst	positive
erneuerbar	positive
ernsthaft	positive
erschliessbar	positive
erstattungsfähig	positive
erstklassig	positive
erstrebenswert	positive
erweiterbar	positive
erweiterungsfähig	positive
experimentierfreudig	positive
exzellent	positive
fachgemäss	positive
fachgerecht	positive
fadenscheinig	negative
fair	positive
fälschlich	negative
falsch	negative
famos	positive
fehlerhaft	negative
fehlgeschlagen	negative
fehlleitend	negative
fein geschnitten	positive
feingeschnitten	positive
fettarm	negative
fettig	negative
fies	negative
findig	positive
flau	negative
fleischarm	negative
fleischlich	positive
fleissig	positive
förderlich	positive
fördernd	positive
förderungswürdig	positive
förmlich	positive
forsch	negative
frank	positive
freudig	positive
friedfertig	positive
friedlich	positive
friedliebend	positive
friedvoll	positive
froh gestimmt	positive
frohgestimmt	positive
fröhlich	positive
froh	positive
fulminant	positive
fündig	positive
furchtbar	negative
fürchterlich	negative
gammelig	negative
gammlig	negative
garstig	negative
gebührend	positive
gedeihlich	positive
geeignet	positive
gefälscht	negative
gehässig	negative
gehoben	positive
gekonnt	positive
geländegängig	positive
gelehrig	positive
gelogen	negative
gelungen	positive
gemein	negative
genehm	positive
geraten	positive
gerechtfertigt	positive
gerecht	positive
geringwertig	negative
geschäftig	positive
geschäftstüchtig	positive
geschmackvoll	positive
gesetzt	positive
gespielt	negative
gesucht	positive
gewalttätig	negative
gewienert	negative
gewinnbar	positive
glänzend	positive
glimpflich	positive
glorreich	positive
glücklich	positive
glücklos	negative
glückreich	positive
glückselig	positive
glückstrahlend	positive
goldig	positive
grandios	positive
grauslich	negative
griesgrämig	negative
griffig	positive
grobschlächtig	negative
grossartig	positive
grossherzig	positive
grosskotzig	negative
grossmäulig	negative
grossspurig	negative
grottenschlecht	negative
grottig	negative
grundfalsch	negative
grundlos	negative
gutartig	positive
gutherzig	positive
gütig	positive
gütlich	positive
gutmütig	positive
gut	positive
hämisch	negative
handlich	positive
hasserfüllt	negative
hässlich	negative
hehr	positive
heilfroh	positive
heimtückisch	negative
heiter	positive
herausfordernd	negative
herausragend	positive
herrlich	positive
hervorragend	positive
herzensgut	positive
herzig	positive
hetzerisch	negative
himmelschreiend	negative
himmlisch	positive
hinnehmbar	positive
hirnrissig	negative
hochklassig	positive
hochwertig	positive
hochzufrieden	positive
hoffähig	positive
höhnisch	negative
honett	positive
honorabel	positive
honorig	positive
hübsch	positive
humorig	positive
humorvoll	positive
ideal	positive
idyllisch	positive
illegitim	negative
impertinent	negative
inadäquat	negative
inakzeptabel	negative
ineffektiv	negative
insolvent	negative
instandsetzbar	positive
internetfähig	positive
intersubjektiv	negative
irreführend	negative
irregulär	negative
irrig	negative
irritierend	negative
irrtümlich	negative
irrwitzig	negative
jämmerlich	negative
kalorienarm	negative
kampfeslustig	negative
kampflustig	negative
katastrophal	negative
käuflich	negative
klasse	positive
kleidsam	positive
klobig	negative
klotzig	negative
knuffig	positive
kombinierbar	positive
konform	positive
konkordant	positive
konkurrenzfähig	positive
kontrafaktisch	negative
korrekt	positive
korrekturbedürftig	negative
korrupt	negative
kriegerisch	negative
kümmerlich	negative
kunstfertig	positive
lagerfähig	positive
laienhaft	negative
läppisch	negative
lästig	negative
lausig	negative
lauter	positive
lautstark	negative
lebensbejahend	positive
lebensfeindlich	negative
lebensfroh	positive
lebenslustig	positive
lebenstüchtig	positive
legendär	positive
legendenhaft	positive
leidig	negative
leid	negative
leistungsfördernd	positive
liebenswert	positive
liebenswürdig	positive
liebesfähig	positive
liebevoll	positive
lieb	positive
liebreich	positive
lobenswert	positive
löblich	positive
lohnend	positive
lohnenswert	positive
lötfähig	positive
lumpig	negative
lustbetont	positive
lustig	positive
lustvoll	positive
luziferisch	negative
magnetisierbar	positive
malerisch	positive
maliziös	negative
mancherlei	positive
mannschaftsdienlich	positive
mannschaftstauglich	positive
märchenhaft	positive
marktbeherrschend	positive
marktfähig	positive
marktführend	positive
massgerecht	positive
massgeschneidert	positive
massstäblich	positive
massstabsgetreu	positive
massvoll	positive
mau	negative
meisterhaft	positive
meisterlich	positive
mephistophelisch	negative
methodisch	positive
miesepetrig	negative
mies	negative
minderwertig	negative
mischbar	positive
miserabel	negative
misslungen	negative
missraten	negative
mistig	negative
moderat	positive
muffelig	negative
mundgerecht	positive
mythisch	positive
nachahmenswert	positive
nährstoffarm	negative
naturgetreu	positive
negativ	negative
nervig	negative
nervtötend	negative
nett	positive
netzwerkfähig	positive
neuwertig	positive
nichtig	negative
nichtsnutzig	negative
niederträchtig	negative
niedlich	positive
normgemäss	positive
nutzbar	positive
nutzbringend	positive
nützlich	positive
nutzlos	negative
offensiv	negative
okay	positive
ölig	negative
oligotroph	negative
oll	negative
opportun	positive
ordentlich	positive
ordnungsgemäss	positive
ordnungsliebend	positive
panzerbrechend	positive
paradiesisch	positive
parteiisch	negative
passabel	positive
passend	positive
pedantisch	positive
penibel	positive
perfekt	positive
perspektivreich	positive
phänomenal	positive
pickelig	negative
pompös	positive
popelig	negative
poplig	negative
positiv	positive
possierlich	positive
potthässlich	negative
prächtig	positive
prachtvoll	positive
prädestiniert	positive
prahlerisch	negative
praktikabel	positive
prätentiös	negative
praxisgerecht	positive
preisgekrönt	positive
prima	positive
provokativ	negative
provozierend	negative
prunkhaft	positive
prunkvoll	positive
putzig	positive
qualitätsvoll	positive
qualitätvoll	positive
quietschvergnügt	positive
ratsam	positive
reaktionsfähig	positive
rechtschaffen	positive
redlich	positive
regelgemäss	positive
regelgerecht	positive
regulär	positive
reinlich	positive
renovierbar	positive
richtig	positive
rohstoffarm	negative
ruchbar	negative
rühmlich	positive
ruhmreich	positive
ruhmvoll	positive
sachfremd	negative
sachgemäss	positive
sachgerecht	positive
sagenhaft	positive
sanftmütig	positive
satanisch	negative
satzungsgemäss	positive
säuberlich	positive
schäbig	negative
schadenfroh	negative
scharfzüngig	negative
scheusslich	negative
schiefgegangen	negative
schiefgelaufen	negative
schlecht	negative
schlimm	negative
schmuck	positive
schmuckvoll	positive
schmuddelig	negative
schnippisch	negative
schnoddrig	negative
schnöde	negative
schön	positive
schrecklich	negative
schurkisch	negative
schwindlig	negative
seelig	positive
sensationell	positive
seriös	positive
servil	positive
sexy	positive
siegreich	positive
singbar	positive
sinnentstellend	negative
sinngemäss	positive
sinngetreu	positive
sinnhaft	positive
sinnig	positive
sinnlich	positive
sinnlos	negative
sinnreich	positive
sinnvoll	positive
sintflutartig	negative
situationsgerecht	positive
sorgfältig	positive
sorgsam	positive
speicherbar	positive
spitzenmässig	positive
spitze	positive
spitzfindig	negative
spitz	negative
spöttisch	negative
standesgemäss	positive
statthaft	positive
statutengemäss	positive
stichhaltig	positive
stiefmütterlich	negative
stilgerecht	positive
stilsicher	positive
stilvoll	positive
stimmig	positive
sträflich	negative
strafwürdig	negative
strähnig	negative
streitlustig	negative
streitsüchtig	negative
stümperhaft	negative
subjektiv	negative
subsidiär	positive
süffisant	negative
superior	positive
süss	positive
tadelnswert	negative
tanzbar	positive
tatkräftig	positive
tauglich	positive
täuschend	negative
teilbar	positive
tendenziös	negative
teuflisch	negative
tragisch	negative
traumatisch	negative
traumatisierend	negative
traumhaft	positive
treffend	positive
trefflich	positive
treffsicher	positive
trügerisch	negative
tüchtig	positive
tückisch	negative
tugendhaft	positive
tugendlich	positive
tugendreich	positive
übel	negative
übereifrig	positive
überglücklich	positive
überlegen	positive
übermächtig	positive
überragend	positive
umgekehrt	negative
umsichtig	positive
umweltgerecht	positive
unakzeptabel	negative
unangebracht	negative
unangemessen	negative
unannehmbar	negative
unansehnlich	negative
unappetitlich	negative
unästhetisch	negative
unattraktiv	negative
unautorisiert	negative
unbefugt	negative
unbegründet	negative
unberechtigt	negative
unbescholten	positive
unbillig	negative
unblutig	positive
undankbar	negative
unecht	negative
unedel	negative
unehrenhaft	negative
uneinholbar	positive
unerhört	negative
unerreichbar	positive
unerreicht	positive
unfähig	negative
unfair	negative
unfehlbar	positive
unförmig	negative
unfreundlich	negative
ungeeignet	negative
ungehörig	negative
ungelegen	negative
ungepflegt	negative
ungerechtfertigt	negative
ungerecht	negative
ungeschlacht	negative
ungetrübt	positive
ungezogen	negative
unglücklich	negative
ungünstig	negative
ungut	negative
unkorrekt	negative
unnachahmlich	positive
unnützlich	negative
unpassend	negative
unprofessionell	negative
unrechtmässig	negative
unrecht	negative
unrühmlich	negative
unsachgemäss	negative
unschön	negative
unsinnig	negative
unstandesgemäss	negative
unstimmig	negative
untadelig	positive
untadlig	positive
untauglich	negative
unternehmungslustig	positive
unterstützend	positive
unübertrefflich	positive
unübertroffen	positive
unverdient	negative
unverdorben	positive
unverfroren	negative
unverhältnismässig	negative
unverrichtet	negative
unverschämt	negative
unvertretbar	negative
unvorteilhaft	negative
unwahr	negative
unwürdig	negative
unziemlich	negative
unzuständig	negative
unzutreffend	negative
unzweckmässig	negative
vaterlandslos	negative
verabscheuungswürdig	negative
verantwortbar	positive
verarbeitbar	positive
verarmt	negative
verbraucht	negative
verehrungswürdig	positive
verfehlt	negative
verformt	negative
vergammelt	negative
vergnügt	positive
verheerend	negative
verheissungsvoll	positive
verkaufsfördernd	positive
verkehrt	negative
verkommen	negative
verlebt	negative
verleumderisch	negative
verlockend	positive
verlottert	negative
verlumpt	negative
vermeintlich	negative
vernichtend	negative
verschwitzt	negative
verteufelt	negative
vertretbar	positive
verwachsen	negative
verwahrlost	negative
verwertbar	positive
verwirrend	negative
viele	positive
vielerlei	positive
vielversprechend	positive
vierschrötig	negative
viertklassig	negative
virtuos	positive
vitaminarm	negative
vollmundig	negative
vorbestimmt	positive
voreingenommen	negative
vorgeblich	negative
vorgeschoben	negative
vorgetäuscht	negative
vorlaut	negative
vorschriftsgemäss	positive
vorschriftsmässig	positive
vortrefflich	positive
vorzüglich	positive
wachstumsfördernd	positive
waffenfähig	positive
wählbar	positive
wahrhaftig	positive
wahrhaft	positive
wahrheitsgemäss	positive
wahrheitsgetreu	positive
wahr	positive
wasserarm	negative
wertig	positive
wertlos	negative
wettbewerbsfähig	positive
wichtigtuerisch	negative
widerlich	negative
widerwärtig	negative
widrig	negative
wohl geformt	positive
wohlgeformt	positive
wohlproportioniert	positive
wolkenbruchartig	negative
wortgemäss	positive
wortlautgemäss	positive
wunderbar	positive
wunderschön	positive
wundervoll	positive
wünschenswert	positive
würdelos	negative
würdevoll	positive
zahlungsunfähig	negative
zänkisch	negative
zanksüchtig	negative
zärtlich	positive
zerbeult	negative
zerlumpt	negative
zivil	positive
zufrieden	positive
zukunftsfähig	positive
zünftig	positive
zutreffend	positive
zweckfrei	negative
zweckgemäss	positive
zwecklos	negative
zweckmässig	positive
zweitklassig	negative
zynisch	negative
