1000-fach	positive
100-fach	positive
100%ig	positive
100-prozentig	positive
10-fach	positive
10-malig	positive
12-fach	positive
2-fach	positive
2-malig	positive
3-fach	positive
3-malig	positive
4-fach	positive
4-malig	positive
5-fach	positive
5-malig	positive
6-fach	positive
6-malig	positive
7-fach	positive
7-malig	positive
8-fach	positive
8-malig	positive
9-fach	positive
9-malig	positive
aalglatt	negative
abbaubar	positive
abbauwürdig	positive
abbildbar	positive
abendfüllend	positive
abendhimmel	positive
abenteuerlustig	positive
abermalig	positive
aberwitzig	negative
abfällig	negative
abflauend	negative
abgebrannt	negative
abgebrüht	negative
abgedroschen	positive
abgegriffen	negative
abgehärtet	negative
abgeklärt	positive
abgelaufen	negative
abgelegen	negative
abgemagert	negative
abgemergelt	negative
abgerissen	negative
abgeschieden	negative
abgeschirmt	positive
abgeschlagen	negative
abgeschrägt	positive
abgespannt	negative
abgestimmt	positive
abgewirtschaftet	negative
abgewrackt	negative
abgezehrt	negative
abgezockt	negative
abgründig	positive
abgrundtief	negative
abhängig	negative
abhörsicher	positive
ablehnend	negative
ablesbar	positive
abnehmend	negative
abnutzen	negative
abriebfest	negative
abrufbar	positive
abschätzbar	positive
abschätzig	negative
abscheulich	negative
abschlägig	negative
abschliessbar	positive
abschliessend	positive
abschüssig	positive
absehbar	positive
absetzbar	positive
absinkend	negative
absolutistisch	positive
absolut	positive
abstinent	positive
abstossend	negative
abstrakt	positive
abstrus	negative
absurd	negative
abträglich	negative
abundant	positive
abwechselnd	negative
abweisend	negative
abwesend	negative
abwiegeln	positive
abwracken	positive
abziehbar	positive
abziehen	negative
abzugsfähig	positive
achtbar	positive
achtfach	positive
achtgrösste	positive
achtmalig	positive
achtsam	positive
achtspurig	positive
achtungserfolg	positive
achtzigprozentig	negative
adagio	positive
adaptiv	positive
adäquat	positive
adelig	positive
adel	positive
adipös	positive
adlig	positive
adrett	positive
aerodynamisch	positive
affektiert	negative
affenähnlich	positive
affig	negative
afrikanischer elefant	positive
afro-amerikanisch	negative
afro-amerikanisch	positive
aggressiv	negative
agil	positive
ähnlich	positive
aidskrank	negative
aktenkundig	positive
aktionistisch	positive
aktionsfähig	positive
aktiv	positive
akut	positive
akzentuiert	positive
akzeptabel	positive
akzeptieren	positive
akzessorisch	negative
akzidentell	negative
akzidentiell	negative
alarmierend	negative
albern	positive
albtraum	positive
alkoholabhängig	negative
alkoholkrank	negative
alkohollöslich	positive
alkoholsüchtig	negative
allabendlich	positive
allbekannt	positive
allegretto	positive
allegro	positive
alleinig	negative
allein	negative
allein stehend	negative
alleinstehend	negative
allerbeste	positive
allerhöchste	positive
allerlei	positive
allfällig	negative
allgegenwärtig	positive
allgemein verbindlich	positive
allgemeinverbindlich	positive
allgemeinverständlich	negative
alliiert	positive
alljährlich	positive
allmächtig	positive
allmählich	positive
allmonatlich	positive
allmorgendlich	positive
allseitig	positive
alltäglich	positive
alltagstauglich	positive
allumfassend	positive
allwöchentlich	positive
allzugegen	positive
alptraumartig	negative
alptraumhaft	negative
alptraum	positive
alsbaldig	negative
altadelig	positive
altadlig	positive
altbekannt	positive
altbewährt	positive
altehrwürdig	positive
alternativ	negative
altersgemäss	positive
altersgerecht	positive
altersschwach	negative
alterungsbeständig	negative
altmeisterin	positive
altmeister	positive
altpreussisch	positive
altrosafarben	positive
altrosa	positive
altüberliefert	positive
amateurhaft	negative
amateurmeister	positive
ambivalent	negative
amoralisch	negative
amtlich	positive
amüsant	positive
anachronistisch	negative
analog	positive
anämisch	negative
anbaufähig	positive
andante	positive
andantino	positive
andauernd	positive
änderbar	negative
andere	negative
andersfarbig	positive
andersgeartet	negative
anderthalbfach	positive
anderweitig	negative
anerkannt	positive
anerkennenswert	positive
anfällig	negative
anfangserfolg	positive
anfechtbar	negative
angebbar	negative
angeberisch	negative
angeblich	negative
angebracht	positive
angebunden	positive
angekündigt	positive
angemeldet	positive
angemessen	positive
angenehm	positive
angepasst	positive
angesagt	positive
angeschlagen	negative
angespannt	positive
angestammt	positive
angestrengt	negative
angewiesen	negative
angezeigt	positive
angreifbar	negative
angrenzend	positive
angriffslustig	negative
angst erregend	negative
angsterregend	negative
anhaben	negative
anlehnungsbedürftig	negative
anliegend	positive
anmutig	positive
annehmbar	positive
anonym	negative
anoxisch	negative
anpassbar	positive
anpassungsfähig	positive
anrechnungsfähig	positive
anrüchig	negative
anschaulich	negative
anscheinend	positive
ansehnlich	positive
ansprechend	positive
ansprechen	positive
anspruchsberechtigt	positive
anspruchslos	negative
anständig	positive
ansteigend	positive
anstellig	positive
anstössig	negative
anstrengend	negative
anteilig	negative
anthrazitfarben	positive
anthrazitgrau	positive
anthrazit	positive
anthropomorph	positive
antibiotisch	positive
antideutsch	negative
antiklerikal	negative
antiphlogistisch	positive
antisemitisch	negative
antizyklisch	positive
antun	negative
anwenderfreundlich	positive
anwendungsbeispiel	positive
anwendungszweck	positive
anwesend	positive
anziehend	positive
anzüglich	negative
apart	positive
apfelgrün	positive
apodiktisch	positive
apokryph	negative
appetitlich	positive
apricot	positive
aprikosenfarben	positive
aprikosenfarbig	positive
apriorisch	positive
aquarellfarben	positive
äquivalent	positive
arbeitsam	positive
arbeitsaufwändig	negative
arbeitsaufwendig	negative
arbeitsfähig	positive
arbeitsfreude	positive
arbeitsfreudig	positive
arbeitsintensiv	negative
arbeitsmuster	positive
arbeitsreich	negative
arbeitsscheu	negative
arbeitssüchtig	negative
arbeitsteilig	negative
arbeitsunfähig	negative
arbeitsunwillig	negative
arbeitswille	positive
arbeitswillig	positive
archetypisch	positive
archetyp	positive
archetypus	positive
architekturgeschichtlich	positive
architekturhistorisch	positive
arglistig	negative
arg	negative
argwöhnisch	negative
aristokratisch	positive
arkadisch	positive
armdick	positive
armlang	positive
ärmlich	negative
arm	negative
armselig	negative
aromatisch	positive
arretiert	negative
arteigen	positive
artfremd	negative
artgemäss	positive
artgerecht	positive
artifiziell	negative
artig	positive
aschfahl	negative
aschgrau	positive
asozial	negative
asphaltiert	negative
ästhetik	positive
ästhetisch	positive
astrein	positive
astronomisch	positive
astrophysikalisch	positive
asynchron	negative
ätherisch	negative
athletisch	positive
atmungsaktiv	positive
atommodell	positive
attraktiv	positive
atypisch	negative
ätzend	negative
auberginefarben	positive
aufbrauchen	negative
aufbrausend	negative
aufdringlich	positive
aufeinander folgend	positive
aufeinanderfolgend	positive
auferstehung	positive
auferweckung	positive
auffallend	positive
auffällig	positive
aufführbar	positive
aufgebracht	positive
aufgebraucht	negative
aufgedreht	positive
aufgedunsen	positive
aufgeklärt	positive
aufgekratzt	positive
aufgelöst	positive
aufgeräumt	positive
aufgeregt	positive
aufgeschlossen	positive
aufgeschrieben	positive
aufgesetzt	negative
aufgeteilt	negative
aufgetrieben	positive
aufhebbar	positive
aufhetzend	negative
aufladbar	positive
auflagenstark	positive
auflösbar	positive
auflöslich	positive
aufmerksam	positive
aufmüpfig	negative
aufnahmefähig	positive
aufrecht	positive
aufrichtig	positive
aufrührerisch	positive
aufsässig	negative
aufsehen erregend	positive
aufsehenerregend	positive
aufständisch	negative
auftragsgemäss	positive
aufwändig	negative
aufwendig	negative
aufwiegelnd	negative
aufwieglerisch	positive
augenfällig	positive
augenschädigend	negative
augenschädlich	negative
augenscheinlich	positive
ausbaufähig	positive
ausbildungszweck	positive
ausdauernd	negative
ausdrücklich	positive
ausdrucksfähig	positive
auserkoren	positive
auserlesen	positive
ausersehen	positive
auserwählen	positive
auserwählt	positive
ausfallend	negative
ausführbar	positive
ausführlich	positive
ausgebleicht	negative
ausgebrannt	negative
ausgebucht	positive
ausgebufft	negative
ausgedehnt	positive
ausgeglichen	positive
ausgekocht	negative
ausgelassen	positive
ausgelaugt	negative
ausgemergelt	negative
ausgepowert	negative
ausgeprägt	positive
ausgepumpt	negative
ausgereift	positive
ausgesprochen	positive
ausgesucht	positive
ausgewiesen	positive
ausgewogen	positive
ausgezeichnet	positive
ausgiebig	positive
aushaltbar	positive
ausländerfeindlich	negative
ausländerfreundlich	positive
auslesbar	positive
ausreichend	positive
aussagefähig	positive
aussagekräftig	positive
ausschlaggebend	positive
ausschliesslich	negative
ausschweifend	negative
aussergewöhnlich	positive
ausserordentlich	positive
ausserstande	negative
aussichtsreich	positive
ausverkauft	positive
auswertbar	positive
auszeichnen	positive
autark	positive
autobiografisch	negative
autobiographisch	negative
autokephal	positive
autokratisch	positive
autonom	positive
autoritativ	positive
avantgardistisch	positive
azurblau	positive
bäckermeisterin	positive
bäckermeister	positive
bahnamtlich	positive
bahnbrechend	positive
ballaststoffreich	positive
ballettmeisterin	positive
ballettmeister	positive
banal	negative
bankrott	negative
barbarisch	negative
bärbeissig	negative
bärenstark	positive
bargeldlos	negative
barmherzig	positive
barock	positive
bar	positive
barsch	negative
basal	positive
bauamtlich	positive
bauchig	positive
baufällig	positive
baugleich	positive
baumlang	positive
baureif	negative
beachtbar	positive
beachtenswert	positive
beachtet	positive
beachtlich	positive
beängstigend	negative
bearbeitbar	positive
bedauerlich	negative
bedauernswert	negative
bedeckt	negative
bedenkenswert	positive
bedenklich	negative
bedeutend	positive
bedeutsam	positive
bedeutung	positive
bedeutungsvoll	positive
bedienbar	positive
bedienungsfreundlich	positive
bedrohlich	negative
bedroht	negative
bedröppelt	negative
bedrückend	negative
bedrückt	negative
bedürftig	negative
beeinflussbar	negative
befähigt	positive
befahrbar	positive
befangen	negative
befehlsgemäss	positive
befestigt	positive
beflissenheit	positive
beflissen	positive
befreit	positive
befremdlich	negative
befriedigend	positive
befristet	negative
befugt	positive
begabt	positive
begehbar	positive
begehrenswert	positive
begehrt	positive
begeisterungsfähig	positive
begnadet	positive
begöschen	positive
begossen	negative
begreifbar	negative
begreiflich	negative
begrenzt	negative
begrifflich	positive
begründbar	positive
begründet	positive
begrünt	negative
begrüssenswert	positive
begünstigend	positive
begütert	positive
begütigen	positive
behaglich	positive
behämmert	negative
behandelbar	negative
behandlungserfolg	positive
beharrlich	negative
behebbar	positive
beherrschbar	positive
beherrscht	positive
behilflich	positive
behindertenfeindlich	negative
behindertengerecht	positive
behuf	positive
behütend	positive
beiderlei	negative
beigefarben	positive
beige	positive
beihilfefähig	positive
beiläufig	negative
beinhart	negative
beispielfall	positive
beispielgebend	positive
beispielhaft	positive
beispiellos	negative
beispiel	positive
beispielsfall	positive
beissend	positive
beitragsfrei	positive
bekanntgegeben	positive
bekanntlich	positive
bekannt	positive
bekifft	negative
beklagenswert	negative
beklemmend	negative
beklommen	negative
bekloppt	negative
beknackt	negative
bekömmlich	positive
bekümmert	negative
belämmert	negative
belastbar	positive
belastend	negative
belastet	positive
belastungsfähig	positive
belebt	positive
belegt	negative
beleibt	positive
beleidigend	negative
beleidigen	negative
beleidigt	negative
beleuchtet	positive
bemerkbar	negative
bemerkenswert	positive
bemitleidenswert	negative
benachbart	positive
benennbar	negative
bengalisch	negative
benutzbar	positive
benutzerfreundlich	positive
beobachtbar	negative
bepreisen	positive
bequem	positive
berauschend	positive
berechenbar	positive
berechnet	positive
berechtigt	positive
beredsam	positive
beredt	positive
bereinigt	positive
bereit	negative
bereitstehend	negative
bereitwillig	positive
bergig	positive
bergisch	positive
bergreich	positive
bernsteinfarben	positive
bernsteinfarbig	positive
beruflich	positive
berufsbegleitend	positive
berufsmässig	positive
berufsunfähig	negative
beruhigen	positive
beruhigt	positive
berühmt	positive
besänftigen	positive
beschädigt	negative
beschämt	negative
beschaulich	positive
bescheiden	negative
bescheuert	negative
beschissen	negative
beschlussfähig	positive
beschränkend	negative
beschränkt	negative
beschreibbar	negative
beschuppt	negative
beschwerlich	positive
beschwichtigen	positive
beschwingt	positive
besessen	positive
besetzt	negative
besinnungslos	negative
besondere	negative
besorgniserregend	negative
bespielbar	positive
besser	positive
beständig	positive
bestechend	positive
bestechlich	negative
bestehend	positive
beste	positive
bestialisch	negative
bestimmbar	negative
bestimmend	positive
bestimmt	positive
bestimmungsgemäss	positive
bestmöglich	positive
bestreitbar	negative
betont	positive
betörend	positive
beträchtlich	positive
betreffend	positive
betretbar	positive
betreten	negative
betriebsam	positive
betriebsbereit	negative
betriebseigen	positive
betriebsfähig	positive
betriebsfremd	negative
betriebssicher	positive
betroffen	negative
betrüblich	negative
betrübt	negative
betrügerisch	negative
bettelarm	negative
betucht	positive
betulich	positive
beunruhigend	negative
bewährt	positive
beweglich	positive
bewegungsmuster	positive
bewegungsunfähig	negative
bewohnbar	positive
bewölkt	negative
bewusstlos	negative
bewusst	positive
bezahlbar	positive
bezaubernd	positive
bezeichnend	positive
beziehbar	negative
beziehungsreich	negative
beziehungsunfähig	negative
bezückend	positive
bezugsfertig	negative
bibeltreu	positive
bibliophil	negative
biedermeierlich	negative
bieder	negative
biegsam	positive
bigott	negative
bildbeispiel	positive
bilderreich	positive
bildhauerisch	positive
bildhübsch	positive
bildnerisch	positive
bildschön	positive
bildungsbürgerlich	negative
bildungsfeindlich	negative
bildungsideal	positive
billig	positive
bindend	positive
bindig	positive
bindungsfähig	positive
binsenwahrheit	positive
binsenweisheit	positive
biografisch	negative
biographisch	negative
bissig	negative
bitterarm	negative
bitterböse	negative
bitter	negative
blankgeputzt	negative
blank	negative
blasphemisch	negative
blassblau	positive
blassgelb	positive
blassgrün	positive
blass	negative
blassrosa	negative
blauäugig	positive
blaublütig	positive
blaugrau	positive
blaugrün	positive
bläulich	positive
blau	positive
blaurot	positive
bleich	negative
bleischwer	positive
blendend	positive
blessiert	negative
blickdicht	negative
blind	negative
blitzartig	negative
blitzblank	negative
blitzeblank	negative
blitzeblau	positive
blitzschnell	negative
blödsinnig	positive
blühend	positive
blumenpracht	positive
blumenreich	positive
blumig	positive
blutarm	negative
blütenweiss	positive
blutig	negative
blutleer	negative
blutrot	positive
blutrünstig	negative
blutverschmiert	negative
bockig	negative
bodenlang	positive
bodenlos	negative
bodennah	positive
bombastisch	positive
bombensicher	positive
bordeauxrot	positive
bordeigen	positive
borniert	negative
börsenfähig	positive
bösartig	negative
böse	negative
boshaft	negative
bös	negative
böswillig	negative
botmässig	positive
brachial	negative
brandgefährlich	negative
brauchbar	positive
braumeisterin	positive
braumeister	positive
bräunlich	positive
bräunlichrot	positive
braun	positive
braunrot	positive
braunschwarz	negative
bravourös	positive
brav	positive
breiig	positive
breitgefächert	positive
breitgesichtig	positive
breithüftig	positive
breitkiefrig	positive
breit	positive
breitschultrig	positive
breitspurig	positive
brennend	positive
brenzlig	positive
brisant	positive
bronzefarben	positive
bronzefarbig	positive
bruchfest	negative
brüchig	positive
bruchstückartig	negative
bruchstückhaft	negative
brüsk	positive
brusthoch	positive
brutal	negative
buchstabengetreu	positive
buchstäblich	positive
buckelig	negative
bucklig	negative
bullerig	positive
bullig	positive
bundeseigen	positive
bundesstaatlich	positive
bundesweit	positive
bündig	negative
bündnisgemäss	positive
bündnisgrün	positive
buntfarbig	negative
bunt	negative
bürgerkriegsähnlich	positive
bürgerlich	negative
bürgersinn	positive
burlesk	positive
bürokratisch	positive
buttergelb	positive
calvinistisch	positive
caritativ	positive
cäsarisch	positive
cash	positive
champion	positive
chancenlos	negative
chancenreich	positive
chance	positive
changierend	positive
charakterfest	positive
charakteristisch	positive
charakterlos	negative
charakterschwach	negative
charaktervoll	positive
charisma	positive
charismatisch	positive
charmant	positive
charme	positive
charterfolg	positive
chauvinistisch	positive
christenfeindlich	negative
christliberal	positive
christlich-orthodox	negative
chronisch	negative
clean	positive
cool	positive
cremefarben	positive
cremefarbig	positive
cremeweiss	positive
cremig	positive
cyclisch	positive
dahergelaufen	negative
dahinterstehend	positive
damenhaft	positive
dämmerig	negative
dämmerungshimmel	positive
dämmrig	negative
dämonisch	negative
danebengegangen	negative
dankbar	positive
darstellbar	positive
darstellerisch	positive
datenmodell	positive
datierbar	negative
dauernd	positive
ddr-meister	positive
deckenhoch	positive
deckungsgleich	positive
deduktiv	positive
defekt	negative
defensiv	positive
definierbar	negative
definitionsgemäss	positive
definitiv	positive
definit	positive
defizitär	negative
deflationär	negative
deformiert	negative
deftig	negative
degressiv	negative
dehnbar	positive
dekadent	negative
dekorativ	positive
delikat	negative
delimitiert	negative
delinquent	negative
delphisch	positive
demagogisch	negative
dement	negative
dementsprechend	positive
demgemäss	positive
demokratiefeindlich	negative
demonstrationszweck	positive
demonstrativ	positive
demoralisierend	negative
denkbar	positive
denkfähig	positive
denkmalgeschützt	positive
denkmodell	positive
denunziatorisch	negative
deplatziert	negative
deplaziert	negative
deprimierend	negative
deprimiert	negative
derb	negative
desaströs	negative
desolat	positive
desorientiert	negative
despektierlich	negative
destruktiv	negative
detailgetreu	positive
detailliert	positive
detailreich	positive
determiniert	positive
deterministisch	positive
deutbar	negative
deutlich	positive
deutschfeindlich	negative
deutschlandweit	positive
dezemberhimmel	positive
dezent	negative
dezidiert	positive
diabetisch	negative
diabolisch	negative
diachronisch	positive
diachron	positive
diagonal	negative
dialogfähig	positive
dicht bebaut	positive
dichtbebaut	positive
dichterisch	positive
dicht	negative
dickbäuchig	positive
dickflüssig	positive
dickköpfig	negative
dicklagig	positive
dicklich	positive
dick	positive
dickwanstig	positive
diebisch	negative
dienlich	positive
dienstbar	positive
dienstbereit	negative
diensteifrig	positive
dienstfähig	positive
diensttauglich	positive
dienstunfähig	negative
diesig-kalt	negative
diesig	negative
differentiell	negative
different	negative
differenziell	negative
differenzierbar	negative
differenziert	positive
diffizil	positive
diffus	negative
digital	negative
diktatorisch	positive
dilettantin	negative
dilettantisch	negative
dilettant	negative
dingfest	negative
direkt	positive
disharmonisch	negative
diskontinuierlich	negative
diskret	positive
diskussionswürdig	positive
diskutabel	positive
diskutierbar	positive
disparat	negative
dissident	negative
dissozial	negative
distal	negative
distanziert	negative
distanzlos	positive
distinguiert	positive
divers	negative
dogmatisch	positive
dogmengeschichtlich	positive
doktrinär	positive
dokumentationszweck	positive
dokumentiert	positive
dolchstosslegende	positive
doll	positive
doppeldeutig	negative
doppelspurig	positive
doppelt	positive
dornenreich	positive
dornig	positive
dortig	negative
dottergelb	positive
drahtig	positive
drakonisch	positive
drall	positive
drangvoll	negative
drastisch	positive
draufgängerisch	negative
dreierlei	negative
dreifach	positive
dreifarbig	positive
dreilagig	positive
dreimalig	positive
dreispurig	positive
dreissigprozentig	negative
dreiviertellang	positive
dringend	negative
dringlich	negative
drittgrösste	positive
dritthöchste	positive
drittklassig	negative
drogenabhängig	negative
drogen nehmen	negative
drogensüchtig	negative
drollig	positive
druckfähig	positive
druckfertig	negative
druckfest	negative
druckreif	negative
druckvoll	positive
drüsenkrank	negative
dubios	negative
dufte	positive
duftig	positive
duktil	positive
dümmlich	positive
dumpf	negative
dunkelblau	positive
dunkelbraun	positive
dunkelfarbig	positive
dunkelgelb	positive
dunkelgrau	positive
dunkelgrün	positive
dunkelhäutig	negative
dunkelhäutig	positive
dunkel	positive
dunkelrot	positive
dunkelviolett	positive
dünnflüssig	positive
dünn	negative
dunstig	negative
durchbrochen	negative
durcheinander	negative
durchführbar	positive
durchgängig	positive
durchgehend	positive
durchlässig	positive
durchschaubar	negative
durchscheinend	positive
durchschlagend	positive
durchschlagskräftig	positive
durchsetzbar	positive
durchsetzungsfähig	positive
durchsichtig	negative
durchstimmbar	positive
durchtrainiert	positive
durchtrieben	negative
dürftig	negative
dürr	negative
dusel	positive
duster	negative
düster	negative
dynamisch	positive
ebenbürtig	positive
eben	negative
echt	positive
edelmütig	positive
edel	positive
effektiv	positive
effekt	positive
eheähnlich	positive
ehrbar	positive
ehrenamtlich	positive
ehrenhaft	positive
ehrenrührig	negative
ehrenvoll	positive
ehrenwert	positive
ehre	positive
ehrlich	positive
ehrlos	negative
ehrrührig	negative
ehrsam	positive
ehrverletzend	negative
ehrwürdig	positive
eifer	positive
eiförmig	positive
eifrig	positive
eigenbrötlerisch	negative
eigenhändig	negative
eigenmächtig	negative
eigen	positive
eigensinnig	negative
eigenständig	positive
eigenwillig	negative
eignen	positive
eilfertig	positive
eilig	negative
eindeutig	positive
eindringlich	positive
eineindeutig	positive
eineinhalbfach	positive
einfach	negative
einfallsreich	positive
einfarbig	positive
einflussreich	positive
eingängig	positive
eingedickt	positive
eingefallen	negative
eingefangen	negative
eingehend	positive
eingeladen	negative
eingeschnappt	negative
eingeschnitten	negative
eingeschränkt	negative
eingeschrieben	positive
eingetragen	positive
einhellig	positive
einklagbar	positive
einkommensabhängig	negative
einkommensschwach	negative
einkommenssteuerpflichtig	positive
einkommensteuerpflichtig	positive
einladend	positive
einleitend	negative
einleuchtend	negative
einlullen	positive
einmalig	negative
einnehmend	positive
einprägsam	positive
einsam	negative
einsatzbereit	negative
einsatzfähig	positive
einsatzzweck	positive
einschätzbar	positive
einschichtig	negative
einschlägig	positive
einschneidend	positive
einschränkend	negative
einsehbar	negative
einsichtsfähig	positive
einsilbig	negative
einspurig	positive
einstellbar	positive
einstudiert	negative
einsturzgefährdet	negative
einträchtig	positive
einvernehmlich	positive
einzeln	negative
einzelstaatlich	positive
einzelstehend	negative
einzigartig	negative
einzig	negative
eirund	positive
eisblau	positive
eisenhart	negative
eisenreich	positive
eisgrau	positive
eisigkalt	negative
eisig	negative
eiskalt	negative
eitel	negative
eiternd	negative
eitrig	negative
eiweissarm	negative
eiweissreich	positive
ekel erregend	negative
ekelerregend	negative
ekelhaft	negative
ekel	negative
eklatant	positive
eklig	negative
ekstase	positive
elaboriert	positive
elastisch	positive
elefantös	positive
elefant	positive
elegisch	negative
elektrodynamisch	positive
elementar	positive
elendig	negative
elend	negative
elfenbeinfarben	positive
elfenbeinfarbig	positive
ellenlang	positive
elliptisch	positive
eloquent	positive
emanzipiert	positive
eminent	positive
empfänglich	positive
empfehlenswert	positive
empfindungsfähig	positive
empfindungsgemäss	positive
emphatisch	positive
empirisch	positive
empörend	negative
empören	negative
empört	positive
emsigkeit	positive
emsig	positive
endgeil	positive
endgültig	positive
endlich	negative
endlos	positive
energiegeladen	positive
energieintensiv	negative
energie	positive
energisch	positive
engstirnig	negative
enorm	positive
entartet	negative
entbehrlich	negative
entbehrungsreich	negative
entfernt	negative
entführt	negative
entgegenkommend	positive
entgeistert	positive
enthaltsam	positive
entkräftet	negative
entlarvend	positive
entleert	negative
entlegen	negative
entmutigend	negative
entrücktheit	positive
entrüstet	positive
entsagend	positive
entsagungsvoll	positive
entscheidbar	positive
entscheidend	positive
entscheidungsschwach	negative
entschieden	positive
entschlossen	positive
entschuldbar	positive
entseelt	negative
entsetzlich	negative
entsetzt	positive
entspannend	positive
entsprechend	positive
entstellen	negative
entstellt	negative
enttäuscht	negative
entwicklungsfähig	positive
entwicklungsgemäss	positive
entwicklungsgeschichtlich	positive
entwürdigend	negative
entwürdigen	negative
entwurfsmuster	positive
entzückend	positive
entzündet	negative
entzündungshemmend	positive
ephemerisch	negative
ephemer	negative
epikureisch	negative
epochal	positive
epoche machend	positive
epochemachend	positive
erbärmlich	negative
erbarmungslos	negative
erbberechtigt	positive
erbittert	positive
erbkrank	negative
erbosen	negative
erbost	negative
erbschaftssteuerpflichtig	positive
erbsengross	positive
erdbraun	positive
erdenklich	positive
erdfarben	positive
erdgeschichtlich	positive
erdnah	positive
erdrückend	negative
ererbt	positive
erfahrbar	positive
erfahrungsgemäss	positive
erfassbar	negative
erfasst	positive
erfinderisch	positive
erfindungsreich	positive
erfolglos	negative
erfolg	positive
erfolgreich	positive
erfolgsabhängig	negative
erfolgsaussicht	positive
erfolgschance	positive
erfolgsgewöhnt	positive
erfolgsverwöhnt	positive
erfolg versprechend	positive
erfolgversprechend	positive
erforderlich	positive
erforscht	positive
erfreulich	positive
erfüllbar	positive
ergänzungsbedürftig	negative
ergebnislos	negative
ergebnisoffen	negative
ergebnisreich	positive
erhaben	positive
erhaltenswert	positive
erheblich	positive
erhöht	positive
erholsam	positive
erholungsbedürftig	negative
erholungszweck	positive
erkältet	negative
erkennbar	positive
erklärbar	negative
erklärlich	negative
erklärt	positive
erklecklich	positive
erkoren	positive
erkundet	positive
erlaubt	positive
erlaucht	positive
erlebbar	positive
erledigt	negative
erleichtern	positive
erleichtert	positive
erlernbar	positive
erleuchtet	positive
erlogen	negative
erlöst	positive
erneuerbar	positive
erneuernd	positive
erneut	positive
ernsthaft	positive
ernstlich	negative
ernst	negative
ernstzunehmend	positive
erpresserisch	negative
erprobt	positive
erquicklich	positive
erregbar	negative
erreichbar	negative
erschliessbar	positive
erschöpft	negative
erschwinglich	positive
ersichtlich	positive
erstattungsfähig	positive
erstgenannt	positive
erstklassig	positive
erstrangig	positive
erstrebenswert	positive
ertragbar	positive
erträglich	positive
ertragssicher	positive
erwähnenswert	positive
erwähnt	positive
erwartbar	positive
erwartungsgemäss	positive
erwartungsgetreu	positive
erweiterbar	positive
erweiterungsfähig	positive
erwerbsfähig	positive
erwerbsunfähig	negative
erzählerisch	positive
erziehungsberechtigt	positive
erzkonservativ	negative
erzürnt	positive
esoterisch	positive
essbar	positive
essential	positive
essentiell	positive
essenzial	positive
essenziell	positive
esssüchtig	negative
etherisch	negative
ethisch	positive
etlich	positive
etwaig	negative
euphorie	positive
euphorisch	positive
europameisterin	positive
europameister	positive
europaweit	positive
eventuell	negative
evolutionistisch	positive
ewig	positive
exaltiert	positive
exempel	positive
exemplarisch	positive
exhibitionistisch	positive
existential	positive
existentiell	positive
existent	positive
existenzbedrohend	negative
existenzial	positive
existenziell	positive
exklusiv	negative
exorbitant	positive
exoterisch	negative
experimentierfreudig	positive
explizit	positive
exploit	positive
explosionsartig	negative
explosionsgefährlich	negative
exponieren	positive
extensiv	positive
extravertiert	positive
extremistisch	positive
extrem	positive
extrovertiert	positive
exzellent	positive
exzeptionell	positive
exzessiv	negative
fabelhaft	positive
facettenreich	negative
fachgemäss	positive
fachgerecht	positive
fact	positive
fadenscheinig	negative
fähig	positive
fahlgelb	positive
fahlgrau	positive
fahl	negative
fahndungserfolg	positive
fahrbar	positive
fahrbereit	negative
fahrstuhlgerecht	positive
fahrtauglich	positive
fahrtüchtig	positive
fairness	positive
fair	positive
fakt	positive
faktum	positive
fakultativ	negative
falb	negative
fallbeispiel	positive
fallend	negative
fällig	positive
fälschlich	negative
falsch	negative
fälschungssicher	positive
faltenreich	positive
faltig	positive
familiär	positive
familienfeindlich	negative
familienfreundlich	positive
familiengerecht	positive
familiensinn	positive
famos	positive
fanatisch	positive
fantasielos	negative
fantasiereich	positive
fantasievoll	positive
fantastisch	positive
farbecht	negative
farbenfroh	negative
farbenprächtig	negative
farbenreich	negative
farbig	negative
farbig	positive
farbkarte	positive
farblos	negative
farbmuster	positive
farbschwach	negative
fassbar	negative
fassungslos	positive
fatal	negative
faulig	negative
faul	negative
faustgross	positive
fechtmeisterin	positive
fechtmeister	positive
federführend	positive
federleicht	negative
fehlbar	negative
fehlend	negative
fehlerhaft	negative
fehlgeschlagen	negative
fehlleitend	negative
feierlich	positive
feige	negative
feig	negative
feil	positive
feindlich	negative
feindschaftlich	negative
feindselig	negative
feingeistig	positive
feingemahlen	positive
fein geschnitten	positive
feingeschnitten	positive
feinkörnig	positive
fein	positive
feinschmeckerisch	positive
feist	positive
feldgrau	positive
felsenfest	positive
fern	negative
fernsehsüchtig	negative
fertig	negative
festgebunden	positive
festgefangen	negative
festgefügt	negative
festgehalten	positive
festgenommen	negative
festkochend	negative
festlich	positive
fest	negative
feststehend	negative
feststellbar	negative
fettarm	negative
fettig	negative
fettleibig	positive
fettlöslich	positive
fett	positive
fettreich	positive
feuchtfröhlich	positive
feuchtheiss	positive
feuchtwarm	positive
feudalistisch	positive
feudal	positive
feuerfest	negative
feuerflüssig	positive
feuerrot	positive
feurig	positive
fidel	positive
fieberhaft	negative
fiebrig	negative
fies	negative
figurenreich	positive
filigran	positive
filmbeispiel	positive
filmgeschichtlich	positive
filmhistorisch	positive
filzähnlich	positive
final	positive
finanzierbar	positive
finanzkräftig	positive
finanzschwach	negative
finanzstark	positive
findig	positive
fingerdick	positive
fingerlang	positive
finit	positive
finster	negative
firmament	positive
firmeneigen	positive
fischähnlich	positive
fit	positive
fixiert	positive
fix	negative
fixsternhimmel	positive
flächengross	positive
flächengrösste	positive
flächentreu	positive
flach	negative
flagrant	positive
flapsig	negative
flaschengrün	positive
flatterhaft	positive
flatterig	positive
flaumig	positive
flau	negative
flauschig	positive
fleckig	negative
flegelhaft	negative
fleischarm	negative
fleischermeisterin	positive
fleischermeister	positive
fleischfarben	positive
fleisch geworden	positive
fleischgeworden	positive
fleischlich	positive
fleissig	positive
fleiss	positive
flexibel	positive
fliederfarben	positive
flink	negative
floral	negative
flor	positive
flott	negative
fluchtartig	negative
flüchtig	negative
fluffig	positive
flugbereit	negative
flugbereit	positive
flugfähig	positive
flügge	positive
flugtauglich	positive
flugunfähig	negative
flüssig	positive
föderiert	positive
föhnhimmel	positive
föhnig	positive
folgenreich	positive
folgenschwer	positive
folgsam	positive
forciert	negative
förderlich	positive
fördernd	positive
fördern	positive
förderungswürdig	positive
formbar	positive
formell	positive
formen	positive
formenreich	positive
förmlich	positive
formschön	positive
formstabil	negative
formvollendet	positive
forsch	negative
forschungsintensiv	negative
forschungszweck	positive
fortbestehend	positive
fortdauernd	positive
fortgesetzt	positive
fortlaufend	positive
fortschreitend	positive
fortschrittlich	positive
fortschrittsfeindlich	negative
fortune	positive
fortwährend	positive
frage	negative
fragil	positive
fraglich	negative
fraglos	positive
fragmentarisch	negative
fragwürdig	negative
fraktioniert	negative
frank	positive
frauenfeindlich	negative
frauenfreundlich	positive
frauentypisch	positive
frech	negative
freiberuflich	positive
freihändig	negative
freiheitlich	positive
freiherrlich	positive
freimütig	positive
frei	positive
freischaffend	positive
freisinnig	positive
freistehend	negative
freiwillig	positive
freizeitorientiert	positive
freizügig	positive
fremdbestimmt	negative
fremdenfeindlich	negative
fremd	negative
frenetisch	positive
frequent	positive
frequenzabhängig	negative
fresssüchtig	negative
freudentaumel	positive
freudig	positive
freudlos	negative
freundlich	positive
freund	positive
freundschaftlich	positive
frevlerisch	negative
friedensgefährdend	negative
friedfertig	positive
friedlich	positive
friedliebend	positive
friedvoll	positive
frigide	negative
frigid	negative
frisch	negative
friseurmeisterin	positive
friseurmeister	positive
fristlos	negative
frivol	negative
froh gelaunt	positive
frohgelaunt	positive
frohgemut	positive
froh gestimmt	positive
frohgestimmt	positive
fröhlich	positive
froh	positive
frommen	positive
frostig	negative
frostsicher	positive
frühjahrshimmel	positive
frühlingshaft	negative
frühlingshimmel	positive
fuchsig	positive
fuchsteufelswild	positive
fügsam	positive
füllig	positive
fulminant	positive
fundamentalistisch	positive
fundamental	positive
fundiert	positive
fündig	positive
fünffach	positive
fünfmalig	positive
fünfprozentig	negative
fünfspurig	positive
fünftgrösste	positive
fünfzigprozentig	negative
funktionsfähig	positive
funktionstüchtig	positive
furchtbar	negative
furchteinflössend	negative
fürchterlich	negative
furcht erregend	negative
furchterregend	negative
furios	positive
fürsorglich	positive
fürstlich	positive
fusslang	positive
futuristisch	positive
galant	positive
gallenkrank	negative
galoppierend	negative
gammelig	negative
gammlig	negative
gangbar	positive
gängig	positive
ganzheitlich	positive
gänzlich	positive
ganz	positive
garstig	negative
gasdicht	negative
gasgefüllt	positive
gasgekühlt	negative
gasreich	positive
gasundurchlässig	negative
gebändert	negative
gebietsfremd	negative
gebirgig	positive
gebleicht	negative
geblümt	negative
geboten	positive
gebrauchsfähig	positive
gebrauchsfertig	negative
gebrechlich	negative
gebrochen	positive
gebucht	positive
gebührend	positive
gebührenfrei	positive
gebührenlos	positive
gebunden	positive
geburtenschwach	negative
geckenhaft	negative
gedackt	negative
gedämpft	negative
gedankenverloren	negative
gedankenversunken	negative
gedankenvoll	negative
gedeihlich	positive
gediegen	positive
gedrängt	negative
gedrungen	negative
geduldig	negative
geeignet	positive
gefährdend	negative
gefährdet	negative
gefährlich	negative
gefahrvoll	negative
gefällig	positive
gefälscht	negative
gefangengehalten	negative
gefangengenommen	negative
gefangen	negative
gefasst	positive
gefeit	positive
gefestigt	positive
gefleckt	negative
gefragt	positive
gefügig	positive
gefüllt	positive
gegeben	negative
gegenbeispiel	positive
gegenrevolutionär	positive
gegnerisch	negative
gehalten	negative
gehaltvoll	positive
geharnischt	positive
gehässig	negative
gehäuft	positive
gehbehindert	positive
geheimgehalten	negative
geheim	negative
geheimnisumwittert	positive
geheimnisvoll	positive
gehemmt	negative
gehfähig	positive
gehoben	positive
gehörig	positive
gehör	positive
gehorsam	positive
gehörsinn	positive
geil	positive
geisterhaft	negative
geistesabwesend	negative
geistesgegenwärtig	positive
geistesgestört	negative
geistesklar	positive
geisteskrank	negative
geistfeindlich	negative
geistig behindert	negative
gekidnapt	negative
geklärt	positive
geknickt	positive
gekonnt	positive
gekränkt	negative
gekünstelt	negative
gelackmeiert	negative
geladen	negative
gelähmt	positive
geländegängig	positive
geländetauglich	positive
gelassen	positive
geläufig	positive
gelbbraun	positive
gelbgrün	positive
gelblich	positive
gelb	positive
gelbrot	positive
gelbweiss	positive
geleert	negative
gelegen	positive
gelegentlich	positive
gelehrig	positive
gelenkig	positive
gelinde	negative
gelind	negative
gelingen	positive
gelogen	negative
gelungen	positive
gemächlich	positive
gemafrei	positive
gemasert	negative
gemässigt	positive
gemäss	positive
gemeindeeigen	positive
gemeinfrei	positive
gemeingefährlich	negative
gemein	negative
gemeinsam	positive
gemeinschaftlich	positive
gemeinschaftsschädigend	negative
gemeinschaftssinn	positive
gemeinsinn	positive
gemeinverständlich	negative
gemustert	negative
gemütlich	positive
genannt	positive
genant	positive
genehm	positive
geneigt	positive
generalstabsmässig	positive
genervt	negative
genesen	positive
genierlich	positive
geniessbar	positive
genügend	positive
genug	positive
genügsam	negative
genusssüchtig	negative
geöffnet	positive
geoutet	positive
gepanscht	negative
gepflegt	positive
gepunktet	negative
gerade	negative
geradlinig	positive
geraten	positive
gerechtfertigt	positive
gerechtigkeit	positive
gerechtigkeitsgefühl	positive
gerechtigkeitssinn	positive
gerecht	positive
geregelt	positive
gereizt	negative
gerichtsverwertbar	positive
geringelt	positive
geringfügig	negative
gering	negative
geringschätzig	negative
geringstmöglich	negative
geringwertig	negative
geronnen	positive
gertenschlank	negative
geruch	positive
geruchssinn	positive
geruhsam	positive
gesamt	positive
gesamtstaatlich	positive
geschäftig	positive
geschäftsschädigend	negative
geschäftssinn	positive
geschäftstüchtig	positive
geschäftszweck	positive
geschätzt	positive
gescheckt	negative
geschichtlich	positive
geschichtsträchtig	positive
geschlossen	negative
geschmackssinn	positive
geschmackvoll	positive
geschnetzelt	negative
geschnitten	negative
geschockt	positive
geschrieben	positive
geschützt	positive
geschwind	negative
geschwollen	positive
geschworen	positive
gesellschaftsfähig	positive
gesellschaftsfeindlich	negative
gesellschaftsunfähig	negative
gesellschaftsverträglich	positive
gesetzt	positive
gesetzwidrig	negative
gesinnt	positive
gesittet	positive
gespalten	negative
gespensterhaft	negative
gespenstig	negative
gespenstisch	negative
gesperrt	negative
gespielt	negative
gesprächsbereit	positive
gesprenkelt	negative
gestaltbar	negative
gestalterisch	positive
geständig	positive
gestattet	positive
gestorben	negative
gestört	negative
gestreckt	positive
gestreift	negative
gestreng	positive
gestresst	negative
gesucht	positive
gesundet	positive
gesundheitsabträglich	negative
gesundheitsdienlich	positive
gesundheitsförderlich	positive
gesundheitsfördernd	positive
gesundheitsgefährdend	negative
gesundheitsgemäss	positive
gesundheitsschädigend	negative
gesundheitsschädlich	negative
gesund	positive
getragen	positive
gewagt	negative
gewaltbereit	negative
gewaltig	positive
gewaltsam	positive
gewalttätig	negative
gewalttat	negative
gewellt	positive
gewichtig	positive
gewienert	negative
gewinkelt	positive
gewinnbar	positive
gewinnchance	positive
gewinnend	positive
gewissenhaft	positive
gewiss	positive
gewitterhimmel	positive
gewogen	positive
gewohnheitsmässig	positive
gewürfelt	negative
geziert	negative
gezwungen	negative
giftgrün	positive
giftig	negative
gift	negative
gigantisch	positive
gildemeisterin	positive
gildemeister	positive
glamour	positive
glänzend	positive
glanzleistung	positive
glanz	positive
glanzvoll	positive
glasklar	positive
glatt gehen	positive
glattgehen	positive
glatt	negative
glattwandig	negative
glatzköpfig	negative
glaubhaft	positive
glaubwürdig	positive
gleichalt	positive
gleichaltrig	positive
gleichartig	positive
gleichbedeutend	positive
gleichberechtigt	positive
gleichbleibend	positive
gleichfarbig	positive
gleichgeartet	positive
gleich gelagert	positive
gleichgelagert	positive
gleich gerichtet	positive
gleichgerichtet	positive
gleichgeschaltet	positive
gleichgesinnt	positive
gleichgestellt	positive
gleichgewichtssinn	positive
gleichgross	positive
gleichlang	positive
gleichlautend	positive
gleichnamig	positive
gleichnishaft	negative
gleich	positive
gleichrangig	positive
gleichsinnig	positive
gleichwertig	positive
gleitfähig	negative
glibberig	negative
glimpflich	positive
glitschig	negative
global	positive
glorreich	positive
glücklich	positive
glücklos	negative
glück	positive
glückreich	positive
glückselig	positive
glücksfall	positive
glücksgefühl	positive
glückstrahlend	positive
glühend	positive
glühendrot	positive
gnadenlos	negative
gnädig	positive
gnomenhaft	negative
goldähnlich	positive
goldbraun	positive
goldfarben	positive
goldfarbig	positive
goldgelb	positive
goldglänzend	positive
goldgrün	positive
goldig	positive
gottähnlich	positive
gotteslästerlich	negative
gottgegeben	positive
gottgewollt	positive
grade	negative
gradlinig	positive
graduell	positive
grandios	positive
grantig	negative
grasartig	negative
grasgrün	positive
grasig	negative
grässlich	negative
graublau	positive
graubraun	positive
grauen erregend	negative
grauenerregend	negative
grauenhaft	negative
grauenvoll	negative
graugrün	positive
graulich	negative
gräulich	negative
grau	positive
grausam	negative
grauschwarz	negative
grausig	negative
grauslich	negative
grauweiss	positive
gravierend	positive
grazil	positive
graziös	positive
grellbunt	negative
grellfarben	positive
grellfarbig	positive
grellgelb	positive
grell	positive
grellweiss	positive
grenznah	positive
griechisch-orthodox	negative
griesgrämig	negative
griffig	positive
grimmig	negative
grimm	negative
grobkörnig	negative
grob	negative
grobschlächtig	negative
groggy	negative
grossangelegt	positive
grossartig	positive
grossbürgerlich	negative
gross gewachsen	positive
grossgewachsen	positive
grossherzig	positive
grosskotzig	negative
grossmäulig	negative
grossmeisterin	positive
grossmeister	positive
gross	positive
grossspurig	negative
grösste	positive
grösstmöglich	positive
grossväterlich	positive
grosswüchsig	positive
grottenschlecht	negative
grottig	negative
grüblerisch	negative
grünblau	positive
grundfalsch	negative
grundlegend	positive
gründlich	positive
grundlos	negative
grundsätzlich	positive
grundsolide	positive
grundsolid	positive
grundsteuerpflichtig	positive
gründungsmythos	positive
grundverschieden	negative
grüngelb	positive
grüngrau	positive
grünlich	positive
grün	positive
gruselig	negative
günstig	positive
gutartig	positive
gut aufgelegt	positive
gut betucht	positive
gutbetucht	positive
gutbürgerlich	negative
gut gehen	positive
gutgehen	positive
gut gelaunt	positive
gutgelaunt	positive
gutgemeint	positive
gutgeschrieben	positive
gutgläubig	positive
gutherzig	positive
gütig	positive
gütlich	positive
gutmütig	positive
gut	positive
gutsituiert	positive
haarähnlich	positive
haardünn	negative
haarscharf	positive
haarsträubend	positive
habituell	positive
haftfähig	positive
haftunfähig	negative
hager	negative
hagiografisch	negative
hagiographisch	negative
halbamtlich	negative
halbdunkel	negative
halbfertig	negative
halbherzig	negative
halbhoch	positive
halbjährlich	positive
halblang	positive
halbleer	negative
halb	negative
halboffen	positive
halbseiden	negative
halbstaatlich	positive
halbstündig	positive
halbstündlich	positive
halb voll	positive
halbvoll	positive
halbwahrheit	positive
haltbar	positive
hämisch	negative
handfest	positive
handgreiflich	negative
handgross	positive
handhabbar	positive
handlang	positive
handlich	positive
handlungsfähig	positive
handlungsmuster	positive
handlungsunfähig	negative
handtellergross	positive
handwarm	positive
handwerksmeisterin	positive
handwerksmeister	positive
hanebüchen	negative
harsch	negative
hartgesotten	negative
hartherzig	negative
hartnäckig	negative
hart	negative
harzig	positive
hasserfüllt	negative
hässlich	negative
hastig	negative
hauchdünn	negative
häufig	positive
hauptamtlich	positive
hauptberuflich	positive
hauptsächlich	positive
hauptzweck	positive
hausbacken	negative
hauseigen	positive
haushoch	positive
häuslich	negative
hautfarben	positive
hautfreundlich	positive
hautverträglich	positive
hechtgrau	positive
heftig	positive
hehr	positive
heikel	positive
heilbar	negative
heilend	positive
heilen	positive
heilerfolg	positive
heilfroh	positive
heiligenlegende	positive
heillos	negative
heil	positive
heilsam	positive
heilsgeschichtlich	positive
heilungschance	positive
heilzweck	positive
heimatberechtigt	positive
heimelig	positive
heimlich	negative
heimtückisch	negative
heiratswillig	positive
heiser	negative
heissblütig	positive
heiss	positive
heiter	positive
heizzweck	positive
hektisch	positive
hellblau	positive
hellbraun	positive
hellfarben	positive
hellgelb	positive
hellgrau	positive
hellgrün	positive
hellhörig	positive
hell	positive
hellrot	positive
hellwach	negative
hemmungslos	negative
herausfordernd	negative
herausfordern	negative
herausragend	positive
herbsthimmel	positive
herbstlich	negative
hermeneutisch	positive
hermetisch	negative
heroinabhängig	negative
heroinsüchtig	negative
herrlich	positive
herrschend	positive
herstellerunabhängig	positive
heruntergekommen	negative
heruntergewirtschaftet	negative
hervorgehoben	positive
hervorragend	positive
hervorragen	positive
hervorstechend	positive
hervortun	positive
herzensgut	positive
herzhaft	negative
herzig	positive
herzkrank	negative
herznah	positive
heterogen	negative
heterolog	negative
heteromorph	negative
heterotroph	negative
hetzerisch	negative
heuchlerisch	negative
hieratisch	negative
hiesig	positive
hilfebedürftig	negative
hilfe suchend	negative
hilfesuchend	negative
hilflos	negative
hilfreich	positive
hilfsbedürftig	negative
hilfsbereit	positive
himmelblau	positive
himmelfahrt	positive
himmel	positive
himmelschreiend	negative
himmelweit	positive
himmlisch	positive
hinderlich	negative
hinfällig	negative
hinlänglich	positive
hinnehmbar	positive
hinreichend	positive
hinreissend	positive
hinterfotzig	negative
hintergründig	positive
hinterhältig	negative
hinterlistig	negative
hintersinnig	positive
hirnrissig	negative
hirntot	negative
historisch	positive
hitzebeständig	negative
hitzestabil	negative
hochadelig	positive
hochadlig	positive
hoch begabt	positive
hochbegabt	positive
hoch dosiert	positive
hochdosiert	positive
hoch entwickelt	positive
hochentwickelt	positive
hochfliegend	positive
hochgefährlich	negative
hochgefühl	positive
hoch gelegen	positive
hochgelegen	positive
hochgeschätzt	positive
hochgespannt	positive
hochgesteckt	positive
hochgestochen	positive
hoch gewachsen	positive
hochgewachsen	positive
hochgiftig	negative
hochglänzend	positive
hochgradig	positive
hochheilig	negative
hochherrschaftlich	positive
hochkarätig	negative
hochklassig	positive
hochkomplex	negative
hochkompliziert	negative
hochkonzentriert	positive
hochleistungsfähig	positive
hochliegend	positive
hochmusikalisch	positive
hochoffiziell	positive
hoch	positive
hochpreisig	negative
hochprozentig	negative
hochrangig	negative
hochrein	positive
hochrot	positive
hochseetüchtig	positive
hochsommerlich	positive
hochstämmig	positive
hochstehend	negative
höchstentwickelt	positive
höchstgelegen	positive
hochstimmung	positive
höchstmöglich	positive
höchstpersönlich	negative
höchstwahrscheinlich	positive
hochtrabend	positive
hochverdient	positive
hochverräterisch	positive
hoch verschuldet	positive
hochverschuldet	positive
hochwassergefährdet	negative
hochwertig	positive
hochwichtig	positive
hochwüchsig	positive
hochwürdig	positive
hochzufrieden	positive
hoffähig	positive
höfisch	positive
höflich	positive
höhengleich	positive
höher gelegen	positive
höhergelegen	positive
höhnisch	negative
hold	positive
höllisch	negative
holografisch	positive
holprig	negative
hölzern	negative
homogen	positive
homolog	positive
homophob	negative
honett	positive
honiggelb	positive
honorabel	positive
honorig	positive
hörbeispiel	positive
horizontal	negative
horrend	positive
hörsinn	positive
hübsch	positive
hüfthoch	positive
hüftlang	positive
hugenottisch	positive
huldreich	positive
humanitär	positive
human	positive
humorig	positive
humorlos	positive
humorvoll	positive
hundeähnlich	positive
hundemüde	positive
hundertfach	positive
hundertprozentig	positive
hündisch	negative
hünenhaft	positive
hurtig	negative
hydrodynamisch	positive
hygienisch	positive
hyperaktiv	positive
hypernervös	positive
hypothetisch	negative
hysterisch	positive
idealfall	positive
ideal	positive
idealstadt	positive
idealtypisch	positive
idealtyp	positive
idealtypus	positive
ideengeschichtlich	positive
ideenreich	positive
identifizierbar	positive
identisch	positive
ideologisch	positive
idyllisch	positive
idyll	positive
illegitim	negative
illusorisch	negative
illuster	positive
illustrativ	negative
image	positive
imageträchtig	positive
immanent	positive
immediat	positive
immens	positive
immer während	positive
immerwährend	positive
immobil	negative
immun	positive
immunschwach	negative
imperativ	positive
imperial	positive
impertinent	negative
implausibel	negative
implizit	negative
impossibel	negative
impotent	negative
impulsiv	positive
imstande	positive
inadäquat	negative
inakzeptabel	negative
inbrünstig	positive
indefinit	negative
indigniert	positive
indigoblau	positive
indirekt	negative
indischer elefant	positive
indiskret	negative
indiskutabel	negative
induktiv	positive
ineffektiv	negative
infam	negative
infernal	negative
inflationär	positive
informal	positive
informell	negative
inhaftiert	negative
inhaltsgleich	positive
inhomogen	negative
inhuman	negative
initial	negative
initiativ	positive
inkarniert	positive
inkompatibel	negative
inkonsequent	negative
inkonstant	negative
innovativ	positive
inoffiziell	negative
in	positive
inquisitorisch	positive
insolvent	negative
instabil	negative
inständig	positive
instandsetzbar	positive
intakt	positive
integer	positive
integral	positive
integrierend	positive
intensiv	positive
internetfähig	positive
internetsüchtig	negative
interpretationsfähig	negative
interpretierbar	negative
intersubjektiv	negative
intim	negative
intolerant	negative
intrigant	negative
introvertiert	negative
invariant	positive
investitionsfreundlich	positive
involviert	negative
ironisch	negative
irreführend	negative
irregeleitet	negative
irregulär	negative
irrelevant	negative
irre	negative
irreparabel	positive
irreversibel	positive
irrig	negative
irritierend	negative
irritiert	negative
irr	negative
irrsinnig	negative
irrtümlich	negative
irrwitzig	negative
islamfeindlich	negative
isoliert	negative
isomorph	positive
isotrop	positive
israelfeindlich	negative
iterativ	positive
jäh	positive
jahrelang	positive
jahreszeitlich	positive
jahrhundertelang	positive
jährlich	positive
jahrtausendelang	positive
jahrzehntelang	positive
jähzornig	negative
jämmerlich	negative
janusköpfig	negative
jeck	negative
jenseitig	negative
jovial	positive
judenfeindlich	negative
jugendgefährdend	negative
jugendmeisterin	positive
jugendmeister	positive
kabarettistisch	positive
kabbalistisch	positive
kabinettstückchen	positive
kackbraun	positive
kaffeebraun	positive
kahlköpfig	negative
kahl	negative
kaiserfeindlich	negative
kaiserlich-königlich	positive
kaiserlich	positive
kakaobraun	positive
kakifarben	positive
kaki	positive
kalifornisch	positive
kalkhaltig	negative
kalkig	negative
kalkulierbar	positive
kalkweiss	negative
kalorienarm	negative
kalorienreich	positive
kaltblütig	negative
kältebeständig	negative
kaltherzig	negative
kalt	negative
kaltschnäuzig	negative
kameradschaftlich	positive
kammermusikalisch	positive
kampfbereit	negative
kampferfahren	positive
kämpferisch	positive
kampferprobt	positive
kampfeslustig	negative
kampffähig	positive
kampflustig	negative
kampfstark	positive
kampfunfähig	negative
kanariengelb	positive
kannibalisch	negative
kapitalkräftig	positive
kapital	positive
kapriziös	negative
kaputt	negative
kardinal	positive
kardinaltugend	positive
kärglich	negative
karg	negative
kariert	negative
karitativ	positive
karmesinrot	positive
karminrot	positive
karmisch	positive
kastanienrot	positive
katasteramtlich	positive
katastrophal	negative
kategorisch	positive
kaufkräftig	positive
käuflich	negative
kaufsüchtig	negative
kauzig	negative
keck	positive
keimfrei	positive
kenntlich	positive
kennzeichnend	positive
kerngesund	positive
kernig	positive
kerzengerade	negative
kess	positive
keusch	positive
khakifarben	positive
khaki	positive
kiebig	negative
kilometerlang	positive
kilometerweit	positive
kinderfeindlich	negative
kinderfreundlich	positive
kindgemäss	positive
kindgerecht	positive
kindgetreu	positive
kinnlang	positive
kinoerfolg	positive
kirchenamtlich	positive
kirchenfeindlich	negative
kirchengeschichtlich	positive
kirchenhistorisch	positive
kirchenmusikalisch	positive
kirschrot	positive
kitschig	positive
kläglich	negative
klammheimlich	negative
klangbeispiel	positive
klapperdürr	negative
klapprig	negative
klar	positive
klartraum	positive
klärungsbedürftig	negative
klasse	positive
kleidsam	positive
kleinadelig	positive
kleinadlig	positive
kleinbürgerlich	negative
kleingeschnitten	negative
klein gewachsen	negative
kleingewachsen	negative
kleinkariert	negative
kleinkriminell	negative
klein	negative
kleinste	negative
kleinstmöglich	negative
kleinteilig	negative
kleinwüchsig	negative
klimaschädigend	negative
klimaschädlich	negative
klimaverträglich	positive
klischeehaft	negative
klitzeklein	negative
klobig	negative
klotzig	negative
klümperig	positive
klumpig	positive
klümprig	positive
knackig	negative
knallbunt	negative
knallgelb	positive
knallhart	negative
knallig	negative
knallrot	positive
knapp	negative
knatschig	negative
knetbar	positive
kniefrei	negative
kniehoch	positive
knielang	positive
knifflig	positive
knöchelhoch	positive
knöchellang	positive
knöchern	negative
knochig	negative
knorke	positive
knorrig	negative
knuffig	positive
knusprig	negative
kobaltblau	positive
kochfest	negative
kodiert	negative
kohlrabenschwarz	negative
kokainabhängig	negative
kokainsüchtig	negative
kokett	positive
kollegial	positive
kollektiv	positive
kolloidal	positive
kolloid	positive
kolossal	positive
komatös	negative
kombinierbar	positive
kometenhaft	negative
komfortabel	positive
komisch	positive
komödiantisch	positive
kompakt	positive
kompatibel	positive
kompetitiv	negative
komplett	positive
komplex	negative
kompliziert	negative
kompositorisch	positive
kompostierbar	positive
kompromissbereit	positive
kompromissfähig	positive
konditionsschwach	negative
konditionsstark	positive
konfessionsverschieden	negative
konfliktfähig	positive
konformistisch	negative
konform	positive
konfrontativ	negative
kongruent	positive
königlich	positive
königsblau	positive
konjunkturverträglich	positive
konkordant	positive
konkret	negative
konkurrenzfähig	positive
konsekutiv	positive
konsensfähig	positive
konsequent	positive
konservativ	negative
konspirativ	negative
konstant	positive
konstruierbar	positive
konstruktiv	positive
konsumieren	negative
kontaktarm	negative
kontaktierbar	negative
kontaktlos	negative
kontaminieren	negative
kontaminiert	negative
kontemplativ	positive
konterrevolutionär	positive
kontextabhängig	negative
kontextsensitiv	negative
kontinuierlich	positive
kontrafaktisch	negative
kontraproduktiv	negative
konträr	negative
kontrastiv	negative
kontrollierbar	positive
kontrolliert	negative
kontrovers	negative
konventionell	negative
konzentriert	positive
konzerneigen	positive
konzertiert	positive
konzis	negative
kooperativ	positive
kopfballstark	positive
kopflos	negative
kopiergeschützt	positive
kornblumenblau	positive
körpereigen	positive
körperfeindlich	negative
körperfremd	negative
körperimmanent	positive
körperschaftssteuerpflichtig	positive
körperschaftsteuerpflichtig	positive
korpulent	positive
korrekt	positive
korrekturbedürftig	negative
korrigierbar	negative
korrosionsbeständig	negative
korrosiv	negative
korrupt	negative
koscher	positive
kostbar	negative
kostenfrei	positive
kostengünstig	positive
kostenintensiv	negative
kostenlos	positive
köstlich	negative
kostspielig	negative
kräftezehrend	negative
kräftig	positive
kraftlos	negative
kraftvoll	positive
krampfartig	negative
krampfhaft	negative
krampfig	negative
kränkelnd	negative
krankenhausreif	negative
kränken	negative
kränklich	negative
krank	negative
krass	positive
kreativ	positive
krebskrank	negative
kreideweiss	negative
kreisförmig	positive
kreisrund	positive
kribbelig	positive
kribblig	positive
kriegerisch	negative
kriegsähnlich	positive
kriegselefant	positive
kriegsgeschichtlich	positive
kriegsglück	positive
kriegsmüde	negative
kriegstauglich	positive
kriegswichtig	positive
kriegszweck	positive
kriminell	negative
krisenerfahren	positive
krisenerprobt	positive
kristallklar	positive
kritikfähig	positive
krude	negative
krud	negative
krummlinig	positive
krumm	positive
krüppelhaft	negative
krüppelig	negative
krustig	negative
kryptisch	negative
kryptografisch	negative
kryptographisch	negative
küchenmeisterin	positive
küchenmeister	positive
kugelsicher	positive
kühl	negative
kulinarisch	positive
kultig	positive
kultiviert	positive
kulturfeindlich	negative
kümmerlich	negative
kumpelhaft	positive
kündbar	negative
kundenfreundlich	positive
kunstfeindlich	negative
kunstfertig	positive
künstlerisch	positive
künstlich	negative
kunstmärchen	positive
kunstreich	negative
kunstvoll	negative
kunterbunt	negative
kupferbraun	positive
kupferfarben	positive
kupferrot	positive
kurierbar	negative
kurios	positive
kursiv	positive
kursorisch	negative
kurzfristig	negative
kurz gefasst	negative
kurzgefasst	negative
kurz gewachsen	negative
kurzgewachsen	negative
kurz	negative
kurzstielig	negative
kurzzeitig	negative
kuschelig	positive
kuschlig	positive
küstennah	positive
labil	negative
labormuster	positive
lächerlich	positive
lachhaft	positive
lachsfarben	positive
lackmeiern	negative
lädiert	negative
lagerfähig	positive
lahm	positive
laie	negative
laienhaft	negative
lakonisch	negative
lanciert	negative
landeseigen	positive
landesgeschichtlich	positive
landeshistorisch	positive
landesmeisterin	positive
landesmeister	positive
landestypisch	positive
landläufig	positive
landschaftsverträglich	positive
langatmig	positive
längerfristig	positive
langfristig	positive
lang gefasst	positive
langgefasst	positive
langgestielt	positive
lang gestreckt	positive
langgestreckt	positive
lang gewachsen	positive
langgewachsen	positive
langgezogen	positive
lang	positive
langsam	positive
längs gestreift	negative
längsgestreift	negative
langstielig	positive
langwierig	positive
lapidar	negative
lappig	negative
läppisch	negative
larghetto	positive
largo	positive
lasch	positive
lässig	positive
lasterhaft	negative
lästerlich	negative
laster	negative
lästig	negative
latent	negative
lauchgrün	positive
lauffähig	positive
launenhaft	negative
launig	positive
launisch	negative
lau	positive
lausbubenhaft	positive
lausbübisch	positive
lauschig	positive
lausig	negative
lauter	positive
lautstark	negative
lauwarm	positive
lawinensicher	positive
lax	positive
lebendig	positive
lebend	positive
lebensbedrohend	negative
lebensbedrohlich	negative
lebensbejahend	positive
lebensecht	positive
lebensfähig	positive
lebensfeindlich	negative
lebensfroh	positive
lebensgefährlich	negative
lebensgeschichtlich	negative
lebensglück	positive
lebensgross	positive
lebenslänglich	positive
lebenslang	positive
lebenslustig	positive
lebensmüde	negative
lebensnah	positive
lebensnotwendig	positive
lebenssinn	positive
lebenstraum	positive
lebenstüchtig	positive
lebensunfähig	negative
lebensuntüchtig	negative
lebenswichtig	positive
leberkrank	negative
leberschädigend	negative
leberschädlich	negative
lebhaft	positive
lecker	negative
leck	positive
leer	negative
leer stehend	negative
leerstehend	negative
legendär	positive
legendenhaft	positive
legende	positive
leger	positive
legitim	positive
lehmgelb	positive
lehramtlich	positive
lehrbeispiel	positive
lehrerin	positive
lehrer	positive
lehrherrin	positive
lehrherr	positive
lehrmeisterin	positive
lehrmeister	positive
lehrzweck	positive
leibeigen	positive
leibfeindlich	negative
leiblich	positive
leichtfertig	negative
leichtflüssig	positive
leichtfüssig	positive
leichtgängig	negative
leichtgewichtig	negative
leichtgläubig	positive
leicht	negative
leichtsinnig	negative
leidenschaftlich	positive
leidensfähig	positive
leidig	negative
leidlich	positive
leid	negative
leid tragend	negative
leidtragend	negative
leistungsabhängig	negative
leistungsfähig	positive
leistungsfördernd	positive
leistungsschwach	negative
leistungsstark	positive
leitbild	positive
leitstern	positive
lenkbar	positive
lernerfolg	positive
lernfähig	positive
lesbar	positive
lesenswert	positive
leserfreundlich	positive
leserlich	positive
letal	negative
lethargisch	negative
letztendlich	positive
letztgenannt	positive
letztinstanzlich	positive
letztlich	positive
letztmöglich	positive
leuchtend	positive
leuchtendrot	positive
leutselig	positive
liberaldemokratisch	positive
liberal	positive
lichtarm	negative
lichtbeständig	negative
lichtblau	positive
lichtdurchflutet	positive
lichtdurchlässig	positive
lichtecht	negative
lichterloh	positive
lichtgrau	positive
lichtgrün	positive
licht	negative
lichtschwach	negative
lichtstark	positive
lichtundurchlässig	negative
liebenswert	positive
liebenswürdig	positive
liebesfähig	positive
liebevoll	positive
lieblich	positive
lieb	positive
liebreich	positive
liebreizend	positive
liederlich	negative
liiert	positive
lilafarben	positive
lilafarbig	positive
lila	positive
lilienweiss	positive
limitiert	negative
lindgrün	positive
lind	negative
linear	negative
linke	negative
link	negative
linksbündig	negative
linksextremistisch	positive
linksextrem	positive
linkslastig	negative
linksliberal	positive
linksradikal	positive
liquide	positive
liquid	positive
literarhistorisch	positive
literaturgeschichtlich	positive
literaturhistorisch	positive
lithografisch	positive
litographisch	positive
lizenzkonform	positive
lobenswert	positive
löblich	positive
löchrig	positive
locker	positive
lohnabhängig	negative
lohnend	positive
lohnen	positive
lohnenswert	positive
lohnintensiv	negative
lohnsteuerpflichtig	positive
loh	positive
lokal	negative
lösbar	positive
lose	positive
löslich	positive
los	positive
lötfähig	positive
lotrecht	negative
lückenhaft	negative
lückenlos	positive
luderhaft	negative
luftdicht	negative
luftdurchlässig	positive
luftgefüllt	positive
luftgekühlt	negative
luftig	negative
luftleer	negative
luftundurchlässig	negative
luft- und wasserdicht	negative
lügnerisch	negative
lümmelhaft	negative
lumpig	negative
lungenkrank	negative
lupenrein	positive
lustbetont	positive
lüstern	positive
lustfeindlich	negative
lustig	positive
lustvoll	positive
luzid	negative
luziferisch	negative
machbar	positive
mächtig	positive
machtlos	negative
machtvoll	positive
mafiaähnlich	positive
magenfreundlich	positive
magenkrank	negative
magentafarben	positive
magenta	positive
magenverträglich	positive
mager	negative
magersüchtig	negative
magisch	positive
magmarot	positive
magnetisierbar	positive
majestätisch	positive
makaber	negative
malerisch	positive
malermeisterin	positive
malermeister	positive
maliziös	negative
malvenfarben	positive
malvenfarbig	positive
mammut	positive
mancherlei	positive
mangelnd	negative
manieriert	negative
manierlich	positive
manifest	positive
manipulierbar	negative
männerfeindlich	negative
männertypisch	positive
mannigfach	positive
mannschaftsdienlich	positive
mannschaftsmeisterin	positive
mannschaftsmeister	positive
mannschaftstauglich	positive
mannsgross	positive
mannshoch	positive
manövrierunfähig	negative
märchenhaft	positive
märchen	positive
marginal	negative
marineblau	positive
marine	positive
markant	positive
marketingzweck	positive
markig	positive
marktbeherrschend	positive
marktfähig	positive
marktführend	positive
marktgerecht	positive
marktreif	positive
marktschreierisch	negative
marmoriert	negative
marode	positive
marod	positive
martialisch	negative
marxistisch-leninistisch	positive
maschinenlesbar	positive
maschinenmodell	positive
massenhaft	positive
massgebend	positive
massgeblich	positive
massgerecht	positive
massgeschneidert	positive
massig	positive
massiv	positive
masslos	positive
massstäblich	positive
massstabsgerecht	positive
massstabsgetreu	positive
massvoll	positive
masurisch	positive
materialintensiv	negative
matschig	positive
mattgelb	positive
mattgrün	positive
matt	negative
mattweiss	positive
mau	negative
maurermeisterin	positive
maurermeister	positive
mausetot	negative
mausgrau	positive
maximal	positive
maxi	positive
medaillenaussichten	positive
medaillenchance	positive
medaillenerfolg	positive
medikamentenabhängig	negative
meditativ	positive
meergrün	positive
megascharf	positive
mehlig	positive
mehrdeutig	negative
mehrfach	positive
mehrfarbig	negative
mehrheitlich	positive
mehrheitsfähig	positive
mehrmalig	positive
mehrschichtig	positive
mehrspurig	positive
meilenlang	positive
meilenweit	positive
meisterhaft	positive
meisterin	positive
meisterleistung	positive
meisterlich	positive
meister	positive
meisterschaftschance	positive
meistgenannt	positive
melancholisch	negative
melodramatisch	positive
memmenhaft	negative
menschenähnlich	positive
menschenfeindlich	negative
menschenfreundlich	positive
menschengross	positive
menschenleer	negative
menschenscheu	negative
menschenunwürdig	negative
menschenverachtend	negative
menschenverträglich	positive
menschenwürdig	positive
menschlich	positive
mephistophelisch	negative
merkbar	negative
merklich	negative
messbar	negative
messerscharf	positive
messinggelb	positive
metabolisch	negative
metallfarben	positive
metallicgrau	positive
metamorph	positive
metaphysisch	negative
meterhoch	positive
meterlang	positive
methodisch	positive
methodistisch	positive
mickerig	negative
mickrig	negative
miefig	negative
miesepetrig	negative
mies	negative
mietfrei	positive
mikroskopisch	negative
milchig	negative
milchweiss	positive
mildernd	positive
mild	negative
mildtätig	positive
militant	negative
militärgeschichtlich	positive
militärhistorisch	positive
milliardenschwer	positive
millimetergross	positive
millionenfach	positive
millionenschwer	positive
minderheitenfeindlich	negative
minder	negative
minderwertig	negative
mindeste	negative
minimalistisch	negative
minimal	negative
mini	negative
minutenlang	positive
minütlich	positive
mischbar	positive
miserabel	negative
missbräuchlich	negative
missfällig	negative
missgelaunt	negative
missgestimmt	negative
misslaunig	negative
misslich	negative
misslungen	negative
missmutig	negative
missraten	negative
misstrauisch	negative
missverständlich	negative
mistig	negative
mitgenommen	negative
mitgliederschwach	negative
mitgliederstark	positive
mitleidslos	negative
mitreissend	positive
mitschuldig	negative
mittagshimmel	positive
mittelbar	negative
mittelgross	positive
mittelhoch	positive
mittellang	positive
mittelschwer	positive
mobil	positive
modebewusst	positive
modellfall	positive
modellierbar	positive
modell	positive
moderat	positive
moderig	negative
modifizierbar	negative
modrig	negative
möglich	positive
mollig	positive
monatelang	positive
monatlich	positive
mondän	positive
monochromatisch	positive
monochrom	positive
monströs	positive
montierbar	positive
moosgrün	positive
moralisch	positive
moral	positive
morastig	positive
morbide	negative
morbid	negative
mörderisch	negative
mordsmässig	positive
morgenhimmel	positive
morphiumsüchtig	negative
morsch	positive
mosaikartig	negative
müde	positive
muffelig	negative
muffig	negative
mühelos	positive
mühevoll	negative
mühsam	positive
mühselig	positive
mulmig	negative
multiplikativ	positive
multitaskingfähig	positive
mündelsicher	positive
mundgerecht	positive
munter	positive
mürbe	positive
mürb	positive
mürrisch	negative
muschelkalkhaltig	negative
musikalisch	positive
musikbegabt	positive
musikgeschichtlich	positive
musikhistorisch	positive
muskelbepackt	positive
muskelschwach	negative
muskulös	positive
müssig	negative
musterbeispiel	positive
mustergültig	positive
musterhaft	positive
muster	positive
mutig	positive
mutmasslich	positive
mütterlich	positive
mutterlos	negative
mysteriös	negative
mystisch	positive
mythe	positive
mythisch	positive
mythos	positive
nachahmenswert	positive
nachdenklich	negative
nachdrücklich	positive
nachgiebig	positive
nachhaltig	positive
nachlassend	negative
nachlässig	negative
nachmessbar	negative
nachprüfbar	positive
nachrangig	negative
nachrüstbar	positive
nächstgelegen	positive
nächstliegend	positive
nächstmöglich	positive
nachtblau	positive
nachteilig	negative
nächtelang	positive
nachthimmel	positive
nachtragend	negative
nachvollziehbar	negative
nahe gelegen	positive
nahegelegen	positive
naheliegend	positive
nahe	positive
nah	positive
nahrhaft	positive
nährstoffarm	negative
nährstoffreich	positive
nahtlos	negative
naiv	positive
namenhaft	positive
namensgleich	positive
namentlich	positive
namhaft	positive
nämlich	positive
narrativ	positive
narrenhaft	negative
närrisch	positive
naseweis	positive
nasskalt	negative
nasskühl	negative
nationalistisch	positive
nationalkonservativ	negative
nationalliberal	positive
nationalstaatlich	positive
naturalistisch	positive
naturbedingt	positive
naturbelassen	positive
naturfarben	positive
naturgegeben	positive
naturgemäss	positive
naturgeschichtlich	positive
naturgetreu	positive
naturhistorisch	positive
naturidentisch	negative
natürlich	positive
naturnah	positive
natur	positive
naturrein	positive
naturverträglich	positive
nebelgrau	positive
nebelverhangen	negative
nebenamtlich	positive
nebenberuflich	positive
nebensächlich	negative
nebenstehend	positive
neblig	negative
nebligtrüb	negative
nebulös	negative
neckisch	positive
negativbeispiel	positive
negativ	negative
nennbar	negative
nennenswert	positive
neonfarben	positive
neongrün	positive
nervenschädigend	negative
nervenschädlich	negative
nervenschwach	negative
nervenstark	positive
nervig	negative
nervlich	positive
nervös	positive
nervtötend	negative
nestor	positive
nett	positive
netzwerkfähig	positive
neuerlich	positive
neunfach	positive
neunmalig	positive
neuntgrösste	positive
neunzigprozentig	negative
neural	positive
neureich	positive
neuronal	positive
neuwertig	positive
n-fach	positive
nichtig	negative
nicht linear	positive
nichtlinear	positive
nicht öffentlich	negative
nichtöffentlich	negative
nicht offiziell	positive
nichtoffiziell	positive
nicht selbstständig	positive
nichtselbstständig	positive
nichtsnutzig	negative
nicht staatlich	negative
nichtstaatlich	negative
nicht ständig	positive
nichtständig	positive
nieder	negative
niederrangig	negative
niederschmetternd	negative
niederträchtig	negative
niedertracht	negative
niedlich	positive
niedrig	negative
nierenkrank	negative
nierenschädigend	negative
nierenschädlich	negative
niveaugleich	positive
nivelliert	positive
nobel	positive
nochmalig	positive
nölig	negative
nominal	negative
nominell	negative
nonchalent	positive
nonkonformistisch	positive
nonplusultra	positive
nordhimmel	positive
nörgelig	negative
nörglerisch	negative
normalgross	positive
normalspurig	positive
normativ	positive
normgemäss	positive
norm	positive
notbehelfsmässig	negative
notdürftig	negative
notenbeispiel	positive
notgedrungen	positive
notiert	positive
nötig	positive
not leidend	negative
notleidend	negative
notorisch	positive
notwendig	positive
nüchtern	positive
nussbraun	positive
nutzbar	positive
nutzbringend	positive
nützlich	positive
nutzlos	negative
nutzungsberechtigt	positive
oben genannt	positive
obengenannt	positive
oberflächennah	positive
oberflächlich	negative
obgenannt	positive
objektiv	positive
obligatorisch	positive
obligat	positive
obrigkeitsstaatlich	positive
obskur	negative
obstinat	negative
obszön	negative
ockerbraun	positive
ockerfarben	positive
ockerfarbig	positive
ockergelb	positive
offenbar	positive
offen geblieben	positive
offengeblieben	positive
offen gelassen	positive
offengelassen	positive
offenherzig	positive
offenkundig	positive
offen	positive
offensichtlichkeit	positive
offensichtlich	positive
offensiv	negative
offen stehend	positive
offenstehend	positive
öffentlich	positive
offiziell	positive
offiziös	negative
oftmalig	positive
ohnmächtig	negative
okay	positive
okkult	negative
ölig	negative
oligotroph	negative
olivbraun	positive
olivfarben	positive
olivgrau	positive
olivgrün	positive
oliv	positive
oll	negative
öllöslich	positive
ominös	negative
omnipotent	positive
omnipräsent	positive
opak	negative
opiumsüchtig	negative
opportun	positive
oppositionell	negative
optimal	positive
optional	negative
opulent	positive
orangefarben	positive
orangefarbig	positive
orangegelb	positive
orangen	positive
orange	positive
orangerot	positive
ordentlich	positive
ordinär	negative
ordnung	positive
ordnungsgemäss	positive
ordnungsliebend	positive
ordnungssinn	positive
orgelbaumeisterin	positive
orgelbaumeister	positive
orgiastisch	negative
orientierungssinn	positive
originalgetreu	positive
original	positive
originell	positive
orphisch	positive
orthodox	negative
orthogonal	positive
ortsabhängig	negative
ortsfest	negative
ortsfremd	negative
ortsnah	positive
ortsunabhängig	positive
osi-modell	positive
ostentativ	positive
österreichweit	positive
osthimmel	positive
ostpreussisch	positive
out	negative
oval	positive
ozonschädigend	negative
ozonschädlich	negative
paarig	positive
paarungsbereit	negative
paarungswillig	negative
panikartig	positive
panisch	positive
pantomimisch	positive
panzerbrechend	positive
paradebeispiel	positive
paradiesisch	positive
paradies	positive
paradigma	positive
paradigmatisch	positive
paradox	negative
parallel	positive
paralysiert	positive
paranoid	negative
paranormal	negative
paritätisch	positive
parkähnlich	positive
parteiamtlich	positive
parteifeindlich	negative
parteiisch	negative
parteischädigend	negative
parteiunabhängig	positive
partiell	negative
partizipierend	positive
partnerschaftlich	positive
passabel	positive
passend	positive
passen	positive
passierbar	positive
passiv	negative
pastellblau	positive
pastellfarben	positive
pastellfarbig	positive
pastellig	positive
pastell	positive
pastos	positive
patentamtlich	positive
pathetisch	positive
patzig	negative
pausenlos	positive
pech	negative
pechschwarz	negative
pedantisch	positive
peinlich	positive
pejorativ	negative
penetrant	positive
penibel	positive
perfekt	positive
perfide	negative
perfid	negative
perforiert	negative
periodisch	positive
peripher	negative
periphrastisch	negative
perkutan	negative
perlgrau	positive
perlweiss	positive
permanent	positive
permissiv	negative
personalintensiv	negative
personal	negative
personenbezogen	negative
persönlich	negative
perspektivreich	positive
pestverseucht	negative
pfeilschnell	negative
pfirsichfarben	positive
pflanzenverträglich	positive
pflaumenblau	positive
pflegeabhängig	negative
pflegebedürftig	negative
pflegeleicht	positive
phänomenal	positive
phänomen	positive
phantasielos	negative
phantasiereich	positive
phantasievoll	positive
phantastisch	positive
pharisäisch	negative
philanthropisch	positive
phlegmatisch	negative
pickelig	negative
pickel	negative
pigmentiert	positive
pikant	negative
pikiert	negative
pinkfarben	positive
pink	positive
plakativ	negative
planbar	negative
plastisch	positive
plattig	negative
platt	negative
plausibel	positive
plebejisch	negative
pleite	negative
plump	negative
pöbelhaft	negative
polemisch	negative
polizeihauptmeister	positive
polychrom	negative
polymorph	negative
polyrhythmisch	positive
pompös	positive
popelig	negative
poplig	negative
poppig	negative
populär	positive
porös	positive
portofrei	positive
positiv	positive
possenhaft	positive
possierlich	positive
postamtlich	positive
postmeisterin	positive
postmeister	positive
postwendend	negative
potentiell	positive
potent	positive
potenziell	positive
potthässlich	negative
prächtig	positive
pracht	positive
prachtvoll	positive
prädestinieren	positive
prädestiniert	positive
prädikatisieren	positive
prägend	positive
prägnant	positive
prahlerisch	negative
praktikabel	positive
prall	positive
prallvoll	positive
prätentiös	negative
praxisgerecht	positive
praxistauglich	positive
präzedenzfall	positive
preisgekrönt	positive
preisgünstig	positive
preisstabil	negative
preiswert	positive
preiswürdig	positive
prekär	positive
prestige	positive
prestigeträchtig	positive
preussen	positive
preussisch	positive
prima	positive
primär	positive
primitiv	negative
privat	negative
probat	positive
probiotisch	positive
problematisch	positive
problemfrei	negative
problemlos	negative
problemvoll	positive
produktiv	positive
profilieren	positive
profund	positive
programmatisch	positive
progressiv	positive
prominent	positive
prompt	negative
propagandazweck	positive
prothetisch	negative
protokollarisch	positive
prototypisch	positive
prototyp	positive
protzig	positive
provokant	positive
provokativ	negative
provozierend	negative
provozieren	negative
prozyklisch	positive
prüde	positive
prüfbar	positive
prunkhaft	positive
prunk	positive
prunkvoll	positive
pseudonym	negative
psychotisch	negative
publik	positive
publikumserfolg	positive
publiziert	positive
pummelig	positive
punktgleich	positive
pünktlich	positive
pur	positive
purpurfarben	positive
purpurfarbig	positive
purpurrot	positive
putzig	positive
putzmunter	positive
putzsüchtig	negative
pygmäenhaft	negative
pythisch	positive
qualitätsvoll	positive
qualitätvoll	positive
qualvoll	negative
quartiermeisterin	positive
quartiermeister	positive
quaternär	positive
quengelig	negative
quer gestreift	negative
quergestreift	negative
quer	negative
quicklebendig	positive
quick	positive
quietschfidel	positive
quietschvergnügt	positive
quirlig	positive
rabenschwarz	negative
rabiat	negative
radikal	positive
raffiniert	negative
ramponiert	negative
randvoll	positive
ranghoch	positive
rangnieder	negative
rank	negative
ranzig	negative
rapide	negative
rapid	negative
rappeldürr	negative
rar	positive
rasant	negative
rasch	negative
rasend	positive
rassig	positive
rassistisch	negative
ratlos	negative
ratsam	positive
rätselhaft	positive
rat suchend	negative
ratsuchend	negative
raubeinig	negative
räuberisch	negative
rauchfarben	positive
rauchgrau	positive
rauchig	positive
rauchschwach	negative
rauhaarig	negative
raumgreifend	positive
raumhoch	positive
rau	negative
rauschgiftsüchtig	negative
reaktionär	negative
reaktionsfähig	positive
reaktionsschnell	positive
realisierbar	positive
realitätssinn	positive
rebellisch	negative
rechenbeispiel	positive
rechenexempel	positive
recherchierbar	positive
rechtgläubig	negative
rechtmässig	positive
recht	positive
rechtsbündig	negative
rechtschaffenheit	positive
rechtschaffen	positive
rechtsextremistisch	positive
rechtsextrem	positive
rechtsfähig	positive
rechtsgefühl	positive
rechtsgerichtet	positive
rechtsgeschichtlich	positive
rechtshistorisch	positive
rechtskonservativ	positive
rechtslastig	negative
rechtsliberal	positive
rechtsorientiert	positive
rechtsradikal	positive
rechtsseitig	positive
rechtssinn	positive
rechtsstaatlich	positive
rechtsverbindlich	positive
rechtswidrig	negative
rechtwinkelig	positive
rechtwinklig	positive
recyceln	positive
recyclen	positive
recyclingfähig	positive
redebegabt	positive
redegewandt	positive
redlich	positive
reduktionistisch	negative
reflexartig	negative
reflexhaft	negative
reformatorisch	positive
reformerisch	positive
reformfeindlich	negative
reformistisch	positive
regelbar	positive
regelgemäss	positive
regelgerecht	positive
regelhaft	positive
regelkonform	positive
regelmässig	positive
regelrecht	positive
regenbogenfarben	negative
regenerationsfähig	positive
regenerativ	positive
rege	positive
regierungsamtlich	positive
regierungsfähig	positive
regierungsfeindlich	negative
regimefeindlich	negative
regionalgeschichtlich	positive
regionaltypisch	positive
registriert	positive
regressiv	negative
regulär	positive
regulierbar	positive
reguliert	negative
rehbraun	positive
reibungslos	negative
reichhaltig	positive
reichlich	positive
reich	positive
reichsfrei	positive
reichsunmittelbar	positive
reich verziert	positive
reichverziert	positive
reiflich	positive
reinlich	positive
rein	positive
reinweiss	positive
reinziehen	negative
reissend	positive
reissfest	negative
reizbar	negative
reizend	positive
rekonstruierbar	positive
rekordhalterin	positive
rekordhalter	positive
rekordlerin	positive
rekordler	positive
relativ	negative
relevant	positive
religionsfeindlich	negative
religionsgeschichtlich	positive
religionshistorisch	positive
renitent	negative
rennend	positive
renommiert	positive
renovierbar	positive
renovierungsbedürftig	negative
reparabel	negative
reparaturbedürftig	negative
repräsentationszweck	positive
repräsentativ	positive
repressiv	positive
reproduzierbar	positive
republikfeindlich	negative
reputierlich	positive
reserviert	negative
resistent	positive
resolut	positive
respektabel	positive
restaurativ	negative
restlich	positive
restlos	positive
restriktiv	negative
restringiert	negative
retardiert	negative
reumütig	negative
reversibel	negative
revolutionär	positive
rezeptiv	positive
rezessiv	negative
rhythmisch	positive
richtiggehend	positive
richtig	positive
richtungsstabil	negative
richtungsweisend	positive
richtungweisend	positive
riesenerfolg	positive
riesengross	positive
riesenhaft	positive
riesig	positive
rigide	negative
rigid	negative
rigoros	negative
risikobehaftet	negative
risikoreich	negative
riskant	negative
ritterlich	positive
robust	negative
roh	negative
rohstoffarm	negative
rohstoffreich	positive
rollstuhlgerecht	positive
rosafarben	positive
rosafarbig	positive
rosa	positive
rosarot	positive
roséfarben	positive
roséfarbig	positive
rosenrot	positive
rosé	positive
rosig	positive
rostbraun	positive
rostfarben	positive
rostfarbig	positive
rostig	positive
rostrot	positive
rotblau	positive
rot glühend	positive
rotglühend	positive
rötlichbraun	positive
rötlich	positive
rot	positive
royal	positive
rubinrot	positive
ruchbar	negative
ruchlos	negative
ruckartig	negative
rückfällig	negative
rückführbar	positive
rückgängig	negative
rückgebildet	negative
rückläufig	negative
rückständig	negative
rückwärtsgewandt	negative
rückzahlbar	positive
rüde	negative
rudimentär	negative
rüd	negative
rufschädigend	negative
ruhig	negative
rühmlich	positive
ruhmreich	positive
ruhmvoll	positive
ruinieren	negative
ruiniert	negative
ruinös	negative
rundlich	positive
rund	positive
runzelig	positive
runzlig	positive
rüpelhaft	negative
ruppig	negative
russisch-orthodox	negative
russschwarz	negative
rüstig	positive
rustikal	negative
rutschfest	positive
rutschig	negative
sachfremd	negative
sachgemäss	positive
sachgerecht	positive
safranfarben	positive
safrangelb	positive
sagenhaft	positive
saisonal	positive
saisonbedingt	positive
sakrosankt	negative
salomonisch	positive
salonfähig	positive
salopp	positive
sämig	positive
sandfarben	positive
sandfarbig	positive
sanftmütig	positive
sanft	negative
sanierungsbedürftig	negative
sanitär	positive
saphirblau	positive
sarkastisch	negative
satanisch	negative
sattgelb	positive
sattgrün	positive
sattrot	positive
satzungsgemäss	positive
säuberlich	positive
säuerlich	negative
sauer	negative
saukomisch	positive
saumässig	positive
säumig	negative
säurefest	negative
schäbig	negative
schachbrettartig	negative
schachgrossmeisterin	positive
schachgrossmeister	positive
schachmeister	positive
schade	negative
schadenfroh	negative
schaden	negative
schadhaft	negative
schädigend	negative
schädigen	negative
schädlich	negative
schalkhaft	positive
schalk	positive
schalldicht	negative
schallgedämpft	negative
schaltbar	positive
schamhaft	positive
schamlos	negative
schändlich	negative
scharenweise	positive
scharfkantig	positive
scharf	positive
scharfzüngig	negative
scharlachrot	positive
scharmant	positive
scharm	positive
schauderhaft	negative
schaudervoll	negative
schauerhaft	negative
schauerlich	negative
schaurig	negative
schauspielerisch	positive
scheinbar	negative
scheinheilig	negative
scheiss	negative
schelmisch	positive
schelm	positive
schemenhaft	negative
scherzhaft	positive
scheusslich	negative
schicklich	positive
schicksalhaft	positive
schieferblau	positive
schiefergrau	positive
schiefgegangen	negative
schiefgelaufen	negative
schief	positive
schier	positive
schiessmeisterin	positive
schiessmeister	positive
schiffbar	positive
schikanös	negative
schillernd	positive
schimmelig	negative
schimmernd	positive
schlabberig	positive
schlabbrig	positive
schlaff	negative
schläfrig	positive
schlaftrunken	positive
schlafwandlerisch	negative
schlagfertig	positive
schlagkräftig	positive
schlagwortartig	negative
schlammig	positive
schlampig	negative
schlank	negative
schlapp	negative
schlecht gelaunt	negative
schlechtgelaunt	negative
schlecht	negative
schleichend	positive
schleierhaft	positive
schleimig	positive
schleppend	positive
schlicht	negative
schliessbar	positive
schlimm	negative
schlohweiss	positive
schlossermeisterin	positive
schlossermeister	positive
schludrig	negative
schlüpfrig	negative
schlüsselfertig	negative
schmächtig	negative
schmackhaft	negative
schmalspurig	negative
schmalzig	negative
schmeichelhaft	positive
schmelzbar	positive
schmelzflüssig	positive
schmiedbar	positive
schmiedemeisterin	positive
schmiedemeister	positive
schmierig	negative
schmuck	positive
schmuckvoll	positive
schmuddelig	negative
schneebedeckt	negative
schneeweiss	positive
schneidermeisterin	positive
schneidermeister	positive
schneidig	positive
schnellfüssig	negative
schnell	negative
schnellstmöglich	negative
schnellwüchsig	negative
schnippisch	negative
schnoddrig	negative
schnöde	negative
schnurgerade	negative
schockiert	positive
schokoladenbraun	positive
schöngeistig	positive
schönheitsideal	positive
schönheitssinn	positive
schön	positive
schonungslos	negative
schöpferisch	positive
schöpfungsbericht	positive
schöpfungsmythos	positive
schräg	positive
schrecken erregend	negative
schreckenerregend	negative
schrecklich	negative
schreiend	positive
schreinermeisterin	positive
schreinermeister	positive
schriftgemäss	positive
schriftstellerisch	positive
schrittweise	positive
schroff	positive
schrottreif	negative
schrullig	negative
schrumpelig	positive
schrumplig	positive
schubweise	negative
schüchtern	positive
schuldbewusst	positive
schuldfähig	positive
schuldhaft	negative
schuldig	negative
schuld	negative
schuldunfähig	negative
schuleigen	positive
schulterlang	positive
schummerig	negative
schummrig	negative
schuppig	negative
schurkisch	negative
schütter	negative
schutzbedürftig	negative
schützend	positive
schützenswert	positive
schutzfähig	positive
schutzwürdig	positive
schutzzweck	positive
schwächlich	negative
schwach	negative
schwammig	negative
schwankend	negative
schwanzgesteuert	positive
schwarzblau	positive
schwarzbraun	positive
schwarz-gelb	positive
schwarzgrau	positive
schwarzgrün	positive
schwärzlich	negative
schwarz	negative
schwarz-rot-golden	negative
schwarzrotgolden	negative
schwarzweiss	positive
schwarz-weiss-rot	negative
schwefelgelb	positive
schweigsam	negative
schweisstreibend	negative
schwer erziehbar	negative
schwererziehbar	negative
schwergewichtig	positive
schwerkrank	negative
schwer löslich	positive
schwerlöslich	positive
schwermütig	negative
schwer	positive
schwerpunktmässig	positive
schwerreich	positive
schwerverletzt	negative
schwerverwundet	negative
schwer wiegend	positive
schwerwiegend	positive
schwierig	negative
schwindlig	negative
schwindsüchtig	negative
schwulenfeindlich	negative
schwülheiss	positive
schwülstig	positive
schwunghaft	positive
schwungvoll	positive
sechsfach	positive
sechsmalig	positive
sechsspurig	positive
sechstgrösste	positive
sechzigprozentig	negative
seeamtlich	positive
seelenruhig	negative
seelig	positive
seelsorgerisch	positive
seelsorgerlich	positive
seelsorglich	positive
seetüchtig	positive
sehnig	positive
sehschwach	negative
sehsinn	positive
seicht	positive
seidig	negative
seitenlang	positive
sekundär	negative
sekundenschnell	negative
selbständig	positive
selbstbewusst	positive
selbstgefällig	negative
selbstgerecht	negative
selbstgesteckt	negative
selbstherrlich	negative
selbstironisch	negative
selbstmörderisch	negative
selbstmordgefährdet	negative
selbstschädigend	negative
selbstsicher	positive
selbstständig	positive
selbstvergessen	negative
selbstzerstörerisch	negative
selbstzweck	positive
seligkeit	positive
selten	positive
seltsam	positive
semipermeabel	positive
seniorenmeisterin	positive
seniorenmeister	positive
senkrecht	negative
sensationell	positive
sensation	positive
sepiabraun	positive
sequentiell	positive
sequenziell	positive
serienmeisterin	positive
serienmeister	positive
serienreif	positive
seriös	positive
servil	positive
sexgierig	positive
sexhungrig	positive
sexistisch	positive
sexsüchtig	negative
sexy	positive
sibyllinisch	positive
sicherheitsgefährdend	negative
sicher	positive
sichtlich	positive
siderisch	positive
siebenfach	positive
siebenmalig	positive
siebtgrösste	positive
siebzigprozentig	negative
siegchance	positive
siegesbewusst	positive
siegesgewiss	positive
siegessicher	positive
sieg	positive
siegreich	positive
signifikant	positive
silberfarben	positive
silberfarbig	positive
silbergrau	positive
silberweiss	positive
silbrig	positive
simpel	negative
singbar	positive
singulär	negative
sinkend	negative
sinnentleert	negative
sinnentstellend	negative
sinnfällig	negative
sinngemäss	positive
sinngetreu	positive
sinnhaft	positive
sinnig	positive
sinnleer	negative
sinnlich	positive
sinnlos	negative
sinn	positive
sinnreich	positive
sinnverwandt	positive
sinnvoll	positive
sintflutartig	negative
sirupähnlich	positive
sittenlos	negative
sitte	positive
sittlichkeit	positive
sittlich	positive
sittsam	positive
situationsabhängig	negative
situationsgerecht	positive
situativ	negative
situiert	positive
skalierbar	positive
skandalös	positive
skandalträchtig	positive
skandalumwittert	positive
skeptisch	negative
smaragdgrün	positive
sofortig	negative
soft	positive
sogenannt	positive
solidarisch	positive
solide	positive
solid	positive
solitär	negative
solo	negative
sommerhimmel	positive
sommerlich	positive
sommerlich-sonnig	positive
sonderlich	negative
sonnenbeschienen	positive
sonnengelb	positive
sonnennah	positive
sonnig	positive
sonntäglich	positive
sonstig	negative
sorgeberechtigt	positive
sorgfältig	positive
sorgsam	positive
sortenrein	positive
souverän	positive
sozialgeschichtlich	positive
sozialliberal	positive
sozialprestige	positive
sozialstaatlich	positive
sozialverträglich	positive
spärlich	negative
spartanisch	negative
spasshaft	positive
spassig	positive
spätsommerlich	positive
speicherbar	positive
spektakulär	positive
spekulativ	negative
sperrig	negative
spiegelglatt	negative
spielbar	positive
spielberechtigt	positive
spielend	positive
spielerisch	positive
spielfähig	positive
spielfreudig	positive
spielgewinn	positive
spielstark	positive
spielsüchtig	negative
spiessbürgerlich	negative
spiesserhaft	negative
spiesserisch	negative
spiessig	negative
spindeldürr	negative
spitzenmässig	positive
spitze	positive
spitzfindig	negative
spitz	negative
spitzwinkelig	positive
spitzwinklig	positive
spleenig	negative
splendid	negative
spontan	positive
sporadisch	positive
sportiv	positive
sportlich	positive
sport	positive
spottbillig	positive
spöttisch	negative
sprachbegabt	positive
sprachgeschichtlich	positive
sprachhistorisch	positive
sprichwörtlich	positive
spröde	negative
spröd	negative
sprunghaft	negative
spukhaft	negative
spürsinn	positive
staatlich	positive
staatsbürgerlich	negative
staatseigen	positive
staatsfeindlich	negative
staatsgefährdend	negative
staatskonform	positive
staatsmännisch	positive
staatstragend	positive
stabil	negative
stachelig	negative
stachlig	negative
stadtbekannt	positive
stadteigen	positive
stadtgeschichtlich	positive
stadthistorisch	positive
stadtnah	positive
stadtverträglich	positive
stahlblau	positive
stahlgrau	positive
stahlhart	negative
staksig	negative
stallmeisterin	positive
stallmeister	positive
stammesgeschichtlich	positive
stämmig	positive
standardmodell	positive
standesamtlich	positive
standesgemäss	positive
standesherrlich	positive
standfest	positive
standhaft	positive
ständig	positive
starkfarbig	positive
stark	positive
starrköpfig	negative
starr	negative
starrsinnig	negative
startbereit	negative
startfertig	negative
startklar	negative
statisch	negative
statthaft	positive
stattlich	positive
statutengemäss	positive
stechend	positive
steif	negative
steigend	positive
steil	positive
steilwandig	positive
steingrau	positive
steinhart	negative
steinmetzmeisterin	positive
steinmetzmeister	positive
steinreich	positive
sterbenskrank	negative
sterblich	negative
stereotypisch	positive
stereotyp	positive
steril	positive
sternenhimmel	positive
sternhimmel	positive
stetig	positive
stet	positive
steuerbar	positive
steuergünstig	positive
steuerpflichtig	positive
stichhaltig	positive
stichprobenartig	negative
stichpunktartig	negative
stichwortartig	negative
stiefmütterlich	negative
stilbildend	positive
stilecht	positive
stilgerecht	positive
still	negative
stillschweigend	negative
stilsicher	positive
stilvoll	positive
stimmberechtigt	positive
stimmfähig	positive
stimmig	positive
stinkreich	positive
stockdunkel	negative
stockend	positive
stockfinster	negative
stocksteif	negative
stoisch	negative
stoned	negative
störend	negative
störrisch	negative
stossweise	negative
strafbar	negative
straffällig	negative
straff	negative
sträflich	negative
strafmildernd	positive
strafsenkend	positive
strafwürdig	negative
strahlend	positive
strahlen	positive
strahlenverseucht	negative
strähnig	negative
stramm	negative
strapazierfähig	negative
strapaziös	negative
streichfähig	positive
streifig	negative
streitbar	positive
streitig	negative
streitlustig	negative
streit	negative
streitsüchtig	negative
strenggläubig	negative
streng	positive
stressig	negative
strickmuster	positive
strikt	positive
strittig	negative
strohgelb	positive
strömungsgünstig	positive
strukturschwach	negative
studienzweck	positive
stümperhaft	negative
stümperin	negative
stümper	negative
stumpf	negative
stumpfwinkelig	positive
stumpfwinklig	positive
stundenlang	positive
stündlich	positive
stupide	negative
stupid	negative
stur	negative
stutzig	negative
subjektiv	negative
subkutan	negative
sublim	positive
subsidiär	positive
subtil	positive
subtropisch	positive
subversiv	negative
suchtgefährdet	negative
süchtig	negative
südhimmel	positive
südpreussisch	positive
süffisant	negative
suizidgefährdet	negative
sukzessiv	positive
summarisch	negative
sündhaft	negative
sündig	negative
superior	positive
super	positive
superreich	positive
superschnell	negative
superwichtig	positive
suspekt	positive
süsslich	positive
süss	positive
symbolhaft	negative
symbolhaltig	negative
symbolisch	negative
sympathie erweckend	positive
sympathieerweckend	positive
sympathisch	positive
symptomatisch	positive
synchron	positive
synonym	positive
synthetisch	negative
systemimmanent	positive
systemkonform	positive
szenetypisch	positive
tablettensüchtig	negative
tabu	negative
tadelnswert	negative
tagelang	positive
tageshimmel	positive
taggen	positive
taghimmel	positive
täglich	positive
tagtäglich	positive
tagtraum	positive
taktlos	negative
taktvoll	positive
talentiert	positive
tannengrün	positive
tanzbar	positive
tänzerisch	positive
tastsinn	positive
tatkräftig	positive
tatkraft	positive
tätlich	negative
tatsache	positive
taubenblau	positive
taubengrau	positive
taugen	positive
tauglich	positive
täuschend	negative
tausendfach	positive
teamfähig	positive
technikfeindlich	negative
technikfreundlich	positive
technikgläubig	positive
technikorientiert	positive
technokratisch	positive
teilbar	positive
teilerfolg	positive
teilnahmeberechtigt	positive
teilnehmend	positive
teilrechtsfähig	positive
teilweise	negative
temperamentvoll	positive
temperaturabhängig	negative
temperaturbeständig	negative
temporär	positive
temporeich	negative
tendenziös	negative
tennisballgross	positive
ternär	positive
testzweck	positive
teuer	negative
teuflisch	negative
textbeispiel	positive
textmuster	positive
texturiert	negative
theatergeschichtlich	positive
theatralisch	positive
thematisiert	positive
therapierbar	negative
therapieresistent	positive
therapierfolg	positive
thermodynamisch	positive
thermoplastisch	positive
thermostabil	negative
tiefblau	positive
tiefbraun	positive
tiefdunkel	negative
tiefgehend	positive
tiefgekühlt	negative
tiefgreifend	positive
tiefgründig	positive
tiefgrün	positive
tief	positive
tiefreichend	positive
tiefrot	positive
tiefschürfend	positive
tiefschwarz	negative
tiefsinnig	positive
tieftraurig	negative
tierfreundin	positive
tierfreund	positive
tierliebhaberin	positive
tierliebhaber	positive
tiermodell	positive
tiernärrin	positive
tiernarr	positive
tischlermeisterin	positive
tischlermeister	positive
titelchance	positive
titelhalterin	positive
titelhalter	positive
titelverteidigerin	positive
titelverteidiger	positive
todkrank	negative
tödlich	negative
todmüde	positive
todsicher	positive
todtraurig	negative
todunglücklich	negative
tolerant	positive
toll	positive
tollwütig	positive
tonangebend	positive
tonnenschwer	positive
topisch	negative
top	positive
torchance	positive
torgefährlich	negative
torreich	positive
totalitär	positive
total	positive
totenähnlich	positive
totgeboren	negative
tot	negative
toxisch	negative
traditionell	negative
traditionsgemäss	positive
traditionsreich	positive
tragbar	positive
träge	positive
tragfähig	negative
tragikomisch	negative
tragikomisch	positive
tragisch	negative
träg	positive
trainiert	positive
trainingszweck	positive
tränenreich	negative
tranig	positive
transparent	positive
transusig	positive
transversal	negative
transzendental	negative
transzendent	negative
traumatisch	negative
traumatisierend	negative
traumbild	positive
träumerei	positive
träumerisch	negative
traumhaft	positive
traum	positive
traurig	negative
traut	positive
travers	negative
treffend	positive
treffen	negative
trefferchance	positive
trefflich	positive
treffsicher	positive
trendig	positive
treuherzig	positive
treu sorgend	positive
treusorgend	positive
triftig	positive
trinkbar	positive
trist	negative
trittsicher	positive
triumph	positive
trivial	negative
tropisch	positive
trösten	positive
trostlos	negative
trotzig	negative
trübe	negative
trüb	negative
trübselig	negative
trübsinnig	negative
trügerisch	negative
trunksüchtig	negative
trutzig	positive
tuberkulös	negative
tüchtig	positive
tücke	negative
tückisch	negative
tugendhaft	positive
tugendlich	positive
tugend	positive
tugendreich	positive
turbulent	positive
türkisblau	positive
türkisfarben	positive
türkisgrün	positive
türkis	positive
turmhoch	positive
turniererfolg	positive
turnunsgemäss	positive
turnusmässig	positive
typisch	positive
übel gelaunt	negative
übelgelaunt	negative
übellaunig	negative
übel	negative
überarbeitet	positive
überbacken	negative
überbelastet	positive
überbelegt	negative
überbordend	positive
überbreit	positive
überbrückbar	positive
überdeutlich	positive
überdimensional	positive
überdreht	positive
übereifrig	positive
übereinkommend	positive
übereinstimmend	positive
überflüssig	negative
überfordert	positive
überfüllt	positive
übergewichtig	positive
überglücklich	positive
übergross	positive
überhart	positive
überhastet	negative
überhöht	positive
überkandidelt	positive
überlang	positive
überlastet	positive
überlebenschance	positive
überlebensfähig	positive
überlebensgross	positive
überlebenswichtig	positive
überlegen	positive
übermächtig	positive
übermannshoch	positive
übermässig	positive
übermenschlich	positive
übermütig	positive
übermut	positive
übernatürlich	negative
überproportional	positive
überprüfbar	positive
überpünktlich	positive
überqualifiziert	negative
überragend	positive
überragen	positive
überraschungserfolg	positive
überreich	positive
übersät	negative
überschaubar	positive
überschäumend	positive
überschuldet	positive
überschwänglich	positive
überschwang	positive
überschwer	positive
überseeisch	negative
übersehbar	positive
übersichtlich	positive
übersinnlich	negative
überspannt	positive
überstaatlich	positive
überstark	positive
überstürzt	negative
übertragen	negative
übertrieben	positive
übervoll	positive
überwiegend	positive
überwindbar	positive
überzählig	positive
überzeugend	positive
überzeugt	positive
überzogen	positive
überzuckert	negative
ubiquitär	positive
übrig geblieben	positive
übriggeblieben	positive
übrig	positive
übungszweck	positive
uferlos	negative
ufernah	positive
ulkig	positive
ultrakompakt	positive
ultralang	positive
umfänglich	positive
umfangreich	positive
umfassend	positive
umgänglich	positive
umgehend	negative
umgekehrt	negative
umgelegt	negative
umkämpft	positive
umkehrbar	negative
umliegend	positive
umsatzschwach	negative
umsatzstark	positive
umsatzsteuerpflichtig	positive
umschrieben	positive
umsetzbar	positive
umsichtig	positive
umständlich	negative
umstehend	positive
umstritten	negative
umstürzend	negative
umstürzlerisch	negative
umtriebig	positive
umweltbelastend	negative
umweltfeindlich	negative
umweltfreundlich	positive
umweltgefährdend	negative
umweltgerecht	positive
umwelt	positive
umweltschädigend	negative
umweltschädlich	negative
umweltschonend	positive
umweltverträglich	positive
unabänderbar	positive
unabänderlich	positive
unabdingbar	positive
unabhängig	positive
unabkömmlich	positive
unablässig	positive
unabsehbar	negative
unabweisbar	positive
unabwendbar	positive
unachtsam	negative
unähnlich	negative
unakzeptabel	negative
unanfechtbar	positive
unangebracht	negative
unangefochten	positive
unangekündigt	negative
unangemeldet	negative
unangemessen	negative
unangenehm	negative
unangesagt	negative
unangreifbar	negative
unannehmbar	negative
unansehnlich	negative
unanständig	negative
unantastbar	negative
unappetitlich	negative
unartig	negative
unästhetisch	negative
unattraktiv	negative
unaufdringlich	negative
unauffallend	negative
unauffällig	negative
unaufgefordert	positive
unaufgeregt	negative
unaufhaltbar	positive
unaufhaltsam	positive
unaufhebbar	negative
unaufhörlich	positive
unauflösbar	negative
unauflöslich	negative
unaufmerksam	negative
unaufrichtig	negative
unaufschiebbar	negative
unausdenkbar	negative
unausgeglichen	negative
unausgegoren	negative
unausgereift	negative
unausgeschlafen	positive
unausgesprochen	negative
unausgewogen	negative
unauslöschlich	positive
unausschöpflich	positive
unaussprechlich	negative
unausweichlich	positive
unautorisiert	negative
unbändig	positive
unbarmherzig	negative
unbar	negative
unbeachtet	negative
unbeachtlich	negative
unbedarft	positive
unbedenklich	positive
unbedeutend	negative
unbedeutsam	negative
unbedingt	positive
unbefangen	positive
unbefestigt	positive
unbefleckt	positive
unbefriedigend	negative
unbefriedigt	negative
unbefristet	positive
unbefugt	negative
unbegabt	negative
unbegreifbar	positive
unbegreiflich	positive
unbegrenzt	positive
unbegründet	negative
unbehaglich	negative
unbeherrscht	negative
unbehindert	positive
unbeirrbar	positive
unbekannt	negative
unbekömmlich	negative
unbekümmert	positive
unbelastet	negative
unbelebt	negative
unbelegt	positive
unbelehrbar	negative
unbeleuchtet	negative
unbemerkt	negative
unbenutzbar	negative
unbeobachtet	negative
unbequem	negative
unberechenbar	negative
unberechtigt	negative
unbeschadet	positive
unbeschädigt	positive
unbescholten	positive
unbeschränkt	positive
unbeschreibbar	negative
unbeschreiblich	negative
unbeschwert	positive
unbesetzt	positive
unbesiegbar	positive
unbesiegt	positive
unbeständig	negative
unbestätigt	negative
unbestechlich	positive
unbestimmt	negative
unbestreitbar	positive
unbestritten	positive
unbeträchtlich	negative
unbewacht	positive
unbewährt	negative
unbewältigbar	negative
unbeweglich	negative
unbewohnbar	negative
unbewusst	negative
unbezahlbar	negative
unbezähmbar	positive
unbezweifelbar	positive
unbezwingbar	positive
unbillig	negative
unblutig	positive
unbotmässig	negative
unbrauchbar	negative
unbrennbar	negative
unbunt	positive
unbürokratisch	positive
undankbar	negative
undefiniert	negative
undenkbar	negative
undeutlich	negative
undicht	positive
undifferenziert	negative
undogmatisch	positive
undurchdringlich	negative
undurchführbar	negative
undurchlässig	negative
undurchschaubar	negative
undurchsichtig	negative
uneben	positive
unecht	negative
unedel	negative
unehrenhaft	negative
unehrlich	negative
uneingeladen	positive
uneinholbar	positive
uneinnehmbar	positive
uneitel	positive
unelastisch	negative
unendlich	positive
unentbehrlich	positive
unentdeckt	negative
unentgeltlich	positive
unentschieden	negative
unentschlossen	negative
unentschuldbar	negative
unentwegt	negative
unerbittlich	negative
unerfindlich	positive
unerforscht	negative
unerfreulich	negative
unergründlich	positive
unerheblich	negative
unerhört	negative
unerkannt	negative
unerkennbar	negative
unerklärbar	positive
unerklärlich	positive
unerkundet	negative
unerlässlich	positive
unerlaubt	negative
unermesslich	positive
unermüdlich	negative
unerprobt	negative
unerquicklich	negative
unerreichbar	positive
unerreicht	positive
unerschöpflich	positive
unerschwinglich	negative
unerträglich	negative
unerwähnt	negative
unfähig	negative
unfair	negative
unfallgefährdet	negative
unfassbar	positive
unfehlbar	positive
unfein	negative
unfertig	positive
unflätig	negative
unflexibel	negative
unfolgsam	negative
unförmig	negative
unfrei	negative
unfreiwillig	negative
unfreundlich	negative
ungebeten	positive
ungebrochen	positive
ungebührlich	negative
ungebunden	negative
ungeduldig	positive
ungeeignet	negative
ungefährdet	positive
ungefärbt	positive
ungefragt	positive
ungehalten	positive
ungeheissen	positive
ungehemmt	negative
ungeheuerlich	negative
ungeheuer	negative
ungehindert	positive
ungehobelt	negative
ungehörig	negative
ungehorsam	negative
ungehört	negative
ungeklärt	negative
ungekocht	negative
ungekünstelt	positive
ungekürzt	positive
ungelegen	negative
ungelenkig	negative
ungelenk	negative
ungemein	positive
ungemütlich	negative
ungenannt	negative
ungeniert	positive
ungeniessbar	negative
ungenügend	negative
ungeöffnet	negative
ungepflegt	negative
ungerechtfertigt	negative
ungerecht	negative
ungeschlacht	negative
ungeschlagen	positive
ungeschliffen	negative
ungeschminkt	positive
ungeschönt	positive
ungeschrieben	positive
ungeschützt	negative
ungesehen	negative
ungesichert	negative
ungestüm	positive
ungeteilt	positive
ungetrübt	positive
ungewiss	negative
ungezählt	positive
ungezogen	negative
ungezügelt	negative
ungezwungen	positive
ungiftig	positive
unglaubhaft	negative
unglaublich	positive
unglaubwürdig	negative
ungleich	negative
unglücklich	negative
unglück	negative
unglückselig	negative
ungünstig	negative
ungut	negative
unhaltbar	negative
unhandlich	negative
unheilbar	positive
unheilig	negative
unheilschwanger	negative
unheil verheissend	negative
unheilverheissend	negative
unheilvoll	negative
unheimlich	negative
unhöflich	negative
unhygienisch	negative
unidentifiziert	negative
uniert	positive
unignorierbar	positive
uni	positive
universalgeschichtlich	positive
unkalkulierbar	negative
unkenntlich	negative
unkeusch	negative
unklar	negative
unkomfortabel	negative
unkompliziert	positive
unkontrollierbar	negative
unkontrolliert	positive
unkonventionell	positive
unkonzentriert	negative
unkorrekt	negative
unkultiviert	negative
unkündbar	positive
unkurierbar	positive
unlesbar	negative
unleserlich	negative
unleugbar	positive
unlimitiert	positive
unlösbar	negative
unlöslich	negative
unlustig	negative
unmanierlich	negative
unmassgeblich	negative
unmässig	positive
unmenschlich	negative
unmerklich	positive
unmissverständlich	positive
unmittelbar	positive
unmöglich	negative
unmoralisch	negative
unmusikalisch	negative
unnachahmlich	positive
unnachgiebig	negative
unnahbar	negative
unnatürlich	negative
unnötig	negative
unnützlich	negative
unnütz	negative
unordentlich	negative
unorthodox	positive
unpaarig	negative
unparteiisch	positive
unpassend	negative
unpassierbar	negative
unpopulär	negative
unprätentiös	positive
unproblematisch	negative
unproduktiv	negative
unprofessionell	negative
unpünktlich	negative
unrealisierbar	negative
unrechtmässig	negative
unrecht	negative
unredlich	negative
unregelmässig	positive
unrein	negative
unrettbar	positive
unrichtig	negative
unruhig	positive
unrühmlich	negative
unsachgemäss	negative
unsagbar	negative
unsäglich	negative
unsanft	negative
unschädlich	positive
unscharf	negative
unschätzbar	positive
unscheinbar	negative
unschicklich	negative
unschlagbar	positive
unschlüssig	negative
unschön	negative
unschuldig	positive
unschuld	positive
unschwer	negative
unselbständig	negative
unselbstständig	negative
unselig	negative
unseriös	negative
unsicher	negative
unsinnig	negative
unsinn	negative
unsittlich	negative
unspektakulär	negative
unspielbar	negative
unsportlich	negative
unstabil	positive
unstandesgemäss	negative
unsterblich	positive
unstetig	negative
unstet	negative
unstimmig	negative
unstreitig	positive
unstrittig	positive
unsympathisch	negative
untadelig	positive
untadlig	positive
untalentiert	negative
untauglich	negative
unteilbar	negative
unten genannt	positive
untengenannt	positive
unterbrochen	positive
unterdrückerisch	positive
unterentwickelt	negative
unterernährt	negative
unterfordert	negative
untergewichtig	negative
unterkühlt	negative
unterlegen	negative
unterlegt	positive
unternehmenseigen	positive
unternehmungslustig	positive
unterqualifiziert	positive
unterrichtszweck	positive
unterscheidbar	negative
unterschiedlich	negative
unterschwellig	negative
untersetzt	positive
unterstützend	positive
untragbar	negative
untrainiert	negative
untröstlich	negative
untrüglich	positive
untüchtig	negative
untypisch	negative
unüberbrückbar	negative
unüberhörbar	positive
unüberprüfbar	negative
unüberschaubar	negative
unübersehbar	positive
unübersichtlich	negative
unübertrefflich	positive
unübertroffen	positive
unüberwindbar	negative
unüberwindlich	negative
unumgänglich	positive
unumkehrbar	positive
unumschränkt	positive
unumstösslich	positive
unumstritten	positive
unumwunden	positive
ununterbrochen	positive
ununterscheidbar	positive
unveränderbar	positive
unveränderlich	positive
unverändert	positive
unverantwortbar	negative
unverantwortlich	negative
unverbesserlich	negative
unverbindlich	negative
unverblümt	positive
unverbrüchlich	positive
unverdächtig	negative
unverdaulich	negative
unverdeckt	positive
unverdient	negative
unverdorben	positive
unverdrossen	negative
unvereinbar	negative
unverfälscht	positive
unverfroren	negative
unvergänglich	positive
unvergessen	positive
unvergesslich	positive
unvergleichbar	negative
unvergleichlich	negative
unverhältnismässig	negative
unverhohlen	positive
unverkennbar	positive
unverkrampft	positive
unverlangt	positive
unverletzlich	negative
unverletzt	positive
unvermeidbar	positive
unvermeidlich	positive
unvermindert	positive
unvermittelt	positive
unveröffentlicht	negative
unverrichtet	negative
unverrückbar	positive
unverschämt	negative
unverschlossen	positive
unverschlüsselt	positive
unverschuldet	positive
unversehrt	positive
unversöhnlich	negative
unverständlich	positive
unversteckt	positive
unverträglich	negative
unvertretbar	negative
unverwechselbar	positive
unverwüstlich	positive
unverzagt	negative
unverzeihlich	negative
unverzichtbar	positive
unverzüglich	negative
unvollkommen	negative
unvollständig	negative
unvoreingenommen	positive
unvorhersehbar	negative
unvorstellbar	negative
unvorteilhaft	negative
unwägbar	negative
unwahr	negative
unwahrscheinlich	negative
unwandelbar	positive
unwegsam	negative
unweigerlich	positive
unweit	positive
unwesentlich	negative
unwichtig	negative
unwiderrufbar	positive
unwiderruflich	positive
unwiderstehlich	positive
unwiederbringlich	positive
unwillig	negative
unwirsch	positive
unwirtlich	negative
unwürdig	negative
unzählbar	positive
unzählig	positive
unzensiert	positive
unzerbrechlich	negative
unzerstörbar	negative
unzerstört	positive
unzerteilt	positive
unzertrennbar	positive
unzertrennlich	positive
unziemlich	negative
unzivilisiert	negative
unzüchtig	negative
unzufrieden	negative
unzugänglich	negative
unzulänglich	negative
unzumutbar	negative
unzurechnungsfähig	negative
unzureichend	negative
unzuständig	negative
unzutreffend	negative
unzuverlässig	negative
unzweckmässig	negative
unzweideutig	positive
unzweifelhaft	positive
üppig	positive
up to date	positive
urbild	positive
urdeutsch	positive
ureigen	positive
ureigenst	positive
urform	positive
urgeschichtlich	positive
urig	positive
urkomisch	positive
urlaubsreif	negative
urteilsfähig	positive
urtümlich	positive
urtyp	positive
urwüchsig	positive
utopisch	negative
vakant	positive
variabel	negative
variantenreich	positive
variationsreich	positive
variierbar	negative
vaterlandslos	negative
väterlich	positive
vehement	positive
veilchenblau	positive
veilchenfarben	positive
verabscheuungswürdig	negative
verächtlich	negative
veränderbar	negative
veränderlich	positive
verantwortbar	positive
verantwortungsbewusst	positive
verantwortungslos	negative
verantwortungsvoll	positive
verarbeitbar	positive
verarmt	negative
verätzen	negative
verbessernd	positive
verbindlich	positive
verbissen	negative
verbittert	negative
verblasst	negative
verblichen	negative
verbockt	negative
verbohrt	negative
verborgen	negative
verboten	negative
verbrauchen	negative
verbraucht	negative
verbrecherisch	negative
verbucht	positive
verbündet	positive
verdächtig	positive
verdammt	positive
verdaulich	positive
verdeckt	negative
verderben	negative
verderblich	negative
verderbt	negative
verdienstvoll	positive
verdient	positive
verdorben	negative
verdreht	negative
verdriesslich	negative
verdrossen	negative
verdruckst	positive
verehrungswürdig	positive
vereinbar	positive
vereinbarungsgemäss	positive
vereinfacht	negative
vereinigt	positive
vereinsamt	negative
vereinseigen	positive
vereinserfolg	positive
vereinszweck	positive
vereint	positive
vereinzelt	negative
vereitert	negative
verfallen	negative
verfänglich	positive
verfassungsfeindlich	negative
verfassungsgemäss	positive
verfassungskonform	positive
verfassungstreu	positive
verfassungswidrig	negative
verfaulen	negative
verfault	negative
verfehlt	negative
verflixt	negative
verflucht	negative
verfolgbar	positive
verformbar	positive
verformt	negative
verführbar	negative
verführerisch	positive
vergammelt	negative
vergänglich	negative
vergesslich	negative
vergiften	negative
vergleichbar	positive
vergleichszweck	positive
vergnügen	positive
vergnüglich	positive
vergnügt	positive
vergnügungsorientiert	positive
vergrämt	negative
vergrätzt	negative
vergriffen	positive
verhaftet	negative
verhaltensgestört	negative
verhältnismässig	negative
verhangen	negative
verhängnisvoll	negative
verhärtet	negative
verheerend	negative
verheilt	positive
verheissungsvoll	positive
veritabel	positive
verkaufserfolg	positive
verkaufsfördernd	positive
verkaufsschwach	negative
verkehrsarm	negative
verkehrsberuhigt	negative
verkehrsgünstig	positive
verkehrsschwach	negative
verkehrssicher	positive
verkehrstauglich	positive
verkehrsuntauglich	negative
verkehrt	negative
verklemmt	negative
verknallt	negative
verkniffen	negative
verkommen	negative
verkonsumieren	negative
verkrampft	negative
verkrüppeln	negative
verkrüppelt	negative
verkündet	positive
verkürzt	negative
verlagseigen	positive
verlassen	negative
verlässlich	positive
verlebt	negative
verlegt	negative
verletzen	negative
verletzt	negative
verleumderisch	negative
verlockend	positive
verlogen	negative
verloren gegangen	negative
verlorengegangen	negative
verloren	negative
verlottert	negative
verlumpt	negative
vermaledeit	negative
vermehrt	positive
vermeidbar	negative
vermeintlich	negative
vermögend	positive
vermutlich	negative
vernachlässigbar	negative
vernebelt	negative
vernichtend	negative
vernichtet	negative
vernunftbegabt	positive
vernunftgemäss	positive
vernutzen	negative
veröffentlicht	positive
verpanscht	negative
verpflichtend	positive
verquer	negative
verräterisch	positive
verraucht	positive
verringernd	negative
verrostet	positive
verrottet	negative
verrucht	negative
verrückt	negative
verschämt	positive
verschiedenartig	negative
verschiedenfarbig	negative
verschieden	negative
verschimmelt	negative
verschlafen	positive
verschlagen	negative
verschleimt	negative
verschliessbar	positive
verschlossen	negative
verschlüsselt	negative
verschmitzt	positive
verschmutzt	negative
verschnupft	negative
verschoben	negative
verschorft	negative
verschossen	negative
verschroben	negative
verschrotten	positive
verschrumpelt	positive
verschwendungssüchtig	negative
verschwiegen	positive
verschwitzt	negative
verschwommen	negative
verschworen	positive
verschwörerisch	negative
verseucht	negative
versicherungsfremd	negative
versöhnlich	positive
versonnen	negative
verspätet	negative
versperrt	negative
verspielt	positive
versponnen	negative
verständlich	negative
verstärkt	positive
versteckt	negative
verstehbar	negative
verstimmt	negative
verstockt	negative
verstohlen	negative
verstopft	positive
verstorben	negative
verstrichen	negative
versuchsmuster	positive
versuchszweck	positive
versunken	positive
verteidigungszweck	positive
verteufelt	negative
vertikal	negative
vertrackt	negative
vertragen	positive
verträglich	positive
vertragsgemäss	positive
vertrauen erweckend	positive
vertrauenerweckend	positive
vertrauensbildend	positive
vertrauensfördernd	positive
vertrauensvoll	positive
vertrauenswürdig	positive
vertraulich	negative
verträumt	negative
vertraut	positive
vertretbar	positive
vertretungsberechtigt	positive
verunreinigt	negative
verunsichert	negative
verwachsen	negative
verwahrlost	negative
verwaist	negative
verwaschen	negative
verwechselbar	negative
verwendungszweck	positive
verwerflich	negative
verwertbar	positive
verwerten	positive
verwickelt	negative
verwirklichbar	positive
verwirrend	negative
verwirrt	negative
verwittert	positive
verwoben	negative
verworfen	negative
verworren	negative
verwunderlich	negative
verwundet	negative
verwünscht	negative
verzagt	positive
verzeihbar	positive
verzeihend	positive
verzeihlich	positive
verzerrungsfrei	positive
verzichtbar	negative
verzögerungslos	negative
verzückung	positive
verzwackt	negative
verzwickt	negative
veterinäramtlich	positive
vieldeutig	negative
viele	positive
vielerlei	positive
vielfach	positive
vielfarbig	negative
viel gefragt	positive
vielgefragt	positive
viel genannt	positive
vielgenannt	positive
vielgestaltig	negative
viel	positive
vielsagend	positive
vielschichtig	negative
vielspurig	positive
vielversprechend	positive
viel zitiert	positive
vielzitiert	positive
vierfach	positive
vierfarbig	positive
viermalig	positive
vierschrötig	negative
vierspurig	positive
vierteljährlich	positive
viertgrösste	positive
viertklassig	negative
violent	positive
violett	positive
virtuos	positive
viskos	positive
visumfrei	positive
vital	positive
vitaminarm	negative
vitaminreich	positive
vizemeisterin	positive
vizemeister	positive
völkerrechtswidrig	negative
volkseigen	positive
volksfeindlich	negative
volksmärchen	positive
vollberechtigt	positive
vollbesetzt	positive
vollbusig	positive
völlig	positive
vollkommen	positive
vollmundig	negative
voll	positive
vollschlank	positive
vollspurig	positive
vollständig	positive
vollstreckbar	positive
vollsynthetisch	negative
vollumfänglich	positive
vollwertig	positive
vollzählig	positive
voluminös	positive
voraussagbar	positive
voraussehbar	positive
voraussichtlich	positive
vorbehaltlich	negative
vorbestimmt	positive
vorbestraft	negative
vorbildhaft	positive
vorbildlich	positive
vorbild	positive
vordergründig	negative
vordringlich	positive
voreilig	negative
voreingenommen	negative
vorfrühlingshaft	negative
vorgeblich	negative
vorgenannt	positive
vorgeschoben	negative
vorgetäuscht	negative
vorgezogen	positive
vorhanden	positive
vorherbestimmt	positive
vorherrschend	positive
vorhersagbar	positive
vorhersehbar	positive
vorlage	positive
vorlaut	negative
vorliegend	positive
vornehmlich	positive
vornehm	positive
vorrangig	positive
vorrätig	positive
vorreiterrolle	positive
vorschnell	negative
vorschrift	positive
vorschriftsgemäss	positive
vorschriftsmässig	positive
vorstellbar	positive
vorteilhaft	positive
vortrefflich	positive
vorurteilsfrei	positive
vorurteilslos	positive
vorweggenommen	positive
vorwiegend	positive
vorwitzig	positive
vorwurfsvoll	negative
vorzeigbar	positive
vorzüglich	positive
vulgär	negative
waagerecht	negative
waagrecht	negative
wach	negative
wachsam	positive
wachstumsfördernd	positive
wackelig	positive
wacklig	positive
wadenhoch	positive
wadenlang	positive
waffenfähig	positive
wägbar	positive
wählbar	positive
wahlberechtigt	positive
wahlweise	negative
wahnhaft	negative
wahnsinnig	negative
wahnwitzig	negative
wahrhaftig	positive
wahrhaft	positive
wahrheit	positive
wahrheitsgemäss	positive
wahrheitsgetreu	positive
wahr	positive
wahrscheinlich	positive
wandelbar	positive
wandlungsfähig	positive
wankelmütig	negative
wärmebedürftig	negative
warmherzig	positive
warm	positive
wartungsarm	negative
wartungsfreundlich	positive
wartungsintensiv	negative
waschecht	positive
wasserarm	negative
wasserdicht	negative
wasserdurchlässig	positive
wasserfest	negative
wassergefährdend	negative
wassergekühlt	negative
wasserklar	positive
wasserlöslich	positive
wasserreich	positive
wasserundurchlässig	negative
wasserunlöslich	negative
wattiert	positive
wechselhaft	negative
wechselnd	negative
wechselvoll	negative
wechselwarm	negative
wegweisend	positive
wehmütig	negative
wehrdienstfähig	positive
wehrfähig	positive
wehrhaft	positive
wehrtauglich	positive
wehruntauglich	negative
weich	positive
weinerlich	negative
weinrot	positive
weisend	positive
weissgelb	positive
weissgetüncht	positive
weissgrau	positive
weisslich	positive
weiss	positive
weisungsbefugt	positive
weisungsberechtigt	positive
weitestgehend	positive
weitführend	positive
weitgefächert	positive
weitgehend	positive
weitgespannt	positive
weitgreifend	positive
weitläufig	positive
weit	positive
weiträumig	positive
weitreichend	positive
weitschweifig	negative
weittragend	positive
weitverbreitet	positive
welk	positive
wellig	positive
weltberühmt	positive
weltbewegend	positive
welterfolg	positive
weltgeschichtlich	positive
weltgewandt	positive
weltgross	positive
welthistorisch	positive
weltmeisterin	positive
weltmeister	positive
weltoffen	positive
weltumfassend	positive
weltumspannend	positive
weltweit	positive
wenig	negative
wenigste	negative
werbezweck	positive
werkeigen	positive
werkgetreu	positive
werkimmanent	positive
werkmeisterin	positive
werkmeister	positive
werkseigen	positive
werktäglich	positive
wertbeständig	positive
werterhaltend	positive
wertgestellt	positive
wertig	positive
wertkonservativ	negative
wertlos	negative
wertstabil	negative
wertvoll	negative
wesenhaft	positive
wesensgemäss	positive
wesensgleich	positive
wesentlich	positive
westhimmel	positive
westpreussisch	positive
wettbewerb	positive
wettbewerbsfähig	positive
wetterfest	negative
wichtig	positive
wichtigst	positive
wichtigtuerisch	negative
widerlich	negative
widerrechtlich	negative
widerruflich	negative
widersinnig	negative
widerspenstig	negative
widersprüchlich	negative
widerständig	negative
widerstandsfähig	positive
widerstrebend	negative
widerwärtig	negative
widerwillig	negative
widrig	negative
wiederauferstehung	positive
wiederaufladbar	positive
wiedererkennbar	positive
wiedergeboren	positive
wiederholbar	positive
wiederholt	positive
wiederkehrend	positive
wiederverwenden	positive
wiederverwertbar	positive
wieselflink	negative
wildfremd	negative
wild	positive
willensschwach	negative
willfährig	positive
willig	positive
windgeschützt	positive
windschief	positive
winkelig	positive
winkeltreu	positive
winklig	positive
winterfest	negative
winterhart	positive
winterhimmel	positive
winterlich	negative
winzigklein	negative
winzig	negative
wirklichkeitsgetreu	positive
wirklichkeitsnah	positive
wirkmächtig	positive
wirkungsgeschichtlich	positive
wirkungsmächtig	positive
wirkungsreich	positive
wirtschaftsgeschichtlich	positive
wirtschaftshistorisch	positive
wirtschaftsliberal	positive
wirtschaftsschwach	negative
wirtschaftsverträglich	positive
wissenschaftsfeindlich	negative
wissenschaftsgeschichtlich	positive
wissenschaftsmethodisch	positive
wissenswert	positive
witterungsbeständig	negative
witzig	positive
wochenlang	positive
wöchentlich	positive
wohlbegründet	positive
wohlbehütet	positive
wohlbekannt	positive
wohl beleibt	positive
wohlbeleibt	positive
wohlerzogen	positive
wohlfeil	positive
wohl geformt	positive
wohlgeformt	positive
wohl genährt	positive
wohlgenährt	positive
wohlgesinnt	positive
wohlgesonnen	positive
wohlhabend	positive
wohlig	positive
wohlmeinend	positive
wohlproportioniert	positive
wohlschmeckend	negative
wohltätig	positive
wohl temperiert	positive
wohltemperiert	positive
wohltuend	positive
wohl tun	positive
wohltun	positive
wohlverdient	positive
wohlwollend	positive
wohnberechtigt	positive
wohnlich	positive
wohnzweck	positive
wolkenbruchartig	negative
wolkenfrei	positive
wolkenhimmel	positive
wolkenlos	positive
wolkig	negative
wonne	positive
workoholic	negative
wortarm	negative
wortgemäss	positive
wortgetreu	positive
wortkarg	negative
wortlautgemäss	positive
wörtlich	positive
wuchtig	negative
wunderbar	positive
wunderlich	negative
wunder	positive
wundersam	negative
wunderschön	positive
wundervoll	positive
wund	negative
wunschbild	positive
wünschenswert	positive
wunschgemäss	positive
wunschtraum	positive
würdelos	negative
würdevoll	positive
würdig	positive
wüst	negative
wütend	positive
xenophob	negative
x-fach	positive
zaghaft	negative
zähflüssig	positive
zahlbar	positive
zahlenbeispiel	positive
zahllos	positive
zahlreich	positive
zahlungsfähig	positive
zahlungskräftig	positive
zahlungsunfähig	negative
zähneknirschend	negative
zäh	positive
zänkisch	negative
zank	negative
zanksüchtig	negative
zappelig	positive
zappenduster	negative
zartbitter	negative
zartblau	positive
zartgelb	positive
zartgrün	positive
zärtlich	positive
zart	negative
zauberhaft	positive
zaubermärchen	positive
zauderhaft	positive
zehnfach	positive
zehnmalig	positive
zehnprozentig	negative
zehntgrösste	positive
zeichnerisch	positive
zeitabhängig	negative
zeitaufwändig	negative
zeitaufwendig	negative
zeitgemäss	positive
zeitgerecht	positive
zeitgeschichtlich	positive
zeithistorisch	positive
zeitintensiv	negative
zeitlos	positive
zeitraubend	negative
zeittypisch	positive
zeitunabhängig	positive
zeitweilig	positive
zeitweise	positive
zelleigen	positive
zentralnervös	positive
zentral	positive
zerbeult	negative
zerbrechlich	positive
zeremoniell	positive
zerfasert	negative
zerissen	negative
zerkleinert	negative
zerlegbar	positive
zerlöchert	negative
zerlumpt	negative
zerrüttet	negative
zersäbelt	negative
zerschnitten	negative
zerstörbar	negative
zerstören	negative
zerstörerisch	negative
zerstört	negative
zerstreut	negative
zerteilt	negative
zickig	negative
ziegelrot	positive
zielweisend	positive
ziemlich	positive
zierlich	positive
zigfach	positive
zig	positive
zimmermeisterin	positive
zimmermeister	positive
zimmerwarm	positive
zimtfarben	positive
zimtfarbig	positive
zinnoberrot	positive
zirkular	positive
zirkulär	positive
zitierbar	negative
zitronengelb	positive
zittrig	negative
zivilisiert	positive
zivil	positive
zögerlich	positive
zölibatär	positive
zollamtlich	positive
zornig	positive
zotig	negative
zuchterfolg	positive
züchtig	positive
zuckerkrank	negative
zuckersüss	positive
zufrieden	positive
zufriedenstellend	positive
zufügen	negative
zugänglich	positive
zugedeckt	negative
zugeknöpft	negative
zügellos	negative
zügig	negative
zugreifbar	positive
zukunftsfähig	positive
zukunftsträchtig	positive
zukunftsweisend	positive
zukunftweisend	positive
zumutbar	positive
zunehmend	negative
zünftig	positive
zunftmeisterin	positive
zunftmeister	positive
zuordenbar	positive
zurechenbar	positive
zurechnungsfähig	positive
zureichend	positive
zurückführbar	positive
zurückgeblieben	negative
zurückgehend	negative
zurückgezogen	negative
zurückhaltend	negative
zurückweisend	negative
zusammengeschlossen	positive
zusammen	positive
zuständig	positive
zustehend	positive
zuträglich	positive
zutraulich	positive
zutreffend	positive
zuverlässig	positive
zuvorkommend	positive
zwanghaft	negative
zwanglos	positive
zwangsgestört	negative
zwangsläufig	positive
zwanzigfach	positive
zwanzigprozentig	negative
zweckentsprechend	positive
zweckfrei	negative
zweckgemäss	positive
zwecklos	negative
zweckmässig	positive
zweck	positive
zweibahnig	positive
zweideutig	negative
zweierlei	negative
zweifach	positive
zweifarbig	positive
zweifelhaft	negative
zweifellos	positive
zweifelnd	negative
zweifelsfrei	positive
zweiflerisch	negative
zweimalig	positive
zweischichtig	positive
zweispurig	positive
zweitbeste	positive
zweitgrösste	positive
zweithöchste	positive
zweitklassig	negative
zweitrangig	negative
zweitwichtigste	positive
zwergenhaft	negative
zwergwüchsig	negative
zwielichtig	negative
zwiespältig	negative
zwingend	positive
zwölffach	positive
zyklisch	positive
zyklopisch	positive
zynisch	negative
zytotoxisch	negative
