arm	negative
ausgezeichnet	positive
ekelhaft	negative
falsch	negative
gemein	negative
glücklich	positive
gut	positive
hässlich	negative
hochwertig	positive
korrekt	positive
lästig	negative
minderwertig	negative
negativ	negative
nett	positive
positiv	positive
richtig	positive
schlecht	negative
schön	positive
überlegen	positive
unglücklich	negative
