#1073	neutral
@deinskysport	neutral
@lik0n	neutral
@mirkokaminski	neutral
angenehm	positive
arm	negative
armselig	negative
ausgezeichnet	positive
bedauernswert	negative
besser	positive
biospritt	neutral
boxsport‚Äã	neutral
b√∂se	negative
d√ºrftig	negative
ekelerregend	negative
ekelhaft	negative
ekelig	negative
falsch	negative
familienausfl√ºgler	neutral
fies	negative
freundlich	positive
gemein	negative
geringwertig	negative
gl√ºcklich	positive
gut	positive
h√§sslich	negative
h√∂herwertig	positive
h√ºbsch	positive
irrig	negative
jweilandnet	neutral
korrekt	positive
lieb	positive
mangelhaft	negative
meistgew√ºnscht	neutral
mentionsomebodyyouwanttomeet	neutral
minderwertig	negative
misslich	negative
nachahmerprodukt	neutral
nachrangig	negative
negativ	negative
nett	positive
positiv	positive
reaktionskonferenz	neutral
richtig	positive
scheu√ülich	negative
schlecht	negative
schlimm	negative
schwach	negative
sch√§dlich	negative
sch√∂n	positive
stanzmesser	neutral
unangenehm	negative
unerfreulich	negative
ungl√ºcklich	negative
ung√ºnstig	negative
unrecht	negative
unterlegen	negative
verdorben	negative
widerlich	negative
widerw√§rtig	negative
√ºbel	negative
√ºberlegen	positive
√ºberragend	positive
üè∞	neutral
