böse	negative
cool	positive
dumm	negative
elektrisch	neutral
fantastisch	positive
grimmig	negative
grossartig	positive
großartig	positive
hervorragend	positive
hübsch	positive
kompliziert	negative
langsam	negative
langweilig	negative
lieb	positive
liebevoll	positive
materiell	neutral
mechanisch	neutral
nachtragend	negative
nett	positive
objektiv	neutral
phantastisch	positive
prima	positive
sachlich	neutral
schlecht	negative
schlimm	negative
schnell	positive
schrecklich	negative
schwach	negative
schwierig	negative
schön	positive
stark	positive
sympathisch	positive
wütend	negative
zornig	negative
ärgerlich	negative
