allerbeste	positive
angenehm	positive
anständig	positive
attraktiv	positive
aufrichtig	positive
ausgezeichnet	positive
begehrt	positive
begeistert	positive
beliebt	positive
bequem	positive
berühmt	positive
bezaubernd	positive
brillant	positive
diskret	positive
edel	positive
effektiv	positive
ehrlich	positive
einwandfrei	positive
elegant	positive
erstaunlich	positive
fabelhaft	positive
faszinierend	positive
freundlich	positive
froh	positive
glücklich	positive
grossartig	positive
gut	positive
hervorragend	positive
höflich	positive
lieb	positive
nett	positive
qualitätvoll	positive
schön	positive

Begeisterung	positive
Erholung	positive
Fest	positive
Freude	positive
Fröhlichkeit	positive
Güte	positive
Hoffnung	positive
Jubel	positive
Lachen	positive
Liebe	positive
Lächeln	positive
Schatz	positive
Tugend	positive

anbeten	positive
erfreuen	positive
freuen	positive
frohlocken	positive
jubeln	positive
lachen	positive
lieben	positive
lächeln	positive
motivieren	positive
schätzen	positive
vergöttern	positive
wünschen	positive

aggressiv	negative
arrogant	negative
beschädigt	negative
defekt	negative
dumm	negative
empört	negative
falsch	negative
feindlich	negative
gefährlich	negative
gemein	negative
hinterhältig	negative
hinterlistig	negative
hässlich	negative
irreführend	negative
kaputt	negative
kompliziert	negative
listig	negative
mangelhaft	negative
nachtragend	negative
problematisch	negative
schrecklich	negative
unbeliebt	negative
unbeliebt	negative
unehrlich	negative
unmoralisch	negative
unverständlich	negative
verbrecherisch	negative
verdammt	negative
verdorben	negative
verlogen	negative
verrucht	negative
verärgert	negative
wütend	negative

Affäre	negative
Betrug	negative
Gewalt	negative
Hass	negative
Hölle	negative
Krieg	negative
Missbrauch	negative
Mord	negative
Scheisse	negative
Scheiße	negative
Verbrechen	negative
Vergehen	negative
Verrat	negative
Übel	negative

betrügen	negative
empören	negative
hassen	negative
klagen	negative
misslingen	negative
schimpfen	negative
töten	negative
verderben	negative
verderben	negative
vergewaltigen	negative
vernichten	negative
zerstören

akustisch	neutral
alternativ	neutral
analog	neutral
angewandt	neutral
digital	neutral
draussen	neutral
draußen	neutral
elektrisch	neutral
entsprechend	neutral
farbig	neutral
finanziell	neutral
geistig	neutral
geschweisst	neutral
geschweißt	neutral
gewohnt	neutral
gewöhnlich	neutral
gläsern	neutral
grün	neutral
hölzern	neutral
international	neutral
körperlich	neutral
linke	neutral
lokal	neutral
mechanisch	neutral
neutral	neutral
praktisch	neutral
rechte	neutral
sachlich	neutral
separat	neutral
sichtbar	neutral
technisch	neutral
theoretisch	neutral
visuell	neutral
wirtschaftlich	neutral
wissenschaftlich	neutral

Auto	neutral
Baum	neutral
Behörde	neutral
Finanzen	neutral
Luft	neutral
Material	neutral
Natur	neutral
Regierung	neutral
Stoff	neutral
Technik	neutral
Unternehmen	neutral
Verständnis	neutral
Wohnung	neutral

atmen	neutral
benutzen	neutral
berechnen	neutral
erfreuen	neutral
fahren	neutral
fliegen	neutral
gehen	neutral
lesen	neutral
sehen	neutral
verstehen	neutral
wohnen	neutral
zahlen	neutral
