armselig	negative
ausgezeichnet	positive
böse	negative
chemisch	neutral
erstklassig	positive
exzellent	positive
falsch	negative
finanziell	neutral
gluwcklich	positive
grossartig	positive
großartig	positive
gut	positive
körperlich	neutral
lieb	positive
materiell	neutral
mies	negative
minderwertig	negative
negativ	negative
neutral	neutral
phantastisch	positive
physisch	neutral
positiv	positive
praktisch	neutral
richtig	positive
sachlich	neutral
scheisse	negative
scheiße	negative
schlecht	negative
schön	positive
technisch	neutral
theoretisch	neutral
unglücklich	negative
unschön	negative
zweitklassig	negative
