richtig	positive
gut	positive
überragend	positive
überlegen	positive
glücklich	positive
schön	positive
freundlich	positive
nett	positive
ausgezeichnet	positive
besser	positive
korrekt	positive
lieb	positive
höherwertig	positive
hübsch	positive
positiv	positive
angenehm	positive
ekelhaft	negative
verdorben	negative
dürftig	negative
böse	negative
falsch	negative
bedauernswert	negative
mangelhaft	negative
gemein	negative
übel	negative
schwach	negative
arm	negative
ekelerregend	negative
ekelig	negative
schädlich	negative
unterlegen	negative
unangenehm	negative
unerfreulich	negative
misslich	negative
minderwertig	negative
armselig	negative
irrig	negative
widerwärtig	negative
widerlich	negative
hässlich	negative
schlecht	negative
nachrangig	negative
unrecht	negative
negativ	negative
geringwertig	negative
ungünstig	negative
schlimm	negative
unglücklich	negative
scheusslich	negative
fies	negative
genant	negative
genierlich	negative
peinlich	negative
lächerlich	negative
glänzend	positive
glanzvoll	positive
froh	positive
vermaledeit	negative
verwünscht	negative
verflucht	negative
verflixt	negative
zutreffend	positive
trefflich	positive
treffend	positive
zuversichtlich	positive
grellfarbig	negative
grellfarben	negative
schreiend	negative
grell	negative
gefühlvoll	positive
unbändig	positive
verwendungsfähig	positive
anwendbar	positive
verwendbar	positive
geringschätzen	negative
missachten	negative
kugelfisch	positive
gram	negative
harm	negative
gehen	positive
gefühl empfindend	negative
pessimistisch	negative
stehen	positive
kleiden	positive
beziehungslos	negative
glückspilz	positive
glückskind	positive
wohlergehen	positive
bitter	negative
hartherzig	negative
kalt	negative
hart	negative
kaltherzig	negative
pikant	positive
eingehend	positive
sorgfältig	positive
intoxikation	negative
vergiftung	negative
aufschneider	positive
grossmaul	positive
sinnlos	negative
erfreuen	positive
gesittet	positive
sittsam	positive
traut	positive
vertraut	positive
gängig	positive
geläufig	positive
graziös	positive
anmutig	positive
grazil	positive
abstellbar	positive
einsetzbar	positive
grässlich	negative
brav	positive
artig	positive
akkurat	positive
exakt	positive
dankbar	positive
funktionieren	positive
erneuerbar	positive
hilfreich	positive
hilfsbereit	positive
gefällig	positive
trauma	negative
tätlichkeit	negative
galant	positive
attraktivität	positive
zugluft	negative
lobenswert	positive
rühmlich	positive
löblich	positive
umweltaktivist	positive
umweltschützerin	positive
naturschützerin	positive
naturschützer	positive
umweltaktivistin	positive
umweltschützer	positive
heldin	positive
held	positive
rachsüchtig	negative
gewaltlos	negative
verärgert	negative
ärgerlich	negative
bosheit	negative
boshaftigkeit	negative
gehässigkeit	negative
bösartigkeit	negative
böswilligkeit	negative
musikbegabt	positive
musikalisch	positive
emotionslos	negative
gefühllos	negative
lohnen	positive
gedeihen	positive
armfrei	negative
spurlos	negative
behaglichkeit	positive
gemütlichkeit	positive
lebensgefährte	positive
lebensgefährtin	positive
knapp	negative
verderben	negative
verhängnisvoll	negative
desaströs	negative
fatal	negative
versprechen	positive
ergehen	positive
propagandist	positive
werberin	positive
werber	positive
korrektheit	positive
richtigkeit	positive
beliebt	positive
gelitten	positive
verfolgen	positive
zuneigung	positive
humorvoll	positive
humorig	positive
jungfrau	positive
jungmann	positive
düster	negative
schwarz	negative
fangertrag	positive
fang	positive
verrenken	negative
verstellbar	positive
umstellbar	positive
deprimierend	negative
schwermütig	negative
melancholisch	negative
robust	positive
vital	positive
akribisch	positive
wohlschmeckend	positive
lecker	positive
schmackhaft	positive
köstlich	positive
delikat	positive
glück	positive
glücksfall	positive
dusel	positive
gesetzmässig	positive
gesetzlich	positive
legal	positive
bezaubernd	positive
zauberhaft	positive
mitleidig	negative
seelenvoll	positive
beseelt	positive
indigniert	negative
entrüstet	negative
empört	negative
lustig	positive
kargheit	negative
dürftigkeit	negative
armseligkeit	negative
menschenfreundin	positive
menschenfreund	positive
philanthrop	positive
ungeheuerlich	positive
ungeheuer	positive
unheimlich	positive
effektiv	positive
unabkömmlich	positive
unentbehrlich	positive
hehlerin	positive
hehler	positive
grossmütig	positive
zutreffen	negative
stimmen	negative
treffen	negative
hinkommen	negative
verwirrt	negative
distanz	positive
bon	positive
sachkundig	positive
nützlichkeit	positive
nutzen	positive
passend	positive
namenlos	negative
gespannt	negative
vertragen	positive
verstehen	positive
brummer	negative
melancholie	negative
human	positive
menschlich	positive
fortschritt	positive
talentiert	positive
begabt	positive
anbeter	positive
bewundrer	positive
bewunderin	positive
anbeterin	positive
bewunderer	positive
verehrer	positive
verehrerin	positive
bewundrerin	positive
allgemeinheit	positive
niveaulos	negative
geistlos	negative
gefahr	negative
hitze	negative
afterrede	positive
nachrede	positive
vernachlässigung	positive
zudrehen	positive
heiter	positive
stark	negative
grauen	negative
grusel	negative
nagelneu	positive
brandneu	positive
energisch	positive
ausrenken	negative
durchfluten	positive
durchströmen	positive
heikel	negative
brechen	negative
reizend	positive
gefallen	positive
mögen	positive
eifersüchteln	negative
gelten	negative
durchspülen	positive
neidisch	negative
missgünstig	negative
geraten	positive
geniessen	positive
beikommen	negative
machtvoll	positive
mächtig	positive
brutalität	negative
single	positive
fettwanst	positive
fette	positive
brummer	positive
fettmops	positive
fetter	positive
dickwanst	positive
fettsack	positive
taugenichts	positive
tagedieb	positive
nichtsnutz	positive
nichtstuer	positive
juchzen	positive
jubel	positive
jauchzen	positive
jubeln	positive
intensität	negative
niedergeschlagen	negative
down	negative
gedrückt	negative
niedergedrückt	negative
gutmachen	positive
gebildet	positive
gut tun	positive
wohltun	positive
guttun	positive
wohl tun	positive
tortur	negative
qual	negative
schwer	positive
reinfall	negative
debakel	negative
desaster	negative
armageddon	negative
trauerspiel	negative
flop	negative
fiasko	negative
freudlos	positive
traurig	positive
ungefähr	negative
informell	negative
wortwörtlich	positive
gefühlskalt	negative
gefühlsarm	negative
annehmen	positive
gültig	positive
valid	positive
potent	positive
formlosigkeit	positive
rechtsgefühl	positive
rechtsempfinden	positive
erzengel	positive
kranke	negative
kranker	negative
unwetter	negative
gegenwert	negative
ruhigstellen	negative
befugt	positive
zuständig	positive
federführend	positive
energiebündel	positive
anhören	positive
willkommen	positive
erwünscht	positive
zweck	negative
beherrschen	positive
anständig	positive
triumph	positive
minutiös	positive
minuziös	positive
liebelei	positive
liebesgeschichte	positive
liebesabenteuer	positive
romanze	positive
liebschaft	positive
herzlich	positive
innig	positive
zurückfinden	positive
feldverweis	positive
score	positive
skore	positive
herausstellung	positive
punktestand	positive
hinausstellung	positive
platzverweis	positive
standardmässig	positive
serienmässig	positive
minimal	negative
gemeinnützig	positive
ohrenbetäubend	positive
haardünn	positive
hauchdünn	positive
wegdrehen	negative
treffen	positive
reich	positive
gehaltvoll	positive
reichhaltig	positive
heisshungrig	negative
kerngesund	negative
gertenschlank	negative
mega-in	negative
todmüde	negative
putzmunter	negative
hellwach	negative
hundemüde	negative
umgang	positive
beklommenheit	positive
belebt	positive
ausfallen	positive
hoffnungslos	negative
asexuell	negative
romantisch	positive
anhören	negative
erwartungsvoll	positive
hoffnungsvoll	positive
hoffnungsfroh	positive
abergläubisch	positive
fachkundig	positive
vergeblich	negative
vergebens	negative
sexuell	positive
erwartbar	positive
erwartungsgemäss	positive
erwartungsgetreu	positive
mittel	negative
mässig	negative
mittelmässig	negative
durchschnittlich	negative
fruchtbar	positive
antriebslos	negative
lustlos	negative
