unterlegen	negative
richtig	positive
böse	negative
bös	negative
nett	positive
korrekt	positive
negativ	negative
übel	negative
schlecht	negative
schön	positive
hübsch	positive
gut	positive
positiv	positive
mangelhaft	negative
ungünstig	negative
freundlich	positive
angenehm	positive
falsch	negative
schädlich	negative
arm	negative
verdorben	negative
bedauernswert	negative
unerfreulich	negative
misslich	negative
unglücklich	negative
ausgezeichnet	positive
schwach	negative
unangenehm	negative
fies	negative
geringwertig	negative
minderwertig	negative
gemein	negative
hässlich	negative
überragend	positive
irrig	negative
unrecht	negative
überlegen	positive
nachrangig	negative
scheusslich	negative
widerlich	negative
widerwärtig	negative
ekel erregend	negative
ekelerregend	negative
ekelhaft	negative
glücklich	positive
armselig	negative
dürftig	negative
lieb	positive
besser	positive
schlimm	negative
sinnreich	positive
leistungsschwach	negative
recht	positive
fragwürdig	negative
verschlagen	negative
link	negative
befremdlich	negative
beängstigend	negative
charakterschwach	negative
wirtschaftsschwach	negative
rauchschwach	negative
willensschwach	negative
verkehrsschwach	negative
mitgliederschwach	negative
zittrig	negative
deformiert	negative
verformt	negative
richtiggehend	positive
regelrecht	positive
sauer	negative
gekränkt	negative
spitzenmässig	positive
leid	negative
durchbrochen	negative
ärmel	negative
unfreundlich	negative
sonnig	positive
aktfoto	positive
ätzend	negative
mistig	negative
beknackt	negative
oll	negative
zutreffend	positive
widrig	negative
wahr	positive
notbehelfsmässig	negative
erfreulich	positive
glückreich	positive
sittlich	positive
moralisch	positive
ethisch	positive
polaroidfoto	positive
satellitenbild	positive
polaroid	positive
schnappschuss	positive
farbfoto	positive
polaroidbild	positive
sofortbild	positive
schwindlig	negative
gütig	positive
liebesfähig	positive
liebenswert	positive
importgut	positive
gefährlich	negative
lästig	negative
volksgut	positive
erstklassig	positive
spitze	positive
klasse	positive
endgeil	positive
wunderschön	positive
wohl geformt	positive
wohlgeformt	positive
fleischarm	negative
abgelaufen	negative
verfallen	negative
verrottet	negative
schimmelig	negative
verschimmelt	negative
herzensgut	positive
herausragend	positive
fein	positive
hervorragend	positive
kulturgut	positive
liedgut	positive
erwägen	positive
industriegut	positive
reich	positive
kontrafaktisch	negative
sehschwach	negative
kargo	positive
stückgut	positive
ladegut	positive
transportgut	positive
sammlungsgut	positive
massengut	positive
unangemessen	negative
inadäquat	negative
verfehlt	negative
unselbstständig	negative
unselbständig	negative
gruppenfoto	positive
einzelfoto	positive
porträtbild	positive
garstig	negative
vorschriftsgemäss	positive
unedel	negative
grundstufe	positive
rüstungsgut	positive
fair	positive
screenshot	positive
halb	negative
unvollständig	negative
lückenhaft	negative
notdürftig	negative
defizitär	negative
unvollkommen	negative
grundfalsch	negative
inakzeptabel	negative
unakzeptabel	negative
nährstoffarm	negative
wasserarm	negative
fettarm	negative
bauerngut	positive
unbill	negative
beleidigt	negative
halbherzig	negative
lügnerisch	negative
verlogen	negative
unaufrichtig	negative
erdrückend	negative
bedrückend	negative
belastend	negative
mulmig	negative
abstossend	negative
unsympathisch	negative
unbehaglich	negative
ungemütlich	negative
beklemmend	negative
stilsicher	positive
unübertrefflich	positive
unästhetisch	negative
phantastisch	positive
fantastisch	positive
unförmig	negative
geschmackvoll	positive
pickelig	negative
entstellt	negative
pikiert	negative
erbost	negative
fehlbar	negative
faul	negative
faulig	negative
verfault	negative
grossherzig	positive
gutherzig	positive
gutmütig	positive
friedlich	positive
friedliebend	positive
edelmütig	positive
bescheiden	negative
anrüchig	negative
traumatisierend	negative
traumatisch	negative
vernichtend	negative
katastrophal	negative
verheerend	negative
scheiss	negative
beschissen	negative
jovial	positive
kollegial	positive
grottenschlecht	negative
menschenfreundlich	positive
sorgsam	positive
sorgfältig	positive
ordnungsliebend	positive
bedauerlich	negative
schade	negative
unerquicklich	negative
unkomfortabel	negative
ergebnisreich	positive
zweckmässig	positive
sinnvoll	positive
sinnig	positive
imageträchtig	positive
ehrenvoll	positive
prestigeträchtig	positive
optimal	positive
regelgerecht	positive
wartungsfreundlich	positive
intrigant	negative
leutselig	positive
elendig	negative
erfolg versprechend	positive
erfolgversprechend	positive
legendär	positive
mythisch	positive
wundervoll	positive
herrlich	positive
prima	positive
wunderbar	positive
himmlisch	positive
paradiesisch	positive
ungerecht	negative
grauslich	negative
wurfarm	negative
dia	positive
negativaufnahme	positive
negativbild	positive
röntgenbild	positive
diapositiv	positive
lichtbild	positive
diabild	positive
eingeschnappt	negative
verletzt	negative
perfekt	positive
mustergültig	positive
vorbildlich	positive
beispielhaft	positive
exzellent	positive
mustergut	positive
unglückselig	negative
bemitleidenswert	negative
beklagenswert	negative
sagenhaft	positive
schmalspurig	negative
gesundheitsschädlich	negative
gesundheitsschädigend	negative
papierabzug	positive
eifrig	positive
arbeitsam	positive
emsig	positive
fleissig	positive
tüchtig	positive
gruppenbild	positive
gruppenaufnahme	positive
ergänzungsbedürftig	negative
wünschenswert	positive
gelungen	positive
geraten	positive
pejorativ	negative
ruinös	negative
anoxisch	negative
bedenkenswert	positive
unschön	negative
laienhaft	negative
ungeeignet	negative
ungut	negative
unprofessionell	negative
nutzlos	negative
meierhof	positive
meierei	positive
ablichtung	positive
unverträglich	negative
kontraproduktiv	negative
schädigend	negative
abträglich	negative
bedürftig	negative
ärmlich	negative
zahlungsunfähig	negative
bankrott	negative
erledigt	negative
ruiniert	negative
labil	negative
verloren	negative
instabil	negative
hilflos	negative
zielfoto	positive
tonarm	negative
viertklassig	negative
gutshof	positive
weingut	positive
hofgut	positive
kärglich	negative
unbequem	negative
unbefriedigend	negative
komfortabel	positive
wohltuend	positive
zufriedenstellend	positive
wohlig	positive
befriedigend	positive
nervenschwach	negative
muskelschwach	negative
mies	negative
schadenfroh	negative
zweitklassig	negative
schurkisch	negative
verderbt	negative
schnöde	negative
kümmerlich	negative
elend	negative
erbärmlich	negative
jämmerlich	negative
charakterlos	negative
verkehrsarm	negative
fünf	negative
zwei	positive
rufschädigend	negative
unschädlich	positive
zuträglich	positive
investitionsfreundlich	positive
verwerflich	negative
barmherzig	positive
angriffslustig	negative
aggressiv	negative
kampflustig	negative
kampfeslustig	negative
gelind	negative
ruchbar	negative
eklig	negative
tückisch	negative
unerträglich	negative
arg	negative
satanisch	negative
dämonisch	negative
diabolisch	negative
teuflisch	negative
hasserfüllt	negative
stiefmütterlich	negative
böswillig	negative
ranzig	negative
unterfüttern	negative
toxisch	negative
reichsgut	positive
archivgut	positive
strafwürdig	negative
abgeschlagen	negative
traurig	negative
geeignet	positive
gehoben	positive
unansehnlich	negative
fürsorglich	positive
geburtenschwach	negative
gutartig	positive
lausig	negative
unfehlbar	positive
toll	positive
wohlgesonnen	positive
wohlgesinnt	positive
gesinnt	positive
kameradschaftlich	positive
liebenswürdig	positive
unkorrekt	negative
schuldig	negative
umweltschädigend	negative
umweltschädlich	negative
geschäftsschädigend	negative
parteischädigend	negative
tugendhaft	positive
gerecht	positive
tugendlich	positive
verträglich	positive
übermächtig	positive
rohstoffarm	negative
bettelarm	negative
bitterarm	negative
kalorienarm	negative
verarmt	negative
pleite	negative
hautfreundlich	positive
erbgut	positive
erbhof	positive
fronhof	positive
herrenhof	positive
klostergut	positive
digitalfoto	positive
luderhaft	negative
unanständig	negative
verworfen	negative
unauffallend	negative
unauffällig	negative
geruhsam	positive
behaglich	positive
gemütlich	positive
schlechtigkeit	negative
frohgestimmt	positive
froh gestimmt	positive
zufrieden	positive
ungetrübt	positive
nichtsnutzig	negative
gelinde	negative
schmeichelhaft	positive
detailaufnahme	positive
seelig	positive
wägen	positive
bitterböse	negative
paradigmatisch	positive
magenfreundlich	positive
bedienungsfreundlich	positive
kundenfreundlich	positive
leserfreundlich	positive
attraktiv	positive
nutzbringend	positive
nützlich	positive
maliziös	negative
hämisch	negative
süffisant	negative
hündisch	negative
chancenreich	positive
erfolgreich	positive
kalkulieren	positive
bildschön	positive
ertragbar	positive
deliberieren	positive
stilgerecht	positive
sinnhaft	positive
grandios	positive
berauschend	positive
meisterhaft	positive
meisterlich	positive
elefantös	positive
satellitenfoto	positive
schmuck	positive
stilvoll	positive
dekorativ	positive
potthässlich	negative
liebreich	positive
tugendreich	positive
prächtig	positive
märchenhaft	positive
prachtvoll	positive
umgekehrt	negative
regulär	positive
vorschriftsmässig	positive
ordnungsgemäss	positive
ungemach	negative
grundübel	negative
kriminell	negative
themenfoto	positive
regelgemäss	positive
pedantisch	positive
penibel	positive
förmlich	positive
achtsam	positive
peinlich	positive
preisgekrönt	positive
amoralisch	negative
niederträchtig	negative
superior	positive
missraten	negative
misslungen	negative
exportware	positive
investitionsgut	positive
stümperhaft	negative
importware	positive
boshaft	negative
weinerlich	negative
okay	positive
glückstrahlend	positive
überglücklich	positive
gemeingut	positive
irregulär	negative
irrtümlich	negative
unrichtig	negative
unzutreffend	negative
fälschlich	negative
unwahr	negative
läppisch	negative
nichtig	negative
werbefotografie	positive
werbephotographie	positive
pressephotographie	positive
pressefotografie	positive
familiengut	positive
grottig	negative
untrainiert	negative
unsportlich	negative
kraftlos	negative
memmenhaft	negative
schlapp	negative
schwächlich	negative
mickerig	negative
schlaff	negative
gebrechlich	negative
lichtschwach	negative
farbphotographie	positive
farbfotografie	positive
handelsgut	positive
genehm	positive
begrüssenswert	positive
unehrenhaft	negative
ehrlos	negative
glückselig	positive
glücklos	negative
chancenlos	negative
frachtgut	positive
fracht	positive
transportware	positive
mau	negative
unnützlich	negative
erfolglos	negative
drittklassig	negative
unfertig	negative
partiell	negative
ineffektiv	negative
günstig	positive
eingängig	positive
ideal	positive
bleich	negative
farbschwach	negative
immunschwach	negative
umsatzschwach	negative
entscheidungsschwach	negative
konditionsschwach	negative
verkaufsschwach	negative
unattraktiv	negative
unverdorben	positive
erträglich	positive
cargo	positive
ladungsgut	positive
zerstörerisch	negative
destruktiv	negative
traumhaft	positive
idyllisch	positive
sensationell	positive
legendenhaft	positive
umgänglich	positive
menschenwürdig	positive
verkehrt	negative
unecht	negative
fangarm	negative
unfair	negative
teilweise	negative
schwarzweissbild	positive
schwarz-weiss-bild	positive
schwarzweissfoto	positive
schwarz-weiss-foto	positive
themenfotografie	positive
themenphotographie	positive
archivfoto	positive
archivbild	positive
farbaufnahme	positive
farbbild	positive
insolvent	negative
matt	negative
flau	negative
fotografie	positive
photographie	positive
preussisch	positive
gewissenhaft	positive
unvorteilhaft	negative
kläglich	negative
massenstückgut	positive
liebevoll	positive
nervig	negative
giftig	negative
bildhübsch	positive
sinnlich	positive
feingeschnitten	positive
fein geschnitten	positive
eiweissarm	negative
vitaminarm	negative
grossartig	positive
pressefoto	positive
blendend	positive
glimpflich	positive
verteufelt	negative
verbessernd	positive
schrecklich	negative
fürchterlich	negative
furchtbar	negative
strukturschwach	negative
finanzschwach	negative
altersschwach	negative
stark	positive
gefahrgut	positive
versorgungsgut	positive
behandlungsgut	positive
dilettantisch	negative
luftfracht	positive
fehlerhaft	negative
schiffsfracht	positive
miserabel	negative
schäbig	negative
exportgut	positive
erinnerungsfoto	positive
fahndungsbild	positive
fahndungsfoto	positive
hinfällig	negative
morbide	negative
zart	negative
freundschaftlich	positive
partnerschaftlich	positive
kumpelhaft	positive
rudimentär	negative
fragmentarisch	negative
bruchstückhaft	negative
bruchstückartig	negative
kammergut	positive
unsinnig	negative
ergebnislos	negative
zwecklos	negative
zweckfrei	negative
unzweckmässig	negative
vorbildhaft	positive
umweltgefährdend	negative
stinkreich	positive
steinreich	positive
strömungsgünstig	positive
unheilvoll	negative
unheilschwanger	negative
unheil verheissend	negative
unheilverheissend	negative
besorgniserregend	negative
leicht	negative
treu sorgend	positive
treusorgend	positive
schwerreich	positive
neureich	positive
zerbeult	negative
menschenverträglich	positive
wirtschaftsverträglich	positive
sozialverträglich	positive
begütert	positive
überreich	positive
griesgrämig	negative
feindlich	negative
muffelig	negative
miesepetrig	negative
wahrhaft	positive
unstimmig	negative
sinngetreu	positive
kopfballstark	positive
edel	positive
froh	positive
anmutig	negative
graziös	negative
unverdaulich	negative
normgemäss	positive
verstärkt	positive
nahrhaft	positive
goldig	positive
putzig	positive
gnädig	positive
zärtlich	positive
niedlich	positive
verzeihend	positive
unschuldig	positive
rein	positive
geländegängig	positive
uneinholbar	positive
unerreicht	positive
marktbeherrschend	positive
unnachahmlich	positive
unerreichbar	positive
marktführend	positive
tanzbar	positive
erlernbar	positive
vaterlandslos	negative
mischbar	positive
druckfähig	positive
zytotoxisch	negative
vortrefflich	positive
bestechend	positive
begünstigend	positive
mildernd	positive
vorzüglich	positive
geisterhaft	negative
gespenstig	negative
grauenerregend	negative
grauen erregend	negative
gruselig	negative
schaurig	negative
schauerhaft	negative
schauerlich	negative
gespensterhaft	negative
gespenstisch	negative
brauchbar	positive
notleidend	negative
not leidend	negative
überstark	positive
leidlich	positive
aushaltbar	positive
zukunftsfähig	positive
lagerfähig	positive
marktfähig	positive
suizidgefährdet	negative
selbstmordgefährdet	negative
unfallgefährdet	negative
verführbar	negative
frank	positive
hochzeitsbild	positive
wortgemäss	positive
wortlautgemäss	positive
blutarm	negative
unrühmlich	negative
süss	positive
possierlich	positive
unannehmbar	negative
unvertretbar	negative
untauglich	negative
unfähig	negative
bestmöglich	positive
wohlhabend	positive
gutsituiert	positive
betucht	positive
vermögend	positive
gut betucht	positive
gutbetucht	positive
zahlungskräftig	positive
rückfällig	negative
unvermindert	positive
unehrlich	negative
gründlich	positive
hautverträglich	positive
wolkenbruchartig	negative
vierschrötig	negative
wahrheitsgetreu	positive
bucklig	negative
buckelig	negative
verwachsen	negative
vorwurfsvoll	negative
nervtötend	negative
essbar	positive
wahrheitsgemäss	positive
sinngemäss	positive
vorteilhaft	positive
geniessbar	positive
unbekömmlich	negative
famos	positive
strahlend	positive
barsch	negative
unpraktisch	negative
humanitär	positive
friedvoll	positive
herzig	positive
grazil	negative
bestimmungsgemäss	positive
befehlsgemäss	positive
unstandesgemäss	negative
ehrlich	positive
ehrenhaft	positive
verlottert	negative
verkommen	negative
unappetitlich	negative
ungepflegt	negative
schmuddelig	negative
vergammelt	negative
verlumpt	negative
entspannend	positive
erholsam	positive
gesundheitsförderlich	positive
fördernd	positive
förderlich	positive
unzufrieden	negative
todunglücklich	negative
praktisch	positive
ätherisch	negative
modefotografie	positive
modephotographie	positive
singbar	positive
trinkbar	positive
gefährdet	negative
gesellschaftsverträglich	positive
bedenklich	negative
beunruhigend	negative
alptraumhaft	negative
alptraumartig	negative
unheimlich	negative
alarmierend	negative
ungeheuer	negative
schauderhaft	negative
schaudervoll	negative
kombinierbar	positive
nutzbar	positive
unautorisiert	negative
dankbar	positive
leberschädlich	negative
leberschädigend	negative
nervenschädlich	negative
nervenschädigend	negative
nierenschädlich	negative
nierenschädigend	negative
lebenstüchtig	positive
untüchtig	negative
geschäftstüchtig	positive
wertlos	negative
landschaftsfoto	positive
klassenfoto	positive
familienbild	positive
familienaufnahme	positive
oberflächlich	negative
delikat	negative
gesetzt	positive
seriös	positive
korrekturbedürftig	negative
schwarz-weiss-fotografie	positive
schwarzweissfotografie	positive
lebensfeindlich	negative
erpresserisch	negative
empörend	negative
entwürdigend	negative
menschenfeindlich	negative
selbständig	positive
selbstständig	positive
beeinflussbar	negative
teilbar	positive
lötfähig	positive
liederlich	negative
lasterhaft	negative
entartet	negative
dekadent	negative
heruntergekommen	negative
einladend	positive
feinschmeckerisch	positive
kulinarisch	positive
offensiv	negative
draufgängerisch	negative
perspektivreich	positive
arbeitsfreudig	positive
arbeitswillig	positive
ordentlich	positive
stachelig	negative
stachlig	negative
erlebbar	positive
torgefährlich	negative
heilsam	positive
probiotisch	positive
heilend	positive
bekömmlich	positive
ungiftig	positive
ungeniessbar	negative
verdaulich	positive
umweltverträglich	positive
unsittlich	negative
hetzerisch	negative
demagogisch	negative
kriegerisch	negative
unzumutbar	negative
daguerreotypie	positive
vielversprechend	positive
aussichtsreich	positive
effektiv	positive
unnütz	negative
sinnentstellend	negative
oligotroph	negative
gesundheitsfördernd	positive
anziehend	positive
unübertroffen	positive
unverrichtet	negative
verbittert	negative
freudlos	negative
waffenfähig	positive
geil	positive
sexy	positive
konstruktiv	positive
wohlwollend	positive
behütend	positive
schützend	positive
väterlich	positive
wohlmeinend	positive
mütterlich	positive
vollständig	positive
betroffen	negative
leidtragend	negative
leid tragend	negative
einzelbild	positive
abzugsfähig	positive
siegreich	positive
super	positive
top	positive
krass	positive
fett	positive
tierfoto	positive
eigen	positive
konfliktfähig	positive
gefällig	positive
gefestigt	positive
lebensbejahend	positive
lebenslustig	positive
lebensfroh	positive
heilfroh	positive
erleichtert	positive
straffällig	negative
delinquent	negative
mitschuldig	negative
verbrecherisch	negative
schändlich	negative
unerhört	negative
seelsorglich	positive
augenschädigend	negative
augenschädlich	negative
klimaschädigend	negative
klimaschädlich	negative
eilfertig	positive
betriebsam	positive
geschäftig	positive
beflissen	positive
übereifrig	positive
servil	positive
diensteifrig	positive
agil	positive
wohnlich	positive
erstrebenswert	positive
farblos	negative
architekturbild	positive
architekturfoto	positive
reklamephotographie	positive
reklamefotografie	positive
reklamefoto	positive
modefoto	positive
seelsorgerisch	positive
seelsorgerlich	positive
unordentlich	negative
knuffig	positive
rechtschaffen	positive
orgiastisch	negative
klischeehaft	negative
bedrohlich	negative
vordergründig	negative
plakativ	negative
fleischlich	positive
digitalfotografie	positive
digitalphotographie	positive
anrechnungsfähig	positive
beihilfefähig	positive
sittenlos	negative
unmoralisch	negative
wüst	negative
ungehobelt	negative
heimelig	positive
grobschlächtig	negative
ungeschlacht	negative
hochzufrieden	positive
vergnügt	positive
ungerechtfertigt	negative
unbefugt	negative
ungehörig	negative
sinnlos	negative
eigenständig	positive
durchsetzungsfähig	positive
makrofotografie	positive
makrophotographie	positive
unspektakulär	negative
magnetisierbar	positive
bespielbar	positive
schmuckvoll	positive
gutgemeint	positive
abgewrackt	negative
mephistophelisch	negative
luziferisch	negative
streitsüchtig	negative
gehässig	negative
bissig	negative
aufhetzend	negative
aufwiegelnd	negative
zänkisch	negative
zanksüchtig	negative
hilfreich	positive
human	positive
gelogen	negative
vorgetäuscht	negative
lohnenswert	positive
lohnend	positive
kleinkriminell	negative
dahergelaufen	negative
sehen	positive
gelehrig	positive
hochklassig	positive
virtuos	positive
kunstfertig	positive
hochwertig	positive
poplig	negative
popelig	negative
melancholisch	negative
deprimiert	negative
suchtgefährdet	negative
anständig	positive
unbedenklich	positive
himmelschreiend	negative
arkadisch	positive
huldreich	positive
superreich	positive
bekümmert	negative
erstattungsfähig	positive
hochgiftig	negative
fabelhaft	positive
prunkhaft	positive
menschlich	positive
panzerbrechend	positive
unverhältnismässig	negative
räuberisch	negative
strafbar	negative
betrügerisch	negative
fulminant	positive
dienlich	positive
tierfotografie	positive
tierphotographie	positive
nacktbild	positive
nacktaufnahme	positive
nacktfoto	positive
kapitalkräftig	positive
satzungsgemäss	positive
unsachgemäss	negative
reproduktionsphotographie	positive
reproduktionsfotografie	positive
industriefotografie	positive
industriephotographie	positive
hobbyfotografie	positive
hobbyphotographie	positive
aktfotografie	positive
aktphotographie	positive
phänomenal	positive
reinlich	positive
redlich	positive
klobig	negative
klotzig	negative
unfein	negative
gesund	positive
gesundheitsdienlich	positive
unachtsam	negative
pragmatisch	positive
erfolgsverwöhnt	positive
erfolgsgewöhnt	positive
fündig	positive
lauschig	positive
todtraurig	negative
reumütig	negative
börsenfähig	positive
objektiv	positive
unbescholten	positive
sachlich	positive
trouble	negative
unannehmlichkeit	negative
entsetzlich	negative
abscheulich	negative
verabscheuungswürdig	negative
furcht erregend	negative
furchterregend	negative
kursorisch	negative
unberechtigt	negative
lappig	negative
erlogen	negative
gefälscht	negative
souverän	positive
selbstsicher	positive
selbstbewusst	positive
stadtverträglich	positive
naturverträglich	positive
verstohlen	negative
unbemerkt	negative
unbeobachtet	negative
unbeachtet	negative
unscheinbar	negative
unverdächtig	negative
provozierend	negative
provokativ	negative
unziemlich	negative
schiefgegangen	negative
danebengegangen	negative
untadlig	positive
untadelig	positive
tauglich	positive
verkehrsgünstig	positive
reaktionsfähig	positive
adrett	positive
gepflegt	positive
appetitlich	positive
verschwitzt	negative
verwahrlost	negative
zumutbar	positive
trübsinnig	negative
streitlustig	negative
schiefgelaufen	negative
fehlgeschlagen	negative
sintflutartig	negative
gekonnt	positive
hinderlich	negative
störend	negative
selbstzerstörerisch	negative
selbstschädigend	negative
magenverträglich	positive
prunkvoll	positive
pompös	positive
malerisch	positive
philanthropisch	positive
wahrhaftig	positive
furchteinflössend	negative
hochzeitsfoto	positive
situiert	positive
architekturfotografie	positive
architekturphotographie	positive
porträtphotographie	positive
porträtfotografie	positive
luftbildfotografie	positive
luftbildphotographie	positive
landschaftsphotographie	positive
landschaftsfotografie	positive
schuldhaft	negative
kaufkräftig	positive
wettbewerbsfähig	positive
konkurrenzfähig	positive
griffig	positive
schrecken erregend	negative
schreckenerregend	negative
spukhaft	negative
tragisch	negative
angsterregend	negative
angst erregend	negative
dissozial	negative
asozial	negative
intensiv	positive
hochgradig	positive
gespielt	negative
urlaubsfoto	positive
konfirmationsbild	positive
konfirmationsfoto	positive
umweltbelastend	negative
statutengemäss	positive
machtvoll	positive
herausfordernd	negative
sanftmütig	positive
gedeihlich	positive
überhart	positive
amateurhaft	negative
unbezähmbar	positive
klassenbild	positive
familienfoto	positive
tränenreich	negative
praxistauglich	positive
flugtauglich	positive
geländetauglich	positive
diensttauglich	positive
fahrtauglich	positive
lückenlos	positive
prozessrecht	positive
unheilig	negative
unselig	negative
schwarz	negative
wachstumsfördernd	positive
federleicht	negative
millionenschwer	positive
allerbeste	positive
schlagfertig	positive
beispielgebend	positive
alltagstauglich	positive
kriegstauglich	positive
erschöpft	negative
auswertbar	positive
pflanzenverträglich	positive
klimaverträglich	positive
landschaftsverträglich	positive
förderungswürdig	positive
verlockend	positive
verheissungsvoll	positive
fraglich	negative
feindselig	negative
feindschaftlich	negative
fröhlich	positive
wehmütig	negative
schmackhaft	negative
problemlos	negative
problemfrei	negative
waschecht	positive
gedankenvoll	negative
tiefsinnig	positive
letal	negative
polemisch	negative
hochwassergefährdet	negative
hochgefährlich	negative
verhängnisvoll	negative
fatal	negative
vorurteilslos	positive
drangvoll	negative
ungefärbt	positive
defensiv	positive
widerrechtlich	negative
rechtswidrig	negative
arbeitsunfähig	negative
missbräuchlich	negative
anbaufähig	positive
genusssüchtig	negative
strafmildernd	positive
strafsenkend	positive
leichtfertig	negative
durchlässig	negative
marode	negative
baufällig	negative
marod	negative
verrostet	negative
rostig	negative
wackelig	negative
verwittert	negative
erweiterbar	positive
instandsetzbar	positive
verwertbar	positive
drollig	positive
stumpf	negative
haltbar	positive
leistungsfördernd	positive
marktreif	positive
anämisch	negative
doll	positive
tiefgründig	positive
ruhmreich	positive
löblich	positive
lobenswert	positive
rühmlich	positive
tieftraurig	negative
keck	positive
angeberisch	negative
grossspurig	negative
grossmäulig	negative
prahlerisch	negative
reichverziert	positive
reich verziert	positive
gesetzeswerk	positive
recht kompetenz	positive
recht inhalt	positive
recht subjekt	positive
unproblematisch	negative
reibungslos	negative
ungeschönt	positive
bitter	negative
schnoddrig	negative
unkeusch	negative
ausländerfeindlich	negative
fremdenfeindlich	negative
frauenfeindlich	negative
rassistisch	negative
umweltfeindlich	negative
verfassungsfeindlich	negative
wegweisend	positive
vornehm	positive
heuchlerisch	negative
scheinheilig	negative
unredlich	negative
tiefschürfend	positive
kriegsmüde	negative
tiefreichend	positive
lethargisch	negative
tentakel	negative
bigott	negative
tiefgreifend	positive
tiefgehend	positive
radikal	positive
sportlich	positive
verlegt	negative
zukunftsträchtig	positive
schwulenfeindlich	negative
regierungsfeindlich	negative
werkgetreu	positive
krankenhausreif	negative
schwerverwundet	negative
kolloid	positive
kolloidal	positive
nachteilig	negative
marktgerecht	positive
spitzfindig	negative
schwermütig	negative
wertig	positive
wehrtauglich	positive
100%ig	positive
100-prozentig	positive
antideutsch	negative
deutschfeindlich	negative
wohltätig	positive
erhaben	positive
verleumderisch	negative
ansprechend	positive
strähnig	negative
ölig	negative
fettig	negative
streng	positive
veritabel	positive
gesundheitsabträglich	negative
restlos	positive
unteilbar	negative
schwer	positive
mächtig	positive
tödlich	negative
anwendungsbezogen	positive
angewandt	positive
praxisbezogen	positive
benutzbar	positive
praktikabel	positive
hochherrschaftlich	positive
internetfähig	positive
manövrierunfähig	negative
netzwerkfähig	positive
antiklerikal	negative
republikfeindlich	negative
konjunkturverträglich	positive
makaber	negative
wacklig	negative
abbaubar	positive
risikoreich	negative
riskant	negative
existenzbedrohend	negative
wehrfähig	positive
flugunfähig	negative
apokryph	negative
duftig	positive
verschorft	negative
entzündet	negative
eiternd	negative
eitrig	negative
wund	negative
vereitert	negative
blessiert	negative
lädiert	negative
unverbindlich	negative
würdevoll	positive
honorabel	positive
honett	positive
schwerverletzt	negative
verwundet	negative
wärmebedürftig	negative
luftig	negative
zügellos	negative
unschwer	negative
familienfeindlich	negative
staatsfeindlich	negative
ausserstande	negative
zweitbeste	positive
verlorengegangen	negative
verloren gegangen	negative
sündig	negative
sündhaft	negative
sperrig	negative
zukunftsweisend	positive
zukunftweisend	positive
durchschlagskräftig	positive
reiflich	positive
wartungsarm	negative
explosionsgefährlich	negative
brandgefährlich	negative
antibiotisch	positive
xenophob	negative
bewegungsunfähig	negative
sommerlich-sonnig	positive
arbeitsunwillig	negative
müssig	negative
überflüssig	negative
diebisch	negative
feinkörnig	positive
lecker	negative
verhärtet	negative
vergrätzt	negative
verkehrssicher	positive
behilflich	positive
urtümlich	positive
verfahrensrecht	positive
bildungsfeindlich	negative
fortschrittsfeindlich	negative
flügge	positive
theoretisch	negative
betrüblich	negative
frame	positive
erweiterungsfähig	positive
lebensbedrohlich	negative
lebensgefährlich	negative
aromatisch	positive
vertragsrecht	positive
lustbetont	positive
befreit	positive
lustvoll	positive
erlöst	positive
beruhigt	positive
mühelos	negative
umstritten	negative
strittig	negative
kontrovers	negative
ozonschädigend	negative
ozonschädlich	negative
fahrtüchtig	positive
schlampig	negative
schutzbedürftig	negative
wissenschaftsfeindlich	negative
wehrdienstfähig	positive
wehruntauglich	negative
verkehrsuntauglich	negative
lebensunfähig	negative
lebenspraktisch	positive
zweifelhaft	negative
abgespannt	negative
milliardenschwer	positive
musterhaft	positive
seetüchtig	positive
lebensbedrohend	negative
quietschvergnügt	positive
speicherbar	positive
illegitim	negative
antiphlogistisch	positive
wichtigtuerisch	negative
unbekümmert	positive
behindertenfeindlich	negative
reformfeindlich	negative
islamfeindlich	negative
kulturfeindlich	negative
leibfeindlich	negative
körperfeindlich	negative
ästhetisch	positive
verzerrungsfrei	positive
hundertprozentig	positive
schlagkräftig	positive
streitbar	positive
ungekürzt	positive
unwürdig	negative
würdelos	negative
ausgesprochen	positive
gewinnbar	positive
zerbrechlich	positive
filigran	positive
kirchenfeindlich	negative
honorig	positive
keusch	positive
unterstützend	positive
subsidiär	positive
reichsrecht	positive
feingemahlen	positive
caritativ	positive
karitativ	positive
säuerlich	negative
ungeschlagen	positive
handlich	positive
aristokratisch	positive
adlig	positive
adelig	positive
nobel	positive
abbauwürdig	positive
betont	positive
liebreizend	positive
lieblich	positive
verführerisch	positive
betörend	positive
unwiderstehlich	positive
begehrenswert	positive
charmant	positive
scharmant	positive
kokett	positive
risikobehaftet	negative
vulgär	negative
volksfeindlich	negative
geistfeindlich	negative
gesellschaftsfeindlich	negative
unbefriedigt	negative
zerlumpt	negative
entzündungshemmend	positive
gemeinschaftsschädigend	negative
gesellschaftsunfähig	negative
ausgelaugt	negative
ausgepumpt	negative
ausgebrannt	negative
aufnahmefähig	positive
lebensuntüchtig	negative
unproduktiv	negative
prätentiös	negative
aufladbar	positive
bestreitbar	negative
köstlich	negative
enttäuscht	negative
trübselig	negative
betrübt	negative
deprimierend	negative
spöttisch	negative
qualitätsvoll	positive
unverschuldet	positive
mannschaftstauglich	positive
mannschaftsdienlich	positive
verkaufsfördernd	positive
unerkannt	negative
verehrungswürdig	positive
ruhmvoll	positive
glorreich	positive
eingehend	positive
verstrichen	negative
unseriös	negative
hehr	positive
tollwütig	positive
gefahrvoll	negative
ungeteilt	positive
unzerteilt	positive
ganzheitlich	positive
integral	positive
verlagsrecht	positive
unbesiegt	positive
kuschlig	positive
kuschelig	positive
exemplarisch	positive
strassenverkehrsrecht	positive
unvoreingenommen	positive
hintergründig	positive
blaublütig	positive
einsturzgefährdet	negative
unrechtmässig	negative
zotig	negative
leichtgängig	negative
lustfeindlich	negative
israelfeindlich	negative
kaiserfeindlich	negative
männerfeindlich	negative
christenfeindlich	negative
demokratiefeindlich	negative
parteifeindlich	negative
religionsfeindlich	negative
minderheitenfeindlich	negative
regimefeindlich	negative
unhandlich	negative
ungehört	negative
ungesehen	negative
angreifbar	negative
fragil	positive
ausbaufähig	positive
erneuerbar	positive
renovierbar	positive
schnippisch	negative
scharfzüngig	negative
anwendungsorientiert	positive
handlungsunfähig	negative
zynisch	negative
höhnisch	negative
technikfeindlich	negative
neuwertig	positive
kündigungsrecht	positive
vergrämt	negative
hochseetüchtig	positive
berufspraktisch	positive
verkehrstauglich	positive
athletisch	positive
sportiv	positive
mildtätig	positive
abgerissen	negative
gammelig	negative
gammlig	negative
lumpig	negative
angeschlagen	negative
unhaltbar	negative
komplett	positive
vollzählig	positive
schulrecht	positive
unschicklich	negative
bedröppelt	negative
untröstlich	negative
begossen	negative
gelackmeiert	negative
erholungsbedürftig	negative
urlaubsreif	negative
mitgenommen	negative
entkräftet	negative
echt	positive
verkehrsrecht	positive
stilecht	positive
originalgetreu	positive
unverfälscht	positive
ausgelassen	positive
ordnungsrecht	positive
qualitätvoll	positive
erschliessbar	positive
hintersinnig	positive
verarbeitbar	positive
hilfsbereit	positive
hochgespannt	positive
bedienbar	positive
verfassungswidrig	negative
gesetzwidrig	negative
unzuständig	negative
bedroht	negative
unerlaubt	negative
verboten	negative
ritterlich	positive
vorbestraft	negative
vorurteilsfrei	positive
unparteiisch	positive
unbestechlich	positive
säuberlich	positive
schamlos	negative
obszön	negative
ordinär	negative
tadelnswert	negative
sträflich	negative
desolat	negative
unstabil	negative
undicht	negative
integrierend	positive
wohlschmeckend	negative
desaströs	negative
anfechtbar	negative
beschämt	negative
kunstfeindlich	negative
untragbar	negative
unverfroren	negative
impertinent	negative
lautstark	negative
unverschämt	negative
vorlaut	negative
vollmundig	negative
ungezogen	negative
undankbar	negative
grosskotzig	negative
plebejisch	negative
phlegmatisch	negative
unzüchtig	negative
winkeltreu	positive
ehrenrecht	positive
wirklichkeitsgetreu	positive
frevlerisch	negative
lästerlich	negative
ehrenbürgerrecht	positive
lebensmittelrecht	positive
luftdurchlässig	negative
rezeptiv	positive
schwierig	positive
sprechakttheoretisch	negative
funktionentheoretisch	negative
feldtheoretisch	negative
kategorientheoretisch	negative
geldtheoretisch	negative
komplexitätstheoretisch	negative
rechtstheoretisch	negative
medientheoretisch	negative
quantentheoretisch	negative
aktiengesetz	positive
bergrecht	positive
wiederaufladbar	positive
medienrecht	positive
wirkmächtig	positive
fischereirecht	positive
lenkbar	positive
steuerbar	positive
heiter	positive
niederschmetternd	negative
vereinsrecht	positive
naseweis	positive
kess	positive
seerecht	positive
blind	negative
ungezügelt	negative
rechtsfähig	positive
mehrheitsfähig	positive
anpassungsfähig	positive
montierbar	positive
schutzfähig	positive
kampfunfähig	negative
dienstunfähig	negative
kleinadelig	positive
kleinadlig	positive
leck	negative
löchrig	negative
regierungsfähig	positive
gebrauchsfähig	positive
lehnsrecht	positive
gut aufgelegt	positive
glanzvoll	positive
glänzend	positive
spielstark	positive
wettbewerbsrecht	positive
anpassbar	positive
fähig	positive
allegro	positive
zivilrecht	positive
privatrecht	positive
internationales recht	positive
zartbitter	negative
judenfeindlich	negative
antisemitisch	negative
preiswürdig	positive
wasserdurchlässig	negative
urig	positive
standesherrlich	positive
erbrecht	positive
mietrecht	positive
stadtrecht	positive
landrecht	positive
bodenrecht	positive
heimatrecht	positive
erbbaurecht	positive
dienstrecht	positive
elternrecht	positive
familienrecht	positive
verschoben	negative
trist	negative
emissionsrecht	positive
selbstmörderisch	negative
schmiedbar	positive
allmächtig	positive
nüchtern	positive
schaltbar	positive
dahinterstehend	positive
weiss	negative
demoralisierend	negative
beschwingt	positive
bildungstheoretisch	negative
würdig	positive
verdienstvoll	positive
züchtig	positive
einnehmend	positive
gewinnend	positive
regelbar	positive
umgelegt	negative
finanzstark	positive
clean	positive
gesundet	positive
benutzerfreundlich	positive
anwenderfreundlich	positive
lichtdurchlässig	negative
morbid	negative
handhabbar	positive
gerichtsverwertbar	positive
kompostierbar	positive
schmierig	negative
ungeschützt	negative
gastrecht	positive
urheberrecht	positive
hausrecht	positive
verwertungsrecht	positive
namensrecht	positive
markenrecht	positive
unbefleckt	positive
streitig	negative
flugfähig	positive
betreuungsrecht	positive
ungesichert	negative
skalierbar	positive
rosig	positive
rederecht	positive
senderecht	positive
übertragungsrecht	positive
veranstaltungsrecht	positive
austragungsrecht	positive
kriegsrecht	positive
potent	positive
wirtschaftsrecht	positive
einstellbar	positive
familienfreundlich	positive
kinderfeindlich	negative
ausländerfreundlich	positive
frauenfreundlich	positive
omnipotent	positive
tonangebend	positive
beschlussfähig	positive
einsatzfähig	positive
urheberrechtsschutz	positive
umsatzstark	positive
multitaskingfähig	positive
haftunfähig	negative
schliessbar	positive
kirchenrecht	positive
europarecht	positive
nutzungsrecht	positive
atomrecht	positive
etherisch	negative
hochglänzend	positive
lustig	positive
finanzkräftig	positive
verwaltungsrecht	positive
haushaltsrecht	positive
mitbestimmungsrecht	positive
mitspracherecht	positive
beamtenrecht	positive
steuerrecht	positive
spitz	negative
mühselig	positive
arbeitsscheu	negative
krank	negative
illusionslos	positive
ohnmächtig	negative
royal	positive
kaiserlich	positive
sachenrecht	positive
ausländerrecht	positive
handlungsfähig	positive
mittelschwer	positive
unrein	negative
koscher	positive
steril	positive
keimfrei	positive
adaptiv	positive
recyclingfähig	positive
regenerationsfähig	positive
wiederverwertbar	positive
gehfähig	positive
völkerrechtswidrig	negative
regulierbar	positive
gewagt	negative
spielend	negative
tarifrecht	positive
urhebervertragsrecht	positive
telekommunikationsrecht	positive
gewährleistungsrecht	positive
tarifautonomie	positive
schutzrecht	positive
abtreibungsrecht	positive
schöngeistig	positive
massstabsgerecht	positive
gefährdend	negative
wasserrecht	positive
feingeistig	positive
hochadlig	positive
subtil	positive
abgründig	positive
lebensfähig	positive
stimmrecht	positive
pfandrecht	positive
wohnrecht	positive
informationsrecht	positive
vetorecht	positive
umweltrecht	positive
vorkaufsrecht	positive
streikrecht	positive
sorgerecht	positive
wandlungsfähig	positive
arbeitsfähig	positive
obskur	negative
dubios	negative
grossväterlich	positive
hemmungslos	negative
beziehungsunfähig	negative
rüstig	positive
verheilt	positive
geistesklar	positive
genesen	positive
rentenrecht	positive
arbeitsrecht	positive
planungshoheit	positive
unsentimental	positive
feuchtfröhlich	positive
erlaubt	positive
pharisäisch	negative
kampfstark	positive
beschwerlich	positive
profund	positive
bearbeitbar	positive
trostlos	negative
damenhaft	positive
zögerlich	positive
zauderhaft	positive
süsslich	positive
zuckersüss	positive
königlich	positive
feudalistisch	positive
autonomierecht	positive
ungeschliffen	negative
hervorgehoben	positive
hochadelig	positive
problemvoll	positive
semipermeabel	negative
erbpacht	positive
wohlerzogen	positive
desillusioniert	positive
verdient	positive
leichtfüssig	positive
frohgemut	positive
launig	positive
gutgelaunt	positive
gut gelaunt	positive
bravourös	positive
marktschreierisch	negative
minderheitenrecht	positive
schimmernd	positive
changierend	positive
schillernd	positive
froh gelaunt	positive
frohgelaunt	positive
zierlich	negative
entmutigend	negative
imstande	positive
homophob	negative
wahrscheinlichkeitstheoretisch	negative
evolutionstheoretisch	negative
spieltheoretisch	negative
verschwörungstheoretisch	negative
zahlentheoretisch	negative
kunsttheoretisch	negative
wirtschaftstheoretisch	negative
staatstheoretisch	negative
informationstheoretisch	negative
literaturtheoretisch	negative
erwerbsunfähig	negative
genehmigungsrecht	positive
baurecht	positive
marktrecht	positive
planungsrecht	positive
aktienrecht	positive
verzagt	positive
tierrecht	positive
regenerativ	positive
diffizil	positive
problematisch	positive
sortenrein	positive
berufsunfähig	negative
neutral	positive
beleidigend	negative
ausfallend	negative
feudal	positive
höfisch	positive
mühsam	positive
unbestritten	positive
umweltfreundlich	positive
technikfreundlich	positive
zivilprozessrecht	positive
schuldunfähig	negative
strafprozessrecht	positive
fahl	negative
reizend	positive
verfügungsrecht	positive
emphatisch	positive
unstrittig	positive
schicklich	positive
curriculumtheoretisch	negative
chaostheoretisch	negative
alltagstheoretisch	negative
elektronentheoretisch	negative
konjunkturtheoretisch	negative
zeichentheoretisch	negative
semiotisch	negative
kulturtheoretisch	negative
polizeirecht	positive
unzurechnungsfähig	negative
urwüchsig	positive
freiherrlich	positive
kaiserlich-königlich	positive
euphorisch	positive
überschäumend	positive
überbordend	positive
fidel	positive
unbeschwert	positive
übermütig	positive
quietschfidel	positive
akzentuiert	positive
schmelzbar	positive
wirkungsmächtig	positive
nationales recht	positive
gemeinschaftsrecht	positive
schmalzig	negative
eherecht	positive
lupenrein	positive
zerteilt	negative
zerlegbar	positive
nachrüstbar	positive
systemtheoretisch	negative
musiktheoretisch	negative
wissenschaftstheoretisch	negative
erkenntnistheoretisch	negative
haftfähig	positive
kompromissfähig	positive
sozialrecht	positive
altadlig	positive
altadelig	positive
urheberschutz	positive
humorvoll	positive
humorig	positive
goldglänzend	positive
hochrein	positive
zitatrecht	positive
kerngesund	positive
unbegabt	negative
untalentiert	negative
geburtsrecht	positive
vorfahrtsrecht	positive
völkerrecht	positive
öffentliches recht	positive
vorfahrt	positive
kündigungsschutzrecht	positive
strafrecht	positive
staatsrecht	positive
anerkennenswert	positive
volksrecht	positive
wegerecht	positive
jugendstrafrecht	positive
unbegreifbar	positive
farbig	positive
atmungsaktiv	negative
zauberhaft	positive
zuckerkrank	negative
brenzlig	positive
wassergefährdend	negative
wichtig	positive
bundesrecht	positive
filmrecht	positive
zurechnungsfähig	positive
leistungsstark	positive
bleischwer	positive
erbkrank	negative
unbegreiflich	positive
ökonomisch	negative
niessbrauch	positive
arbeitsteilig	negative
fleischfarben	positive
türkis	positive
cäsarisch	positive
durchstimmbar	positive
spielfähig	positive
zahlungsfähig	positive
entwicklungsfähig	positive
fürstlich	positive
ehrverletzend	negative
friedensgefährdend	negative
schwindsüchtig	negative
überschwer	positive
scherzhaft	positive
kampffähig	positive
altehrwürdig	positive
erkältet	negative
fügsam	positive
allegretto	positive
landesrecht	positive
klar	positive
cremeweiss	negative
pigmentiert	positive
erhaltenswert	positive
leistungsfähig	positive
zweifarbig	positive
diabetisch	negative
mattweiss	negative
blütenweiss	negative
aidskrank	negative
lungenkrank	negative
krebskrank	negative
herzkrank	negative
gallenkrank	negative
leberkrank	negative
nierenkrank	negative
drüsenkrank	negative
magenkrank	negative
reinweiss	negative
jugendgefährdend	negative
schneeweiss	negative
pastellig	positive
schwungvoll	positive
pastellfarbig	positive
unmusikalisch	negative
repressiv	positive
unterdrückerisch	positive
drastisch	positive
drakonisch	positive
strikt	positive
sympathisch	positive
verschliessbar	positive
sicherheitsgefährdend	negative
verpanscht	negative
klickbar	positive
downloadbar	positive
verunreinigt	negative
beherrschbar	positive
überlebensfähig	positive
insolvenzrecht	positive
grüblerisch	negative
schlechtgelaunt	negative
schlecht gelaunt	negative
hochwürdig	positive
sympathie erweckend	positive
sympathieerweckend	positive
gelb	positive
falb	negative
abschliessbar	positive
kartellrecht	positive
willfährig	positive
gehorsam	positive
dreifarbig	positive
sterbenskrank	negative
familiengerecht	positive
machtlos	negative
kritikfähig	positive
leidensfähig	positive
dialogfähig	positive
gelbweiss	negative
milchweiss	negative
einkommensteuerrecht	positive
psychotisch	negative
todkrank	negative
zerkleinert	negative
hell	positive
kränkelnd	negative
kränklich	negative
hautfarben	positive
grundpfandrecht	positive
blaugrün	positive
gotteslästerlich	negative
weissgetüncht	positive
metamorph	positive
schuldfähig	positive
majestätisch	positive
fraktioniert	negative
aufgeräumt	positive
gestreng	positive
perlweiss	negative
schlohweiss	negative
unstreitig	positive
interaktiv	positive
virtuell	positive
virtual	positive
unhygienisch	negative
teilrechtsfähig	positive
geistesgestört	negative
schutzwürdig	positive
unverständlich	positive
heikel	positive
hochverdient	positive
anklickbar	positive
braun	positive
tuberkulös	negative
lilienweiss	negative
andersfarbig	positive
quick-and-dirty	positive
teamfähig	positive
aktionsfähig	positive
einsichtsfähig	positive
urteilsfähig	positive
metallfarben	positive
blumig	positive
grellweiss	negative
ruchlos	negative
höflich	positive
sittsam	positive
starkfarbig	positive
knifflig	positive
kirchensatz	positive
textbasiert	positive
alkoholkrank	negative
schamhaft	positive
empfindungsfähig	positive
türkisfarben	positive
sublim	positive
geschnitten	negative
zerfasert	negative
vorwitzig	positive
gestört	negative
dienstfähig	positive
kinderfreundlich	positive
blasphemisch	negative
weisslich	negative
pastell	positive
pastellfarben	positive
monochrom	positive
herunterladbar	positive
crossmedial	positive
brisant	positive
obligationenrecht	positive
sächlich	positive
kompliziert	positive
kontaminiert	negative
gepanscht	negative
gestattet	positive
vierfarbig	positive
schuldrecht	positive
unumstritten	positive
unangefochten	positive
dunkelfarbig	positive
wohlverdient	positive
schwarzweiss	positive
aschfahl	negative
bezaubernd	positive
hinreissend	positive
entzückend	positive
bezückend	positive
scrollbar	positive
verlinkt	positive
mikrotheoretisch	negative
umweltschonend	positive
uni	positive
einfarbig	positive
kommunalrecht	positive
leichtsinnig	negative
krüppelhaft	negative
magersüchtig	negative
heiser	negative
silberweiss	negative
grauweiss	negative
verschmutzt	negative
verkrüppelt	negative
staatsgefährdend	negative
hellfarben	positive
aufgeteilt	negative
naturfarben	positive
rauchig	positive
schwerkrank	negative
silbrig	positive
alphanumerisch	positive
nebenstrafrecht	positive
bindungsfähig	positive
denkfähig	positive
monochromatisch	positive
gleichfarbig	positive
verseucht	negative
nachdenklich	negative
dornenreich	positive
gefügig	positive
erwerbsfähig	positive
talentiert	positive
begabt	positive
befähigt	positive
lernfähig	positive
gesundheitsgefährdend	negative
gesittet	positive
prüde	positive
tonnenschwer	positive
inquisitorisch	positive
krüppelig	negative
herrschend	positive
unerklärbar	positive
unerklärlich	positive
wolkenfrei	positive
verzwackt	positive
steuerpflichtig	positive
folgsam	positive
ungehorsam	negative
unerfindlich	positive
unergründlich	positive
unfassbar	positive
übellaunig	negative
mikroökonomisch	negative
sozioökonomisch	negative
makroökonomisch	negative
grellgelb	positive
zuvorkommend	positive
wertvoll	positive
kostbar	positive
verschnupft	negative
verrückt	negative
undurchschaubar	positive
ehrrührig	negative
ehrenrührig	negative
grimm	negative
massgeblich	positive
sentimental	negative
schikanös	negative
essenzial	positive
essential	positive
wasserklar	positive
verschleimt	negative
musikalisch	positive
wesentlich	positive
dornig	positive
verflixt	positive
dunkelhäutig	positive
grundsteuerpflichtig	positive
erbschaftssteuerpflichtig	positive
hellbraun	positive
einschneidend	positive
massiv	positive
brav	positive
relevant	positive
misslaunig	negative
entgegenkommend	positive
superwichtig	positive
hochwichtig	positive
beigefarben	positive
sandfarben	positive
goldgelb	positive
kalkig	negative
verwünscht	positive
messinggelb	positive
gelbbraun	positive
goldbraun	positive
rehbraun	positive
ockerbraun	positive
olivbraun	positive
tiefbraun	positive
wissenswert	positive
gelblich	positive
galant	positive
rührselig	negative
beziehungsreich	positive
weissgelb	positive
grüngelb	positive
strohgelb	positive
orangegelb	positive
kristallklar	positive
lebensnotwendig	positive
wichtigst	positive
nennenswert	positive
zweitwichtigste	positive
erwähnenswert	positive
zerschnitten	negative
frech	negative
artig	positive
nussbraun	positive
verdrossen	negative
überlebenswichtig	positive
goldfarben	positive
wahnsinnig	negative
geisteskrank	negative
irre	negative
irr	negative
irrsinnig	negative
schokoladenbraun	positive
pestverseucht	negative
grundsätzlich	positive
sepiabraun	positive
erdbraun	positive
kupferbraun	positive
kackbraun	positive
kakifarben	positive
khakifarben	positive
khaki	positive
kaki	positive
hellgelb	positive
sehnsüchtig	negative
nörglerisch	negative
nölig	negative
nörgelig	negative
kleingeschnitten	negative
zimtfarbig	positive
brennend	positive
dienstbar	positive
bronzefarben	positive
sprachbegabt	positive
rostbraun	positive
rötlichbraun	positive
rostfarben	positive
zitronengelb	positive
körperschaftsteuerpflichtig	positive
körperschaftssteuerpflichtig	positive
verfänglich	positive
permissiv	negative
lebenswichtig	positive
sehnsuchtsvoll	negative
sattgelb	positive
sonnengelb	positive
fahlgelb	positive
safrangelb	positive
lehmgelb	positive
buttergelb	positive
schwefelgelb	positive
blassgelb	positive
dottergelb	positive
honiggelb	positive
silberfarben	positive
schalkhaft	positive
denunziatorisch	negative
glasklar	positive
albern	positive
strahlenverseucht	negative
staatstragend	positive
vorherrschend	positive
dunkelgelb	positive
bräunlich	positive
salonfähig	positive
wolkenlos	positive
liquide	positive
liquid	positive
silberfarbig	positive
rostfarbig	positive
goldfarbig	positive
schwererziehbar	positive
schwer erziehbar	positive
safranfarben	positive
bernsteinfarben	positive
missgestimmt	negative
missgelaunt	negative
verstimmt	negative
knatschig	negative
quengelig	negative
essenziell	positive
essentiell	positive
mürrisch	negative
grimmig	negative
grantig	negative
hochleistungsfähig	positive
hochkompliziert	positive
wohlfahrtsökonomisch	negative
agrarökonomisch	negative
informationsökonomisch	negative
possenhaft	positive
übelgelaunt	negative
übel gelaunt	negative
gesellschaftsfähig	positive
üppig	positive
kanariengelb	positive
knallgelb	positive
mattgelb	positive
lohnsteuerpflichtig	positive
zartgelb	positive
geschnetzelt	negative
zersäbelt	negative
verworren	positive
verwickelt	positive
beige	positive
erdfarben	positive
verflucht	positive
vermaledeit	positive
bronzefarbig	positive
sandfarbig	positive
elfenbeinfarbig	negative
elfenbeinfarben	negative
bernsteinfarbig	positive
vielschichtig	positive
verzwickt	positive
vertrackt	positive
kakaobraun	positive
botmässig	positive
einkommenssteuerpflichtig	positive
einkommensteuerpflichtig	positive
bärbeissig	negative
eingeschnitten	negative
arbeitsökonomisch	negative
ingenieurökonomisch	negative
umweltökonomisch	negative
politökonomisch	negative
industrieökonomisch	negative
sozialökonomisch	negative
medienökonomisch	negative
schelmisch	positive
verhaltensgestört	negative
vernunftbegabt	positive
unkalkulierbar	positive
unberechenbar	positive
gemeingefährlich	positive
graubraun	positive
umsatzsteuerpflichtig	positive
unwichtig	negative
musikbegabt	positive
hochbegabt	positive
hoch begabt	positive
verwoben	positive
komplex	positive
zimtfarben	positive
unbeschreiblich	positive
unbeschreibbar	positive
kalkhaltig	negative
rebellisch	negative
aufständisch	negative
widerspenstig	negative
aufmüpfig	negative
knorrig	negative
lichtstark	positive
ernstzunehmend	positive
kunstvoll	positive
hochkarätig	positive
unartig	negative
verdreht	negative
unsäglich	positive
bekloppt	negative
narrenhaft	negative
jeck	negative
burlesk	positive
taktlos	negative
taktvoll	positive
wirtschaftlich	negative
stur	negative
unüberprüfbar	positive
unlustig	negative
dickköpfig	negative
lümmelhaft	negative
charakteristisch	positive
rentabel	negative
zinsgünstig	negative
profitabel	negative
aquarellfarben	positive
richtungsweisend	positive
richtungweisend	positive
begrifflich	positive
belegt	negative
hochmusikalisch	positive
facettenreich	positive
lausbubenhaft	positive
lausbübisch	positive
verraucht	positive
dunkelbraun	positive
beleuchtet	positive
unsagbar	positive
unlöslich	positive
spleenig	negative
indiskret	negative
diskret	positive
unhöflich	negative
existenziell	positive
existentiell	positive
sekundär	negative
zweitrangig	negative
unbedeutend	negative
nebensächlich	negative
unbedeutsam	negative
ungebührlich	negative
paranoid	negative
zentral	positive
loh	positive
sehnlich	negative
hochkomplex	positive
wahnhaft	negative
hygienisch	positive
muffig	negative
aufsässig	negative
entbehrlich	negative
sonnenbeschienen	positive
nostalgisch	negative
unbotmässig	negative
verzichtbar	negative
monopolistisch	negative
flegelhaft	negative
pöbelhaft	negative
unmanierlich	negative
ockerfarbig	positive
einschlägig	positive
unnötig	negative
unfolgsam	negative
unökonomisch	positive
flapsig	negative
eigensinnig	negative
diskussionswürdig	positive
despektierlich	negative
verächtlich	negative
begnadet	positive
verschmitzt	positive
gesprächsbereit	positive
programmatisch	positive
normativ	positive
zielweisend	positive
massgebend	positive
marginal	negative
abstrakt	positive
ockergelb	positive
ockerfarben	positive
muschelkalkhaltig	negative
störrisch	negative
bockig	negative
verstockt	negative
eigenmächtig	negative
eigenwillig	negative
patzig	negative
diskutabel	positive
kunstreich	positive
bibliophil	positive
rationell	negative
sprachökonomisch	negative
prozessökonomisch	negative
kompromissbereit	positive
lichterloh	positive
lichtdurchflutet	positive
verbockt	negative
renitent	negative
existential	positive
existenzial	positive
kennzeichnend	positive
bestimmend	positive
konfrontativ	negative
verlust bringend	positive
verlustbringend	positive
modrig	negative
moderig	negative
konkret	negative
wesensgemäss	positive
geringschätzig	negative
energiewirtschaftlich	negative
planwirtschaftlich	negative
finanzwirtschaftlich	negative
personalwirtschaftlich	negative
unkontrollierbar	positive
lukrativ	negative
aufmerksam	positive
diskutierbar	positive
hauswirtschaftlich	negative
trotzig	negative
peripher	negative
autoritativ	positive
überbelegt	negative
abschätzig	negative
ineffizient	positive
schwarzbraun	positive
erleuchtet	positive
manierlich	positive
abfällig	negative
indiskutabel	negative
vermeidbar	negative
unaussprechlich	positive
gewinn bringend	negative
gewinnbringend	negative
privatwirtschaftlich	negative
kammermusikalisch	positive
unwirtschaftlich	positive
missfällig	negative
splendid	positive
miefig	negative
gemeinwirtschaftlich	negative
verlustreich	positive
akzessorisch	negative
unrentabel	positive
weltwirtschaftlich	negative
gesamtwirtschaftlich	negative
wesenhaft	positive
lapidar	negative
widerständig	negative
gut gehend	negative
gutgehend	negative
aussenwirtschaftlich	negative
wasserwirtschaftlich	negative
kirchenmusikalisch	positive
sanitär	positive
forstwirtschaftlich	negative
konsensfähig	positive
närrisch	negative
optional	negative
marktwirtschaftlich	negative
vernachlässigbar	negative
involviert	positive
unentbehrlich	positive
geistig behindert	negative
beiläufig	negative
fakultativ	negative
effizient	negative
unaufmerksam	negative
schnell	positive
hellhörig	positive
reaktionsschnell	positive
geistesgegenwärtig	positive
wach	positive
versunken	positive
kontemplativ	positive
konzentriert	positive
hochrangig	positive
meditativ	positive
szenetypisch	positive
frauentypisch	positive
wasserunlöslich	positive
männertypisch	positive
löslich	negative
typisch	positive
landestypisch	positive
zeittypisch	positive
archetypisch	positive
regionaltypisch	positive
hochstehend	positive
unabkömmlich	positive
unkonzentriert	negative
untypisch	negative
schwerlöslich	negative
schwer löslich	negative
öllöslich	negative
alkohollöslich	negative
fettlöslich	negative
prototypisch	positive
stereotypisch	positive
stereotyp	positive
idealtypisch	positive
geistesabwesend	negative
zerstreut	negative
vergesslich	negative
wasserlöslich	negative
energieeffizient	negative
superschnell	positive
temporeich	positive
abwesend	negative
nahtlos	positive
rasch	positive
träumerisch	negative
zügig	positive
hurtig	positive
geschwind	positive
verträumt	negative
schnellwüchsig	positive
pfeilschnell	positive
verzögerungslos	positive
hellwach	positive
wirkungsvoll	negative
effektvoll	negative
müde	negative
eilig	positive
hastig	positive
rapide	positive
rapid	positive
kometenhaft	positive
galoppierend	positive
schnellfüssig	positive
fluchtartig	positive
gedankenverloren	negative
gedankenversunken	negative
atypisch	negative
langsam	negative
andante	negative
versonnen	negative
selbstvergessen	negative
schleppend	negative
gemächlich	negative
wirkungslos	positive
schlaftrunken	negative
unausgeschlafen	negative
todmüde	negative
verschlafen	negative
vorschnell	positive
voreilig	positive
dringend	positive
unaufschiebbar	positive
ernstlich	positive
dringlich	positive
hundemüde	negative
lahm	negative
transusig	negative
tranig	negative
träge	negative
träg	negative
andantino	negative
mangelnd	negative
fehlend	negative
gehbehindert	negative
