schwach	negative
hervorragend	positive
lieb	positive
liebevoll	positive
phantastisch	positive
fantastisch	positive
grossartig	positive
böse	negative
bös	negative
sympathisch	positive
prima	positive
langsam	negative
schwierig	negative
kompliziert	negative
schnell	positive
schlecht	negative
dumm	negative
stark	positive
nett	positive
schrecklich	negative
grimmig	negative
ärgerlich	negative
nachtragend	negative
zornig	negative
wütend	negative
schön	positive
hübsch	positive
langweilig	negative
schlimm	negative
lichtschwach	negative
labil	negative
verloren	negative
instabil	negative
gefährdet	negative
selbständig	positive
selbstständig	positive
hilflos	negative
entwürdigend	negative
unbegreifbar	negative
unbegreiflich	negative
unverständlich	negative
umsatzschwach	negative
leistungsschwach	negative
vortrefflich	positive
bestechend	positive
herausragend	positive
vorzüglich	positive
gütig	positive
zittrig	negative
absolutistisch	positive
unfair	negative
übel	negative
ungerecht	negative
gefestigt	positive
oberflächlich	negative
leicht	negative
debil	negative
weinerlich	negative
schmachvoll	negative
schmählich	negative
schuldig	negative
kopfballstark	positive
eklatant	positive
unvermindert	positive
gewaltig	positive
heftig	positive
fluchtartig	positive
kraftvoll	positive
kräftig	positive
zäh	positive
widerstandsfähig	positive
matt	negative
mau	negative
flau	negative
faul	negative
lausig	negative
nervenschwach	negative
muskelschwach	negative
unvorteilhaft	negative
hündisch	negative
bildschön	positive
schwererziehbar	negative
schwer erziehbar	negative
geistesschwach	negative
charakterschwach	negative
wirtschaftsschwach	negative
rauchschwach	negative
willensschwach	negative
verkehrsschwach	negative
sehschwach	negative
mitgliederschwach	negative
überstark	positive
fuchsig	negative
fuchsteufelswild	negative
erbittert	negative
immunschwach	negative
galoppierend	positive
verwünscht	negative
druckvoll	positive
stilgerecht	positive
schnellfüssig	positive
grandios	positive
hochklassig	positive
hochwertig	positive
unedel	negative
schmuck	positive
stilvoll	positive
dekorativ	positive
souverän	positive
selbstsicher	positive
selbstbewusst	positive
sauer	negative
gekränkt	negative
beleidigt	negative
bitterböse	negative
empört	negative
erzürnt	negative
indigniert	negative
entrüstet	negative
sympathie erweckend	positive
sympathieerweckend	positive
fulminant	positive
grottig	negative
superschnell	positive
untrainiert	negative
kraftlos	negative
memmenhaft	negative
schlapp	negative
schwächlich	negative
mickerig	negative
schlaff	negative
gebrechlich	negative
reizlos	negative
ermüdend	negative
geisttötend	negative
dröge	negative
monoton	negative
sterbenslangweilig	negative
stinklangweilig	negative
nahtlos	positive
verzögerungslos	positive
blitzschnell	positive
blitzartig	positive
rasant	positive
flink	positive
charakterlos	negative
anziehend	positive
bildhübsch	positive
sinnlich	positive
feingeschnitten	positive
fein geschnitten	positive
reflexhaft	positive
pejorativ	negative
unzufrieden	negative
leid	negative
allegro	positive
andante	negative
liebreich	positive
unkalkulierbar	negative
unkompliziert	positive
knifflig	negative
problemvoll	negative
brisant	negative
diffizil	negative
problematisch	negative
heikel	negative
prekär	negative
fehlerhaft	negative
satanisch	negative
unberechenbar	negative
gemeingefährlich	negative
schädlich	negative
sekundenschnell	positive
inakzeptabel	negative
unakzeptabel	negative
ungünstig	negative
angriffslustig	negative
aggressiv	negative
kampflustig	negative
kampfeslustig	negative
gelinde	negative
schnellwüchsig	positive
temporeich	positive
ruchbar	negative
eklig	negative
unerträglich	negative
arg	negative
unehrenhaft	negative
ehrlos	negative
unterbelichtet	negative
doof	negative
blöd	negative
dull	negative
verzwickt	negative
vertrackt	negative
verzwackt	negative
verflixt	negative
verflucht	negative
vermaledeit	negative
dusselig	negative
dusslig	negative
astrein	positive
knorke	positive
dufte	positive
prächtig	positive
prachtvoll	positive
glücklos	negative
chancenlos	negative
unnützlich	negative
unnütz	negative
erfolglos	negative
unfreundlich	negative
missvergnügt	negative
hochkompliziert	negative
stupid	negative
stupide	negative
ätzend	negative
mistig	negative
beknackt	negative
oll	negative
widrig	negative
diabolisch	negative
teuflisch	negative
hasserfüllt	negative
stiefmütterlich	negative
gemein	negative
bescheuert	negative
beschränkt	negative
behämmert	negative
trottelhaft	negative
trottelig	negative
idiotenhaft	negative
idiotisch	negative
ineffektiv	negative
feige	negative
feig	negative
hinterhältig	negative
rasch	positive
gut	positive
fürchterlich	negative
furchtbar	negative
durchtrainiert	positive
kriminell	negative
wuchtig	positive
unauffallend	negative
unauffällig	negative
grantig	negative
bärenstark	positive
muskelbepackt	positive
trainiert	positive
kernig	positive
konditionsstark	positive
fit	positive
strukturschwach	negative
einkommensschwach	negative
finanzschwach	negative
altersschwach	negative
gewalttätig	negative
brutal	negative
mörderisch	positive
höllisch	positive
intensiv	positive
hochgradig	positive
verstärkt	positive
schwindlig	negative
stilsicher	positive
grimm	negative
peinlich	negative
misslungen	negative
miserabel	negative
schäbig	negative
zärtlich	positive
liebesfähig	positive
liebenswürdig	positive
liebenswert	positive
nichtsnutzig	negative
pfeilschnell	positive
bleich	negative
blass	negative
geschmackvoll	positive
verkaufsschwach	negative
genant	negative
genierlich	negative
angefressen	negative
unumschränkt	positive
machtvoll	positive
eingeschnappt	negative
verletzt	negative
pikiert	negative
erbost	negative
unversöhnlich	negative
strafwürdig	negative
schädigend	negative
dämlich	negative
abgeschlagen	negative
hässlich	negative
geburtenschwach	negative
hinfällig	negative
morbide	negative
zart	negative
anfällig	negative
eigenständig	positive
durchsetzungsfähig	positive
konfliktfähig	positive
wild	negative
verärgert	negative
interessant	positive
nichts sagend	negative
nichtssagend	negative
eilig	positive
hastig	positive
rapide	positive
rapid	positive
zügig	positive
flott	positive
kometenhaft	positive
explosionsartig	positive
wunderschön	positive
wohl geformt	positive
wohlgeformt	positive
beziehungsreich	negative
uninteressant	negative
fad	negative
fade	negative
eintönig	negative
hurtig	positive
getragen	negative
geschwind	positive
schleppend	negative
amoralisch	negative
fehlbar	negative
farbschwach	negative
klug	positive
entscheidungsschwach	negative
konditionsschwach	negative
hämisch	negative
süffisant	negative
missraten	negative
dilettantisch	negative
stümperhaft	negative
muskulös	positive
grottenschlecht	negative
verkehrsarm	negative
stockend	negative
gemächlich	negative
undurchschaubar	negative
reflexartig	positive
grauslich	negative
unschön	negative
laienhaft	negative
ungeeignet	negative
ungut	negative
unprofessionell	negative
nutzlos	negative
saublöd	negative
saudumm	negative
saudoof	negative
ignorant	negative
tumb	negative
töricht	negative
einfältig	negative
schwachsinnig	negative
strohdoof	negative
strohdumm	negative
verwoben	negative
verworren	negative
vielschichtig	negative
komplex	negative
überhart	positive
sinnlos	negative
unsinnig	negative
ergebnislos	negative
zwecklos	negative
zweckfrei	negative
unzweckmässig	negative
dämonisch	negative
bösartig	negative
famos	positive
böswillig	negative
abträglich	negative
bescheiden	negative
anrüchig	negative
traumatisierend	negative
vernichtend	negative
katastrophal	negative
verheerend	negative
scheiss	negative
beschissen	negative
niederträchtig	negative
maliziös	negative
boshaft	negative
transusig	negative
tranig	negative
träge	negative
träg	negative
begriffsstutzig	negative
belämmert	negative
unbezähmbar	positive
sinnreich	positive
beeinflussbar	negative
hart	positive
schnöde	negative
zerstörerisch	negative
destruktiv	negative
durchschaubar	positive
verständlich	positive
fein	positive
gnädig	positive
herzig	positive
ergebnisreich	positive
zweckmässig	positive
sinnvoll	positive
sinnig	positive
imageträchtig	positive
ehrenvoll	positive
prestigeträchtig	positive
optimal	positive
bestmöglich	positive
verwaschen	negative
geistvoll	positive
kleinkriminell	negative
unsportlich	negative
arglistig	negative
heimtückisch	negative
durchtrieben	negative
hinterlistig	negative
tückisch	negative
perfide	negative
brenzlig	negative
aromatisch	positive
streng	positive
stechend	positive
beissend	positive
scharf	positive
unmässig	positive
übertrieben	positive
geharnischt	negative
klischeehaft	negative
vordergründig	negative
plakativ	negative
grazil	negative
scheusslich	negative
entsetzlich	negative
abscheulich	negative
verabscheuungswürdig	negative
tugendreich	positive
reissend	positive
kursorisch	negative
straffällig	negative
delinquent	negative
mitschuldig	negative
unschuldig	positive
verbrecherisch	negative
schändlich	negative
entschieden	positive
gewaltsam	positive
stabil	positive
glühend	positive
abgehärtet	positive
unverwüstlich	positive
vital	positive
lächerlich	negative
sicher	positive
grausam	negative
barbarisch	negative
erbarmungslos	negative
mitleidslos	negative
gnadenlos	negative
schonungslos	negative
rüde	negative
unerklärbar	negative
unbeschreiblich	negative
dahergelaufen	negative
auffallend	positive
auffällig	positive
betont	positive
umweltschädigend	negative
umweltschädlich	negative
geschäftsschädigend	negative
parteischädigend	negative
poplig	negative
popelig	negative
farblos	negative
lebensfeindlich	negative
schuldhaft	negative
lappig	negative
rüd	negative
roh	negative
rabiat	negative
unselbstständig	negative
unselbständig	negative
leuchtend	positive
lebendig	positive
lebhaft	positive
gebleicht	negative
ausgebleicht	negative
verblasst	negative
verblichen	negative
masslos	positive
garstig	negative
trocken	negative
offensiv	negative
draufgängerisch	negative
deformiert	negative
verformt	negative
torgefährlich	negative
possierlich	positive
tugendhaft	positive
gerecht	positive
fair	positive
tugendlich	positive
unsagbar	negative
attraktiv	positive
begreifbar	positive
begreiflich	positive
sinnhaft	positive
berauschend	positive
meisterlich	positive
elefantös	positive
ansprechend	positive
ästhetisch	positive
verlebt	negative
potthässlich	negative
verbraucht	negative
schurkisch	negative
siegesbewusst	positive
siegesgewiss	positive
siegessicher	positive
staatsmännisch	positive
winterhart	positive
durchschlagskräftig	positive
unrühmlich	negative
facettenreich	negative
fix	positive
nachdrücklich	positive
eindringlich	positive
einförmig	negative
qualitätvoll	positive
erfolg versprechend	positive
erfolgversprechend	positive
legendär	positive
mythisch	positive
wundervoll	positive
herrlich	positive
wunderbar	positive
himmlisch	positive
paradiesisch	positive
finessenreich	positive
spitzenmässig	positive
verstohlen	negative
unbemerkt	negative
unbeobachtet	negative
unbeachtet	negative
unscheinbar	negative
unverdächtig	negative
wieselflink	positive
absolut	positive
griffig	positive
rassig	positive
apart	positive
himmelschreiend	negative
unbefriedigt	negative
kabbalistisch	negative
unglücklich	negative
ruckartig	positive
süss	positive
knuffig	positive
adagio	negative
largo	negative
allegretto	positive
andantino	negative
verfänglich	negative
wertig	positive
huldreich	positive
hochgespannt	positive
sehnig	positive
drahtig	positive
keck	positive
schlagfertig	positive
verträglich	positive
rufschädigend	negative
unschädlich	positive
zuträglich	positive
scharfsinnig	positive
brillant	positive
einfallsreich	positive
ideenreich	positive
mächtig	positive
kalkulierbar	positive
berechenbar	positive
pflegeleicht	positive
ätherisch	negative
hochintelligent	positive
provokativ	negative
akzeptabel	positive
genehm	positive
begrüssenswert	positive
meisterhaft	positive
gerissen	positive
listig	positive
geistreich	positive
weise	positive
abgeklärt	positive
unproblematisch	positive
problemlos	positive
unannehmbar	negative
angenehm	positive
bodenlos	negative
unvertretbar	negative
reizvoll	positive
bedenkenswert	positive
hetzerisch	negative
demagogisch	negative
barmherzig	positive
kriegerisch	negative
forsch	negative
gelind	negative
unzumutbar	negative
provozierend	negative
unwürdig	negative
unaufschiebbar	positive
öd	negative
öde	negative
märchenhaft	positive
prunkhaft	positive
schiefgelaufen	negative
schiefgegangen	negative
danebengegangen	negative
fehlgeschlagen	negative
griesgrämig	negative
muffelig	negative
miesepetrig	negative
anoxisch	negative
erfindungsreich	positive
listenreich	positive
perfekt	positive
mustergültig	positive
vorbildlich	positive
beispielhaft	positive
exzellent	positive
ausgezeichnet	positive
exzeptionell	positive
ausserordentlich	positive
unstimmig	negative
infernal	positive
suizidgefährdet	negative
selbstmordgefährdet	negative
suchtgefährdet	negative
unfallgefährdet	negative
verführbar	negative
rückfällig	negative
hinterfotzig	negative
infam	negative
fies	negative
mies	negative
schadenfroh	negative
unerfindlich	negative
unergründlich	negative
unfassbar	negative
blendend	positive
verteufelt	negative
glücklich	positive
besser	positive
pfiffig	positive
gescheit	positive
glückreich	positive
sittlich	positive
moralisch	positive
ethisch	positive
überschwänglich	positive
stramm	positive
gefährlich	negative
tragisch	negative
herzensgut	positive
räuberisch	negative
voreingenommen	negative
subjektiv	negative
strafbar	negative
betrügerisch	negative
sagenhaft	positive
protzig	positive
unbändig	positive
anmutig	positive
graziös	positive
hochkomplex	negative
amateurhaft	negative
unerotisch	negative
dissozial	negative
asozial	negative
militant	negative
tätlich	negative
tiefgreifend	positive
gründlich	positive
tiefgehend	positive
tiefschürfend	positive
fleischlich	positive
lahm	negative
violent	positive
toxisch	negative
unübertrefflich	positive
tiefreichend	positive
entschlossen	positive
resolut	positive
zufrieden	positive
gesundheitsschädlich	negative
gesundheitsschädigend	negative
eifrig	positive
arbeitsam	positive
emsig	positive
fleissig	positive
tüchtig	positive
wertlos	negative
goldig	positive
putzig	positive
niedlich	positive
verzeihend	positive
wolkenbruchartig	negative
unästhetisch	negative
sintflutartig	negative
unerklärlich	negative
unsäglich	negative
unbeschreibbar	negative
martialisch	negative
brachial	negative
handgreiflich	negative
blutrünstig	negative
verschossen	negative
dezent	negative
unförmig	negative
pickelig	negative
entstellt	negative
schlitzohrig	positive
versöhnlich	positive
beeindruckend	positive
eindrucksvoll	positive
bedrohlich	negative
spannungsvoll	positive
unattraktiv	negative
adrett	positive
gepflegt	positive
appetitlich	positive
aufgebracht	negative
vorwurfsvoll	negative
unverträglich	negative
giftig	negative
erbaulich	positive
sehenswert	positive
sehenswürdig	positive
faszinierend	positive
fesselnd	positive
begeisternd	positive
anregend	positive
okay	positive
hochinteressant	positive
unverrichtet	negative
neuwertig	positive
günstig	positive
geeignet	positive
gehoben	positive
eingängig	positive
ideal	positive
blassrosa	negative
unansehnlich	negative
sexy	positive
vorzeigbar	positive
ansehnlich	positive
resistent	positive
immun	positive
unbeirrbar	positive
schlagkräftig	positive
streitbar	positive
konsequent	positive
fintenreich	positive
einseitig	negative
lesenswert	positive
abwechslungsreich	positive
vorschnell	positive
voreilig	positive
erstklassig	positive
spitze	positive
klasse	positive
endgeil	positive
streitlustig	negative
wünschenswert	positive
ehrenhaft	positive
unspektakulär	negative
ausgesprochen	positive
traumatisch	negative
unlöslich	negative
intelligent	positive
schlau	positive
vorteilhaft	positive
gelungen	positive
geraten	positive
erträglich	positive
paradigmatisch	positive
schmuckvoll	positive
gutartig	positive
inhaltsarm	negative
dornig	negative
herausfordernd	negative
abgewrackt	negative
genialisch	positive
vergeistigt	positive
trickreich	positive
clever	positive
alert	positive
auf zack	positive
genial	positive
unüberprüfbar	negative
erpresserisch	negative
untauglich	negative
empörend	negative
mephistophelisch	negative
luziferisch	negative
vaterlandslos	negative
streitsüchtig	negative
gehässig	negative
bissig	negative
aufhetzend	negative
aufwiegelnd	negative
zänkisch	negative
zanksüchtig	negative
qualitätsvoll	positive
nutzbringend	positive
nützlich	positive
verwickelt	negative
traumhaft	positive
idyllisch	positive
sensationell	positive
prunkvoll	positive
pompös	positive
legendenhaft	positive
absurd	negative
abstrus	negative
spannend	positive
unterhaltsam	positive
kurzweilig	positive
aufregend	positive
kontraproduktiv	negative
grossherzig	positive
gutherzig	positive
barsch	negative
gutmütig	positive
friedlich	positive
friedliebend	positive
edelmütig	positive
perfid	negative
ernstlich	positive
dringlich	positive
dringend	positive
unfehlbar	positive
überragend	positive
chancenreich	positive
erfolgreich	positive
vorbildhaft	positive
spielstark	positive
friedvoll	positive
gelegen	positive
phantasiereich	positive
fantasiereich	positive
lauter	positive
unbescholten	positive
solid	positive
solide	positive
reputierlich	positive
arkadisch	positive
hinderlich	negative
störend	negative
selbstzerstörerisch	negative
selbstschädigend	negative
mühelos	negative
durchsichtig	positive
unabhängig	positive
teilbar	positive
herstellerunabhängig	positive
erstrebenswert	positive
lötfähig	positive
umweltgefährdend	negative
steinhart	positive
halbtrocken	negative
opportun	positive
angebracht	positive
passend	positive
niedrig	negative
geweckt	positive
flammend	positive
steif	positive
wiedergeboren	positive
uneinnehmbar	positive
verlorengegangen	negative
verloren gegangen	negative
verlegt	negative
hintergründig	positive
tiefsinnig	positive
tiefgründig	positive
durchlässig	negative
marode	negative
baufällig	negative
marod	negative
verrostet	negative
rostig	negative
wackelig	negative
verwittert	negative
wichtigtuerisch	negative
brauchbar	positive
gefriergetrocknet	negative
aristokratisch	positive
adlig	positive
adelig	positive
nobel	positive
edel	positive
vornehm	positive
definit	positive
blaublütig	positive
gehbehindert	negative
stahlhart	positive
einsturzgefährdet	negative
tot	negative
quicklebendig	positive
bestechlich	negative
korrupt	negative
käuflich	negative
hirnrissig	negative
hartherzig	positive
robust	positive
frostsicher	positive
bombensicher	positive
kleidsam	positive
rot glühend	positive
rotglühend	positive
duftig	positive
belastbar	positive
drollig	positive
lachhaft	negative
tragikomisch	negative
strömungsgünstig	positive
vorhersagbar	positive
wasserfest	positive
bestimmt	positive
beinhart	positive
eisenhart	positive
vorherbestimmt	positive
flügge	positive
stumpf	negative
eitrig	negative
wund	negative
widerrechtlich	negative
aufrichtig	positive
aufrecht	positive
demonstrativ	positive
provokant	positive
hervorgehoben	positive
emphatisch	positive
akzentuiert	positive
ausgeprägt	positive
ostentativ	positive
geländegängig	positive
zumutbar	positive
aushaltbar	positive
unhaltbar	negative
untragbar	negative
augenschädigend	negative
augenschädlich	negative
klimaschädigend	negative
eilfertig	positive
betriebsam	positive
geschäftig	positive
beflissen	positive
übereifrig	positive
servil	positive
diensteifrig	positive
tatkräftig	positive
agil	positive
blind	negative
fest	positive
strapazierfähig	positive
zukunftsfähig	positive
lagerfähig	positive
marktfähig	positive
feuerfest	positive
plump	negative
feingemahlen	positive
hitzestabil	positive
formstabil	positive
wertstabil	positive
thermostabil	positive
richtungsstabil	positive
unfähig	negative
hartgesotten	positive
seelenruhig	positive
abgezockt	positive
kaltschnäuzig	positive
ausgekocht	positive
abgebrüht	positive
pflegebedürftig	negative
abhängig	negative
hilfsbedürftig	negative
hilfebedürftig	negative
hilfesuchend	negative
hilfe suchend	negative
anlehnungsbedürftig	negative
pflegeabhängig	negative
krude	negative
krud	negative
überhöht	positive
übermässig	positive
überzogen	positive
ertragbar	positive
expressiv	positive
ausdrucksstark	positive
erschreckend	positive
enttäuschend	positive
überraschend	positive
erstaunlich	positive
ausdrucksvoll	positive
verblüffend	positive
zurückhaltend	negative
einsehbar	positive
überprüfbar	positive
nachvollziehbar	positive
feurig	positive
temperamentvoll	positive
neonfarben	positive
leuchtendrot	positive
zerbeult	negative
betriebssicher	positive
rasend	positive
sportlich	positive
rechtschaffen	positive
prätentiös	negative
fraglos	positive
horrend	positive
liebreizend	positive
lieblich	positive
charismatisch	positive
verführerisch	positive
betörend	positive
unwiderstehlich	positive
begehrenswert	positive
charmant	positive
scharmant	positive
erhaben	positive
erklärlich	positive
erklärbar	positive
gesetzwidrig	negative
gelehrig	positive
risikobehaftet	negative
quick	positive
semiarid	negative
virtuos	positive
kunstfertig	positive
unfruchtbar	negative
arbeitsfreudig	positive
arbeitswillig	positive
mündelsicher	positive
verleumderisch	negative
eindrücklich	positive
furios	positive
ruhmreich	positive
löblich	positive
lobenswert	positive
rühmlich	positive
tadelnswert	negative
sträflich	negative
heissblütig	positive
leutselig	positive
mannigfaltig	positive
kugelsicher	positive
uniform	negative
gleichförmig	negative
kräftezehrend	positive
viskos	positive
unsicher	negative
hell	positive
verlottert	negative
verkommen	negative
unappetitlich	negative
ungepflegt	negative
schmuddelig	negative
vergammelt	negative
verlumpt	negative
lawinensicher	positive
geringwertig	negative
minderwertig	negative
reiflich	positive
ungehört	negative
ungesehen	negative
beachtet	positive
suspekt	positive
entspannend	positive
erholsam	positive
gesund	positive
gesundheitsförderlich	positive
gesundheitsdienlich	positive
fördernd	positive
förderlich	positive
hintersinnig	positive
wettbewerbsfähig	positive
konkurrenzfähig	positive
total	positive
völlig	positive
gänzlich	positive
geklärt	positive
kalt	positive
geil	positive
gefällig	positive
aussergewöhnlich	positive
originell	positive
kannibalisch	negative
schwankend	negative
unentschlossen	negative
unschlüssig	negative
irregeleitet	negative
verunsichert	negative
irritiert	negative
zaghaft	negative
wehruntauglich	negative
verkehrsuntauglich	negative
lebensunfähig	negative
fragil	positive
grob	negative
druckfest	positive
staubtrocken	negative
amourös	positive
leichtgängig	negative
kokett	positive
intersubjektiv	negative
ertragssicher	positive
erlebbar	positive
phlegmatisch	negative
federleicht	negative
luftig	negative
strapaziös	positive
explosionsgefährlich	negative
brandgefährlich	negative
verfassungswidrig	negative
ruinös	negative
angeberisch	negative
grossspurig	negative
grossmäulig	negative
prahlerisch	negative
reichverziert	positive
reich verziert	positive
heilsam	positive
unbedenklich	positive
probiotisch	positive
heilend	positive
kreativ	positive
schöpferisch	positive
phantasievoll	positive
fantasievoll	positive
erfinderisch	positive
übermächtig	positive
finanzstark	positive
finanzkräftig	positive
deterministisch	positive
ausgelaugt	negative
ausgepumpt	negative
ausgebrannt	negative
erschöpft	negative
luzid	positive
erstattungsfähig	positive
bewegungsunfähig	negative
schnippisch	negative
scharfzüngig	negative
zynisch	negative
höhnisch	negative
singbar	positive
unzerbrechlich	positive
hochherrschaftlich	positive
spannungsgeladen	positive
annehmbar	positive
hinnehmbar	positive
handlungsunfähig	negative
vertretbar	positive
stadtverträglich	positive
menschenverträglich	positive
gesellschaftsverträglich	positive
wirtschaftsverträglich	positive
sozialverträglich	positive
naturverträglich	positive
reibungslos	negative
problemfrei	negative
abriebfest	positive
unerlaubt	positive
schnoddrig	negative
freundlich	positive
imponierend	positive
imposant	positive
schwindelerregend	positive
schwindel erregend	positive
atemraubend	positive
atemberaubend	positive
nervenzerreissend	positive
prickelnd	positive
packend	positive
dramatisch	positive
offenbar	positive
unkontrollierbar	negative
einfach	negative
offenkundig	positive
gesetzt	positive
offensichtlich	positive
nass	positive
verboten	positive
manövrierunfähig	negative
reaktionsfähig	positive
lesbar	positive
blutig	negative
kampfstark	positive
unblutig	positive
zytotoxisch	negative
wirkmächtig	positive
morastig	positive
entbehrungsreich	positive
vehement	positive
schweisstreibend	positive
unzweifelhaft	positive
undurchlässig	positive
fabelhaft	positive
trinkbar	positive
weich	negative
zweifellos	positive
sonnig	positive
schablonenhaft	negative
einschätzbar	positive
voraussagbar	positive
mischbar	positive
geschützt	positive
bedroht	negative
zuverlässig	positive
vielversprechend	positive
aussichtsreich	positive
lohnenswert	positive
lohnend	positive
effektiv	positive
lohnabhängig	negative
zähflüssig	positive
relativ	negative
anrechnungsfähig	positive
beihilfefähig	positive
untadlig	positive
untadelig	positive
verstehbar	positive
kombinierbar	positive
inkonsequent	negative
fassbar	positive
einleuchtend	positive
erfassbar	positive
feinschmeckerisch	positive
kulinarisch	positive
autokratisch	positive
panzerbrechend	positive
glimpflich	positive
verbessernd	positive
perspektivreich	positive
wacklig	negative
inständig	positive
nutzbar	positive
risikoreich	negative
riskant	negative
müssig	negative
überflüssig	negative
luftgetrocknet	negative
leberschädigend	negative
gelöscht	negative
lebend	positive
trist	negative
trostlos	negative
würzig	positive
tendenziös	negative
parteiisch	negative
aktiv	positive
klotzig	negative
unverschuldet	positive
nieder	negative
existenzbedrohend	negative
mitreissend	positive
turbulent	positive
ungestüm	positive
desolat	negative
unstabil	negative
unverdaulich	negative
undicht	negative
bruchfest	positive
untrüglich	positive
bewundernswert	positive
naseweis	positive
kess	positive
ohnmächtig	negative
einflussreich	positive
unaussprechlich	negative
athletisch	positive
sportiv	positive
erotisch	positive
harsch	positive
gemeinschaftsschädigend	negative
gesellschaftsunfähig	negative
extrem	positive
radikal	positive
kaltherzig	positive
frenetisch	positive
schal	negative
inkarniert	positive
kriegsmüde	negative
lethargisch	negative
gegeben	positive
feststehend	positive
flugunfähig	negative
unerkannt	negative
ausgetrocknet	negative
nahrhaft	positive
grobschlächtig	negative
ungeschlacht	negative
erledigt	negative
verkehrsgünstig	positive
gesundheitsfördernd	positive
diebisch	negative
erklärt	positive
unübersehbar	positive
verdächtig	positive
markig	positive
hervorstechend	positive
markant	positive
prägnant	positive
spektakulär	positive
einprägsam	positive
hochzufrieden	positive
leberschädlich	negative
nervenschädigend	negative
nierenschädlich	negative
nierenschädigend	negative
lebenstüchtig	positive
untüchtig	negative
geschäftstüchtig	positive
schreiend	positive
letal	negative
gemeinverständlich	positive
phänomenal	positive
polemisch	negative
schwunghaft	positive
pedantisch	negative
penibel	positive
förmlich	negative
kreideweiss	negative
angewiesen	negative
feinkörnig	positive
unignorierbar	positive
vierschrötig	negative
ehrbar	positive
multipel	positive
schmeichelhaft	positive
verschorft	negative
entzündet	negative
eiternd	negative
vereitert	negative
beschreibbar	positive
blessiert	negative
lädiert	negative
menschenunwürdig	negative
bestialisch	negative
unmenschlich	negative
menschenverachtend	negative
inhuman	negative
preisgekrönt	positive
verwachsen	negative
formschön	positive
formvollendet	positive
unverbindlich	negative
überzeugt	positive
felsenfest	positive
hochwassergefährdet	negative
redlich	positive
ehrenwert	positive
hehr	positive
achtbar	positive
ruhmvoll	positive
glorreich	positive
umweltbelastend	negative
hochgefährlich	negative
knallhart	positive
arid	negative
gewiss	positive
verschwitzt	negative
verwahrlost	negative
unerbittlich	positive
unbarmherzig	negative
schockiert	negative
geschockt	negative
witterungsbeständig	positive
gediegen	positive
seriös	positive
würdevoll	positive
honorabel	positive
honett	positive
angeschlagen	negative
stimmungsvoll	positive
besinnlich	positive
todsicher	positive
unübertroffen	positive
unzerstörbar	positive
schwerverletzt	negative
waffenfähig	positive
tauglich	positive
klobig	negative
ratsuchend	negative
rat suchend	negative
unfein	negative
vielseitig	positive
ungefährdet	positive
würdelos	negative
konstruktiv	positive
fürsorglich	positive
klimaschädlich	negative
uneinholbar	positive
unerreicht	positive
marktbeherrschend	positive
unnachahmlich	positive
marktführend	positive
tanzbar	positive
theatralisch	positive
krankenhausreif	negative
schwerverwundet	negative
verwundet	negative
kalkweiss	negative
erlebnisreich	positive
kolloid	positive
kolloidal	positive
verehrungswürdig	positive
salomonisch	positive
larghetto	negative
toll	positive
gefahrvoll	negative
imperial	positive
allmächtig	positive
omnipotent	positive
tonangebend	positive
ausserstande	negative
arbeitsunfähig	negative
defensiv	positive
rege	positive
quirlig	positive
umtriebig	positive
verdammt	positive
unintelligent	negative
erkoren	positive
erlernbar	positive
aufgeweckt	positive
magnetisierbar	positive
bespielbar	positive
lebensbedrohend	negative
gekonnt	positive
rechtswidrig	negative
wirkungsmächtig	positive
nachteilig	negative
auserwählt	positive
prädestiniert	positive
auserkoren	positive
vorbestimmt	positive
spannungsreich	positive
ereignisreich	positive
zerbrechlich	positive
filigran	positive
jäh	positive
sichtlich	positive
erprobt	positive
bewährt	positive
probat	positive
eminent	positive
leidlich	positive
allgemeinverständlich	positive
erholungsbedürftig	negative
urlaubsreif	negative
groggy	negative
ausgepowert	negative
mitgenommen	negative
entkräftet	negative
abgespannt	negative
vollkommen	positive
wartungsarm	negative
bindig	positive
unverfroren	negative
impertinent	negative
lautstark	negative
unverschämt	negative
vorlaut	negative
vollmundig	negative
ungezogen	negative
undankbar	negative
grosskotzig	negative
sanftmütig	positive
gedeihlich	positive
honorig	positive
nervenschädlich	negative
geniessbar	positive
bekömmlich	positive
ungiftig	positive
essbar	positive
ungeniessbar	negative
verdaulich	positive
unbekömmlich	negative
umweltverträglich	positive
kongenial	positive
gewitzt	positive
gewieft	positive
unschwer	negative
banal	negative
manifest	positive
trivial	negative
eloquent	positive
beredsam	positive
wortgewandt	positive
wortgewaltig	positive
wortreich	positive
festgefügt	positive
unbrennbar	positive
belastungsfähig	positive
abzugsfähig	positive
spöttisch	negative
spitzfindig	negative
missbräuchlich	positive
dienlich	positive
passabel	positive
magenverträglich	positive
hautverträglich	positive
involviert	negative
mühevoll	positive
stressig	positive
anstrengend	positive
lichtbeständig	positive
wässerig	negative
malerisch	positive
aberwitzig	negative
irrwitzig	negative
entscheidbar	positive
abenteuerlich	positive
aufsehenerregend	positive
aufsehen erregend	positive
faulig	negative
verfault	negative
hochgiftig	negative
tragfähig	positive
druckfähig	positive
friedfertig	positive
umgänglich	positive
preisstabil	positive
tödlich	negative
lebensbedrohlich	negative
lebensgefährlich	negative
säuerlich	negative
trocken-kalt	negative
super	positive
top	positive
erfolgsverwöhnt	positive
erfolgsgewöhnt	positive
siegreich	positive
fündig	positive
wohlgesonnen	positive
wohlgesinnt	positive
gesinnt	positive
freundschaftlich	positive
kameradschaftlich	positive
partnerschaftlich	positive
kumpelhaft	positive
schlammig	positive
dickflüssig	positive
zweifelsfrei	positive
börsenfähig	positive
jovial	positive
kollegial	positive
menschenwürdig	positive
menschenfreundlich	positive
umsatzstark	positive
unbezweifelbar	positive
melodramatisch	positive
autokephal	positive
hochadelig	positive
verantwortbar	positive
standhaft	positive
integer	positive
charakterfest	positive
avantgardistisch	positive
primitiv	negative
simpel	negative
sinnfällig	negative
aquarellfarben	positive
weiss	negative
pastellig	positive
pastell	positive
pastellfarben	positive
begünstigend	positive
mildernd	positive
autonom	positive
autark	positive
parteiunabhängig	positive
temperaturabhängig	negative
zeitabhängig	negative
abgestanden	negative
untalentiert	negative
schöngeistig	positive
wartungsfreundlich	positive
beredt	positive
läppisch	negative
nichtig	negative
multitaskingfähig	positive
haftunfähig	negative
treu sorgend	positive
treusorgend	positive
übersehbar	positive
heterotroph	negative
milliardenschwer	positive
frei	positive
deutbar	positive
verarbeitbar	positive
inbrünstig	positive
besessen	positive
reserviert	negative
schüchtern	negative
ungeschrieben	positive
zurückgezogen	negative
spröde	negative
spröd	negative
eindeutig	positive
zugeknöpft	positive
stocksteif	positive
unbefleckt	positive
subtil	positive
abgründig	positive
kleinadelig	positive
kleinadlig	positive
leck	negative
löchrig	negative
alltagstauglich	positive
praxistauglich	positive
flugtauglich	positive
geländetauglich	positive
kriegstauglich	positive
diensttauglich	positive
fahrtauglich	positive
erweiterbar	positive
ausbaufähig	positive
erneuerbar	positive
renovierbar	positive
instandsetzbar	positive
verwertbar	positive
königlich	positive
feudalistisch	positive
feudal	positive
höfisch	positive
warmherzig	negative
mausetot	negative
abbauwürdig	positive
beleuchtet	positive
erleuchtet	positive
unaufdringlich	negative
rechtsextrem	positive
rechtsextremistisch	positive
linksextremistisch	positive
rechtsradikal	positive
kältebeständig	positive
hitzebeständig	positive
wetterfest	positive
kochfest	positive
komfortabel	positive
wohltuend	positive
bequem	positive
zufriedenstellend	positive
unangenehm	negative
wohlig	positive
befriedigend	positive
etherisch	negative
grellfarbig	positive
grellfarben	positive
pastellfarbig	positive
tragbar	positive
hochglänzend	positive
steuergünstig	positive
soft	negative
wichtig	positive
blank	positive
nachprüfbar	positive
unelastisch	positive
zweifelnd	negative
seelsorglich	positive
strahlend	negative
glückstrahlend	positive
haltbar	positive
überglücklich	positive
seelig	positive
ozonschädigend	negative
ozonschädlich	negative
fahrtüchtig	positive
homoerotisch	positive
definierbar	positive
unflexibel	positive
unbeweglich	positive
starr	positive
regierungsfähig	positive
erstrangig	positive
warm	negative
sperrig	negative
unpraktisch	negative
vielfältig	positive
wohltätig	positive
caritativ	positive
karitativ	positive
leistungsstark	positive
leistungsfördernd	positive
raffiniert	positive
ausgebufft	positive
profund	positive
zweitklassig	negative
seelsorgerisch	positive
seelsorgerlich	positive
marktreif	positive
spitz	negative
grundsolide	positive
grundsolid	positive
wachstumsfördernd	positive
durchscheinend	positive
skandalös	positive
schockierend	positive
belebt	positive
ziemlich	positive
trittsicher	positive
distanziert	negative
millionenschwer	positive
nachmessbar	positive
neongrün	positive
farbecht	positive
dick	positive
repressiv	positive
unterdrückerisch	positive
drastisch	positive
drakonisch	positive
strikt	positive
schalldicht	positive
lichtundurchlässig	positive
wasserundurchlässig	positive
doll	positive
rennend	positive
gelähmt	negative
paralysiert	negative
finit	positive
allerbeste	positive
lichtdurchflutet	positive
totgeboren	negative
semipermeabel	negative
temperaturbeständig	positive
wechselseitig	positive
fruchtbar	positive
unternehmungslustig	positive
workoholic	negative
befestigt	positive
wehrhaft	positive
human	positive
unhandlich	negative
glanzvoll	positive
glänzend	positive
elendig	negative
billig	positive
einnehmend	positive
gewinnend	positive
verkaufsfördernd	positive
säurefest	positive
unerreichbar	positive
abhörsicher	positive
unscharf	negative
alkoholabhängig	negative
alkoholsüchtig	negative
trunksüchtig	negative
süchtig	negative
drogenabhängig	negative
drogensüchtig	negative
rauschgiftsüchtig	negative
strähnig	negative
ölig	negative
fettig	negative
luftdurchlässig	negative
beispielgebend	positive
elend	negative
erbärmlich	negative
allbekannt	positive
anpassbar	positive
menschenscheu	negative
umgelegt	negative
gesundheitsabträglich	negative
wohlbehütet	positive
auserlesen	positive
ausgesucht	positive
erlaucht	positive
handlungsfähig	positive
panisch	negative
panikartig	negative
unteilbar	negative
bereinigt	positive
cool	positive
inquisitorisch	positive
fähig	positive
unerprobt	negative
zerlumpt	negative
kampferfahren	positive
krisenerfahren	positive
unbewährt	negative
kampferprobt	positive
krisenerprobt	positive
schwanzgesteuert	positive
sexgierig	positive
sexhungrig	positive
lüstern	positive
heiss	negative
frigide	positive
frigid	negative
kundenfreundlich	positive
hilfsbereit	positive
abstinent	positive
entsagend	positive
entsagungsvoll	positive
hochadlig	positive
energiegeladen	positive
lichtecht	positive
verdient	positive
würdig	positive
verdienstvoll	positive
wehrdienstfähig	positive
wehrtauglich	positive
lebensfähig	positive
dicht	positive
eigen	negative
determiniert	positive
schicksalhaft	positive
karmisch	positive
bucklig	negative
buckelig	negative
aktionistisch	positive
silbrig	positive
bedienbar	positive
munter	positive
schwer	positive
gasundurchlässig	positive
lichtdurchlässig	negative
entzündungshemmend	positive
umschrieben	positive
unruhig	positive
korrosionsbeständig	positive
abgeschieden	negative
antibiotisch	positive
hieratisch	positive
sonnenbeschienen	positive
benutzbar	positive
produktiv	positive
preisgünstig	positive
kostengünstig	positive
preiswert	positive
finanzierbar	positive
bezahlbar	positive
rechtsfähig	positive
auswertbar	positive
ungewiss	negative
praktikabel	positive
aufnahmefähig	positive
investitionsfreundlich	positive
beleidigend	negative
ausfallend	negative
sarkastisch	negative
ironisch	negative
alterungsbeständig	positive
konjunkturverträglich	positive
pflanzenverträglich	positive
klimaverträglich	positive
landschaftsverträglich	positive
unbestimmt	negative
unvollkommen	negative
qualvoll	negative
belebend	positive
aktivierend	positive
flach	negative
platt	negative
seicht	negative
dümmlich	negative
pikant	positive
deklamatorisch	positive
ungeklärt	negative
distinguiert	positive
kaltblütig	positive
rein	positive
erlaubt	negative
internetfähig	positive
netzwerkfähig	positive
auslesbar	positive
ablesbar	positive
hirntot	negative
speicherbar	positive
flugfähig	positive
frequenzabhängig	negative
ritterlich	positive
ernsthaft	positive
minderbemittelt	negative
minderbegabt	negative
wohlfeil	negative
mühsam	positive
mühselig	positive
beschwerlich	positive
blödsinnig	negative
glückselig	positive
findig	positive
luftdicht	positive
arbeitsunwillig	negative
unlesbar	negative
fresssüchtig	negative
esssüchtig	negative
planbar	positive
drittklassig	negative
klümperig	positive
klümprig	positive
haftfähig	positive
kompromissfähig	positive
feindlich	negative
feuchtkalt	positive
hoch	positive
aufladbar	positive
vorbestraft	negative
denkmalgeschützt	positive
ungeschützt	negative
abgeschirmt	positive
ungesichert	negative
handlich	positive
förderungswürdig	positive
verlockend	positive
verheissungsvoll	positive
viertklassig	negative
erfolgsabhängig	negative
kontextabhängig	negative
ortsabhängig	negative
einkommensabhängig	negative
ortsunabhängig	positive
zeitunabhängig	positive
leistungsabhängig	negative
flüssig	negative
hautfreundlich	positive
verhältnismässig	negative
heillos	negative
kopflos	negative
uferlos	negative
bedenklich	negative
beziehungsunfähig	negative
hochseetüchtig	positive
betulich	positive
gasdicht	positive
halbherzig	negative
messbar	positive
schlicht	negative
unprätentiös	positive
nennbar	positive
wählbar	positive
benennbar	positive
maschinenlesbar	positive
musterhaft	positive
zukunftsweisend	positive
zukunftweisend	positive
wegweisend	positive
zukunftsträchtig	positive
locker	negative
winterlich	positive
herbstlich	positive
unbrauchbar	negative
abrufbar	positive
zugreifbar	positive
erschliessbar	positive
abbaubar	positive
doktrinär	positive
nervenaufreibend	positive
bürgerlich	negative
gestorben	negative
verstorben	negative
entseelt	negative
verschieden	negative
exzessiv	positive
ideologisch	positive
dogmatisch	positive
altadlig	positive
altadelig	positive
grell	positive
lichterloh	positive
windgeschützt	positive
linkslastig	negative
rechtslastig	negative
rangnieder	negative
unsittlich	negative
leserfreundlich	positive
wasserdicht	positive
luft- und wasserdicht	positive
lichtstark	positive
geruhsam	positive
umwerfend	positive
frappierend	positive
behaglich	positive
gemütlich	positive
menschlich	positive
loh	positive
royal	positive
fürstlich	positive
kaiserlich	positive
seetüchtig	positive
stimulierend	positive
blumig	positive
bunt	positive
schimmernd	positive
changierend	positive
schillernd	positive
goldglänzend	positive
unaufrichtig	negative
unredlich	negative
linksextrem	positive
linksradikal	positive
diktatorisch	positive
totalitär	positive
abgrundtief	negative
leidenschaftlich	positive
krass	positive
ungelenk	positive
ungelenkig	positive
hölzern	positive
holprig	positive
staksig	positive
wehrfähig	positive
eisig	positive
sumpfig	positive
schuldunfähig	negative
ehrlich	positive
frohgestimmt	positive
froh gestimmt	positive
ungetrübt	positive
putzsüchtig	negative
preiswürdig	positive
messerscharf	positive
lebensuntüchtig	negative
unproduktiv	negative
wasserdurchlässig	negative
herzhaft	positive
unüberhörbar	positive
standesherrlich	positive
grobkörnig	negative
berufsunfähig	negative
unangebracht	negative
zugänglich	positive
fahl	negative
situativ	negative
situationsabhängig	negative
entgeistert	negative
fassungslos	negative
entsetzt	negative
starrköpfig	positive
gestreng	positive
rigide	positive
rigid	positive
rigoros	positive
reizend	positive
übrig	positive
verschoben	negative
fälschungssicher	positive
kopiergeschützt	positive
verbindlich	positive
feingeistig	positive
fantasielos	negative
phantasielos	negative
ehrsam	positive
energisch	positive
scharfkantig	positive
abgerissen	negative
gammelig	negative
gammlig	negative
lumpig	negative
emanzipiert	positive
nervenstark	positive
initiativ	positive
wechselfeucht	positive
exoterisch	positive
verkehrssicher	positive
verkehrstauglich	positive
heil	positive
sexsüchtig	negative
tablettensüchtig	negative
medikamentenabhängig	negative
verschwendungssüchtig	negative
kaufsüchtig	negative
internetsüchtig	negative
fernsehsüchtig	negative
arbeitssüchtig	negative
spielsüchtig	negative
geschworen	positive
standfest	positive
blutverschmiert	negative
wirkungsreich	positive
selbstmörderisch	negative
kontaktarm	negative
behilflich	positive
wohlwollend	positive
gutgemeint	positive
behütend	positive
schützend	positive
wohlmeinend	positive
unilateral	negative
eingleisig	negative
unschicklich	negative
unseriös	negative
winterfest	positive
leserlich	positive
spottbillig	positive
feil	positive
eisigkalt	positive
zeugungsunfähig	negative
potent	positive
humid	positive
enthaltsam	positive
keusch	positive
damenhaft	positive
tollwütig	positive
skandalumwittert	positive
unschlagbar	positive
machtlos	negative
unbesiegbar	positive
imstande	positive
beschlussfähig	positive
mehrheitsfähig	positive
wandlungsfähig	positive
anpassungsfähig	positive
einsatzfähig	positive
arbeitsfähig	positive
verzagt	positive
zögerlich	positive
zauderhaft	positive
wasserunlöslich	negative
fertig	negative
mittelschwer	positive
reissfest	positive
erschwinglich	positive
antiphlogistisch	positive
unbegabt	negative
hochdramatisch	positive
armselig	negative
aufgebraucht	negative
ausersehen	positive
wässrig	negative
gewinnbar	positive
ungekocht	negative
aufrührerisch	positive
aufwieglerisch	positive
niederrangig	negative
pastos	positive
akut	positive
vordringlich	positive
gestalterisch	positive
bildnerisch	positive
altbewährt	positive
traditionsreich	positive
ausgereift	positive
zierlich	positive
hilfreich	positive
feuchtwarm	positive
wohlerzogen	positive
ersichtlich	positive
magenfreundlich	positive
bedienungsfreundlich	positive
adaptiv	positive
eiskalt	positive
ermunternd	positive
feucht	positive
kontrollierbar	positive
experimentierfreudig	positive
löslich	positive
diesig-kalt	positive
erweiterungsfähig	positive
regenerationsfähig	positive
gehfähig	positive
kontextsensitiv	negative
angebbar	positive
bravourös	positive
marktschreierisch	negative
vorwitzig	positive
marktgerecht	positive
breiig	positive
unterstützend	positive
subsidiär	positive
völkerrechtswidrig	negative
mannschaftstauglich	positive
mannschaftsdienlich	positive
menschenfeindlich	negative
unzurechnungsfähig	negative
megascharf	positive
anerkennenswert	positive
skandalträchtig	positive
matschig	positive
nasskalt	positive
frostig	positive
mildtätig	positive
schutzfähig	positive
kampfunfähig	negative
streichfähig	negative
anbaufähig	positive
immobil	positive
exemplarisch	positive
luftundurchlässig	positive
gefährdend	negative
gewagt	negative
verknallt	negative
süsslich	positive
zuckersüss	positive
ortsfest	positive
zweitbeste	positive
ungeschlagen	positive
unbesiegt	positive
klumpig	positive
eingedickt	positive
schleimig	positive
geronnen	positive
sämig	positive
freiherrlich	positive
fleischgeworden	positive
fleisch geworden	positive
kaiserlich-königlich	positive
erwerbsunfähig	negative
dienstunfähig	negative
philanthropisch	positive
humanitär	positive
spielend	negative
gefeit	positive
flagrant	positive
farbenreich	positive
wiedererkennbar	positive
überschaubar	positive
übersichtlich	positive
bleischwer	positive
schwarz	negative
weisslich	negative
mietfrei	positive
gedämpft	negative
feuerflüssig	negative
schmelzflüssig	negative
leichtflüssig	negative
kabarettistisch	positive
ambivalent	negative
verschwommen	negative
begehbar	positive
flauschig	negative
eben	negative
stachelig	negative
stachlig	negative
strafmildernd	positive
strafsenkend	positive
unkomfortabel	negative
deckenhoch	positive
wadenhoch	positive
brusthoch	positive
dünn	negative
zwanglos	positive
metamorph	positive
marxistisch-leninistisch	positive
gebührenfrei	positive
brüchig	negative
fluffig	negative
porös	negative
mehlig	negative
rau	negative
konfliktgeladen	positive
bedeutsam	positive
bedeutungsvoll	positive
zentral	positive
unwichtig	negative
kritikfähig	positive
leidensfähig	positive
dialogfähig	positive
erforderlich	positive
atmungsaktiv	negative
hoch dosiert	positive
hochdosiert	positive
hochkonzentriert	positive
staatsbürgerlich	negative
identifizierbar	positive
unbesetzt	positive
unbelegt	positive
traurig	negative
undogmatisch	negative
farbig	positive
braun	positive
verdruckst	negative
unvorstellbar	negative
signifikant	positive
undefiniert	negative
glasig	negative
gesucht	positive
lebensbejahend	positive
lebenslustig	positive
lebensfroh	positive
heilfroh	positive
schmalzig	negative
ekel erregend	negative
ekelerregend	negative
ekelhaft	negative
konfessionsverschieden	negative
dreifarbig	positive
vierfarbig	positive
starkfarbig	positive
rüpelhaft	negative
verschiedenfarbig	positive
darstellerisch	positive
unerlässlich	positive
schneeweiss	negative
betriebsbereit	negative
schummrig	negative
halbdunkel	negative
schummerig	negative
unbeleuchtet	negative
fiebrig	positive
polymorph	negative
aufdringlich	positive
distanzlos	positive
ausschweifend	positive
kühl	positive
unbequem	negative
unbefriedigend	negative
einladend	positive
unverkennbar	positive
unverwechselbar	positive
hochwürdig	positive
paarungswillig	negative
buntfarbig	positive
different	negative
knallbunt	positive
poppig	positive
gemustert	positive
regenerativ	positive
blitzeblank	positive
blitzblank	positive
blankgeputzt	positive
gewienert	positive
grauweiss	negative
ungeschliffen	negative
unverdorben	positive
druckreif	negative
verschlagen	negative
zweiflerisch	negative
link	negative
abenteuerlustig	positive
befremdlich	negative
beängstigend	negative
primär	positive
vorherrschend	positive
herrschend	positive
entscheidend	positive
schwer wiegend	positive
schwerwiegend	positive
aufgelöst	positive
hektisch	positive
fieberhaft	positive
wohnlich	positive
pünktlich	positive
verschwiegen	positive
kampffähig	positive
gebrauchsfähig	positive
basal	positive
antideutsch	negative
deutschfeindlich	negative
schwarz-weiss-rot	positive
inhomogen	negative
bedeutend	positive
wassergekühlt	positive
intrigant	negative
zweitwichtigste	positive
pluralistisch	positive
bauchig	positive
betretbar	positive
ungehindert	positive
passierbar	positive
befahrbar	positive
gasgekühlt	positive
frank	positive
flaumig	negative
fertil	positive
bengalisch	positive
unsanft	negative
unflätig	negative
formell	positive
unzuverlässig	negative
biegsam	negative
gelenkig	negative
flexibel	negative
beweglich	negative
mobil	negative
elastisch	negative
notwendig	positive
essenzial	positive
essential	positive
schwarzrotgolden	positive
schwarz-rot-golden	positive
unbelebt	negative
erwähnenswert	positive
wichtigst	positive
nennenswert	positive
erheblich	positive
gehörig	positive
unmusikalisch	negative
lustfeindlich	negative
israelfeindlich	negative
kaiserfeindlich	negative
männerfeindlich	negative
christenfeindlich	negative
demokratiefeindlich	negative
parteifeindlich	negative
religionsfeindlich	negative
minderheitenfeindlich	negative
regimefeindlich	negative
dynamisch	positive
waschecht	positive
mundgerecht	positive
übergewichtig	positive
schwergewichtig	positive
wohlbeleibt	positive
wohl beleibt	positive
einschneidend	positive
massiv	positive
orthodox	positive
ungeniert	positive
evolutionistisch	positive
sublim	positive
grellbunt	positive
hellfarben	positive
beitragsfrei	positive
hyperaktiv	positive
erreichbar	negative
gegenseitig	positive
nervig	negative
hermetisch	positive
glück bringend	positive
glückbringend	positive
heil bringed	positive
heilbringend	positive
blaugrün	positive
türkisfarben	positive
grau	positive
arbeitsscheu	negative
sortenrein	positive
kitschig	positive
fixiert	positive
indefinit	negative
unbewacht	positive
wesentlich	positive
lyrisch	positive
regelbar	positive
krank	negative
massgerecht	positive
naturgetreu	positive
stimmig	positive
abgestimmt	positive
undurchsichtig	positive
heroinabhängig	negative
kokainsüchtig	negative
heroinsüchtig	negative
kümmerlich	negative
jämmerlich	negative
melancholisch	negative
bekümmert	negative
wehmütig	negative
deprimiert	negative
dornenreich	positive
kardinal	positive
unvorhersehbar	negative
verschämt	negative
unzweideutig	positive
flugbereit	negative
bestimmbar	positive
volksfeindlich	negative
geistfeindlich	negative
esoterisch	negative
staatsgefährdend	negative
statisch	positive
gesittet	positive
prüde	positive
vieldeutig	negative
kostenfrei	positive
unentgeltlich	positive
salopp	positive
verspielt	positive
spielerisch	positive
allgemeinverbindlich	positive
allgemein verbindlich	positive
übermannshoch	positive
knöchelhoch	positive
halbhoch	positive
kniehoch	positive
meterhoch	positive
mannshoch	positive
ranghoch	positive
todtraurig	negative
todunglücklich	negative
einsam	negative
bedrückt	negative
reumütig	negative
allein	negative
unbehindert	positive
fortpflanzungsfähig	positive
rezeptiv	positive
zeugungsfähig	positive
superwichtig	positive
hochwichtig	positive
kriegswichtig	positive
überlebenswichtig	positive
pantomimisch	positive
durchbrochen	negative
nervös	positive
wassergefährdend	negative
konfliktträchtig	positive
offen	positive
heterogen	negative
gleich	positive
wattiert	positive
dicklagig	positive
mehrschichtig	positive
volkseigen	negative
körpereigen	negative
körperimmanent	negative
ureigenst	negative
landeseigen	negative
staatseigen	negative
hauseigen	negative
bundeseigen	negative
entfernt	negative
abgelegen	negative
erleichtert	positive
elegisch	negative
morbid	negative
naturfarben	positive
benutzerfreundlich	positive
anwenderfreundlich	positive
regenbogenfarben	positive
zerlegbar	positive
handwarm	negative
zimmerwarm	negative
hysterisch	positive
hypernervös	positive
notorisch	positive
zweithöchste	positive
wiederaufladbar	positive
dritthöchste	positive
allerhöchste	positive
überfallartig	positive
lichtarm	negative
klangvoll	positive
empfindungsfähig	positive
xenophob	negative
arteigen	negative
werkeigen	negative
werkseigen	negative
unternehmenseigen	negative
konzerneigen	negative
betriebseigen	negative
leibeigen	negative
gerichtsverwertbar	positive
tiefdunkel	negative
polychrom	positive
eineindeutig	positive
opiumsüchtig	negative
zurechnungsfähig	positive
halb	negative
notbehelfsmässig	negative
unvollständig	negative
lückenhaft	negative
einsatzbereit	negative
dienstbereit	negative
notdürftig	negative
defizitär	negative
erlabend	positive
vermutlich	negative
eventuell	negative
etwaig	negative
derb	negative
wahnwitzig	negative
andersgeartet	negative
unkeusch	negative
handhabbar	positive
stoned	positive
bekifft	positive
hypothetisch	negative
wechselwarm	positive
wohlgenährt	positive
wohl genährt	positive
wolkig	negative
sommerlich-sonnig	positive
serienreif	positive
pur	positive
gestattet	negative
schuldfähig	positive
unleserlich	negative
kenntlich	positive
erfahrbar	positive
recherchierbar	positive
deutlich	positive
nachrüstbar	positive
schmelzbar	positive
ehrverletzend	negative
leistungsfähig	positive
datierbar	positive
schmierig	negative
überschwer	positive
konfliktreich	positive
verlagseigen	negative
dankbar	positive
kompostierbar	positive
ausländerfeindlich	negative
fremdenfeindlich	negative
frauenfeindlich	negative
rassistisch	negative
umweltfeindlich	negative
verfassungsfeindlich	negative
zelleigen	negative
dumpf	negative
freizeitorientiert	positive
urbar	positive
besinnungslos	negative
zeichnerisch	positive
unfertig	positive
mild	negative
regnerisch	positive
bindungsfähig	positive
denkfähig	positive
feindselig	negative
feindschaftlich	negative
zölibatär	positive
luftgekühlt	positive
merkbar	positive
deftig	positive
andersfarbig	positive
gross	positive
üppig	positive
blumenreich	positive
technikfeindlich	negative
uni	positive
einfarbig	positive
monochrom	positive
steuerbar	positive
weissgetüncht	positive
bullerig	positive
feist	positive
bullig	positive
fett	positive
fettleibig	positive
vollschlank	positive
füllig	positive
barock	positive
freiwillig	positive
unbefangen	positive
dünnflüssig	negative
los	negative
lose	negative
schlabbrig	negative
schlabberig	negative
teilweise	negative
partiell	negative
teamfähig	positive
aktionsfähig	positive
ausdrucksfähig	positive
einsichtsfähig	positive
urteilsfähig	positive
gebrauchsfertig	negative
gleichfarbig	positive
zitierbar	positive
froh	positive
reziprok	positive
erfrischend	positive
teilrechtsfähig	positive
pigmentiert	positive
dickwanstig	positive
dickbäuchig	positive
kompakt	positive
befangen	negative
unversehrt	positive
gesundet	positive
verheilt	positive
geistesklar	positive
genesen	positive
sommerlich	negative
föhnig	negative
grundlegend	positive
fundamental	positive
elementar	positive
hochwüchsig	positive
druckfertig	negative
abgedroschen	negative
gutbürgerlich	negative
kleinbürgerlich	negative
spiessig	negative
spiesserhaft	negative
spiesserisch	negative
allerlei	positive
viele	positive
gemässigt	negative
freudlos	negative
bürokratisch	positive
fanatisch	positive
extremistisch	positive
fundamentalistisch	positive
technokratisch	positive
duster	negative
finster	negative
wohlverdient	positive
scheinbar	negative
raubeinig	negative
schutzwürdig	positive
verdorben	negative
sittenlos	negative
unmoralisch	negative
väterlich	positive
mütterlich	positive
abgewirtschaftet	negative
abgegriffen	negative
heruntergewirtschaftet	negative
heimelig	positive
segensreich	positive
überwältigend	positive
vorrangig	positive
hauptsächlich	positive
essenziell	positive
essentiell	positive
grundsätzlich	positive
massgeblich	positive
sexistisch	positive
majestätisch	positive
fingerdick	positive
halbfertig	negative
sachfremd	negative
kunterbunt	positive
farbenfroh	positive
farbenprächtig	positive
vielfarbig	positive
mehrfarbig	positive
fahrbereit	negative
knallig	positive
immanent	negative
disparat	negative
lügnerisch	negative
verlogen	negative
falsch	negative
unehrlich	negative
tief	positive
steil	positive
erhöht	positive
erdrückend	negative
bedrückend	negative
belastend	negative
mulmig	negative
abstossend	negative
unsympathisch	negative
unbehaglich	negative
ungemütlich	negative
beklemmend	negative
lebensnotwendig	positive
lebenswichtig	positive
gewichtig	positive
gravierend	positive
flatterig	positive
wankelmütig	negative
sprunghaft	positive
unausgeglichen	positive
fruchtbringend	positive
entlegen	negative
humorlos	positive
erwerbsfähig	positive
lauwarm	negative
bewölkt	negative
überlebensfähig	positive
vertrauenswürdig	positive
massstäblich	positive
vergnügt	positive
unbezwingbar	positive
cremig	negative
gewaltbereit	negative
wissenswert	positive
baureif	negative
armdick	positive
gebührenlos	positive
grundverschieden	negative
schneidig	positive
staatstragend	positive
vielsagend	positive
unwägbar	negative
unkultiviert	negative
ruppig	negative
hochrein	positive
vielerlei	positive
ungelegen	negative
unpassend	negative
deplaziert	negative
deplatziert	negative
schwarzweiss	positive
aschfahl	negative
ergebnisoffen	negative
hochverdient	positive
unverantwortbar	negative
zweifarbig	positive
redebegabt	positive
redegewandt	positive
übrig geblieben	positive
übriggeblieben	positive
bezaubernd	positive
hinreissend	positive
zauberhaft	positive
entzückend	positive
bezückend	positive
restlich	positive
vorgezogen	positive
relevant	positive
künstlerisch	positive
vorrätig	positive
behindertenfeindlich	negative
wissenschaftsfeindlich	negative
reformfeindlich	negative
islamfeindlich	negative
kulturfeindlich	negative
leibfeindlich	negative
körperfeindlich	negative
verpflichtend	positive
unzertrennbar	positive
unzertrennlich	positive
bindend	positive
verlässlich	positive
chronisch	negative
lästig	negative
segenbringend	positive
segenspendend	positive
pfirsichfarben	positive
permissiv	negative
sanft	negative
asynchron	negative
grossbürgerlich	negative
spielfreudig	positive
vakant	positive
antiklerikal	negative
republikfeindlich	negative
mancherlei	positive
schwulenfeindlich	negative
regierungsfeindlich	negative
überzählig	positive
dunkelfarbig	positive
verbittert	negative
ergänzungsbedürftig	negative
klärungsbedürftig	negative
rüstig	positive
clean	positive
unverletzt	positive
treffend	positive
massgeschneidert	positive
trefflich	positive
metallfarben	positive
hautfarben	positive
fleischfarben	positive
türkis	positive
kokainabhängig	negative
kribbelig	positive
kribblig	positive
flatterhaft	positive
kerngesund	positive
quietschfidel	positive
hoch gelegen	positive
trübsinnig	negative
skalierbar	positive
unbunt	negative
hochstämmig	positive
cäsarisch	positive
multilateral	positive
bilateral	positive
beiderseitig	positive
schicklich	positive
lilienweiss	negative
grellweiss	negative
schlohweiss	negative
gelb	positive
falb	negative
gefangen	negative
ungeduldig	positive
unverzagt	negative
unverkrampft	positive
unbenutzbar	negative
mittelhoch	positive
raumhoch	positive
hüfthoch	positive
turmhoch	positive
unerschwinglich	negative
mordsmässig	positive
saumässig	positive
impotent	negative
kunstfeindlich	negative
gesellschaftsfeindlich	negative
bildungsfeindlich	negative
fortschrittsfeindlich	negative
unvermutet	positive
höflich	positive
sittsam	positive
kultivierbar	positive
schmiedbar	positive
ungleich	negative
divers	negative
verschiedenartig	negative
unähnlich	negative
andere	negative
öllöslich	positive
alkohollöslich	positive
fettlöslich	positive
schwerlöslich	positive
schwer löslich	positive
wasserlöslich	positive
ureigen	negative
leiblich	negative
startklar	negative
startfertig	negative
bereit	negative
beziehbar	negative
schlüsselfertig	negative
bezugsfertig	negative
kostenlos	positive
betroffen	negative
leidtragend	negative
leid tragend	negative
widersprüchlich	negative
mehrdeutig	negative
gespalten	negative
zwiespältig	negative
doppeldeutig	negative
janusköpfig	negative
adipös	positive
talentiert	positive
begabt	positive
befähigt	positive
lernfähig	positive
wertvoll	positive
kostbar	positive
teuer	negative
selbstironisch	negative
interpretierbar	positive
putzmunter	positive
bearbeitbar	positive
handstreichartig	positive
reinweiss	negative
cremeweiss	negative
mattweiss	negative
blütenweiss	negative
unzivilisiert	negative
tiefgekühlt	positive
spiessbürgerlich	negative
altehrwürdig	positive
ehrwürdig	positive
erhaltenswert	positive
bildhauerisch	positive
schriftstellerisch	positive
tänzerisch	positive
schauspielerisch	positive
dichterisch	positive
unausgereift	negative
unausgegoren	negative
unausgewogen	negative
gemeinfrei	positive
gebirgig	positive
isoliert	negative
vereinfacht	negative
schaltbar	positive
lupenrein	positive
unrein	negative
koscher	positive
steril	positive
keimfrei	positive
schamhaft	positive
anständig	positive
erkennbar	positive
kirchenfeindlich	negative
fügsam	positive
gefügig	positive
willfährig	positive
gehorsam	positive
vielgestaltig	negative
dahinterstehend	positive
bereitstehend	negative
rauchig	positive
tonnenschwer	positive
trutzig	positive
erquickend	positive
spekulativ	negative
kampfbereit	negative
vergnügungsorientiert	positive
unerwartet	positive
ungeahnt	positive
unverhofft	positive
unerahnt	positive
startbereit	negative
silberweiss	negative
einstellbar	positive
gelbweiss	negative
milchweiss	negative
morphiumsüchtig	negative
recyclingfähig	positive
wiederverwertbar	positive
monochromatisch	positive
milchig	negative
blickdicht	negative
opak	negative
jugendgefährdend	negative
montierbar	positive
schliessbar	positive
kuschlig	negative
kuschelig	negative
lauschig	positive
kontrastiv	negative
rechtsverbindlich	positive
anteilig	negative
rudimentär	negative
fragmentarisch	negative
bruchstückhaft	negative
bruchstückartig	negative
zweideutig	negative
familienfeindlich	negative
staatsfeindlich	negative
blau	positive
klamm	positive
hoch verschuldet	positive
hochverschuldet	positive
heteromorph	negative
regulierbar	positive
höchstmöglich	positive
allfällig	negative
frisch	positive
massstabsgetreu	positive
nasskühl	positive
charaktervoll	positive
spielfähig	positive
zahlungsfähig	positive
entwicklungsfähig	positive
paarungsbereit	negative
perlweiss	negative
gesundheitsgefährdend	negative
friedensgefährdend	negative
sicherheitsgefährdend	negative
unzüchtig	negative
unbestätigt	negative
beleibt	positive
voluminös	positive
rundlich	positive
aufgedunsen	positive
korpulent	positive
aufgetrieben	positive
dicklich	positive
mollig	positive
haushoch	positive
dienstfähig	positive
stadteigen	negative
bordeigen	negative
schuleigen	negative
vereinseigen	negative
gemeindeeigen	negative
firmeneigen	negative
brennend	positive
bildungsbürgerlich	negative
ruiniert	negative
tränenreich	negative
verkehrt	negative
unecht	negative
unrecht	negative
dienstbar	positive
unerfreulich	negative
schwermütig	negative
misslich	negative
rabenschwarz	negative
liquide	positive
liquid	positive
gesperrt	negative
furchteinflössend	negative
seidig	negative
uneben	positive
glatt	negative
entgegenkommend	positive
zentralnervös	positive
zuvorkommend	positive
schmal	negative
leichtgewichtig	negative
untergewichtig	negative
mager	negative
bereitwillig	positive
unaufgefordert	positive
willig	positive
grellgelb	positive
kanariengelb	positive
messinggelb	positive
knallgelb	positive
mattgelb	positive
plastisch	positive
festkochend	positive
unwirtlich	negative
tropisch	negative
lang	positive
zartgelb	positive
geisterhaft	negative
gespenstig	negative
grauenerregend	negative
grauen erregend	negative
gruselig	negative
schaurig	negative
schauerhaft	negative
schauerlich	negative
gespensterhaft	negative
gespenstisch	negative
marginal	negative
existential	positive
existenzial	positive
geboten	positive
ernstzunehmend	positive
hochprozentig	negative
licht	negative
besetzt	negative
belegt	negative
moderat	negative
wägbar	positive
handtellergross	positive
normalgross	positive
millimetergross	positive
handgross	positive
dunkelhäutig	positive
unbürokratisch	negative
kaffeebraun	positive
hellrot	positive
rostbraun	positive
rötlichbraun	positive
rostfarben	positive
orange	positive
orangefarben	positive
vorstellbar	positive
undenkbar	negative
überschuldet	positive
systemimmanent	negative
freiheitlich	positive
liberal	positive
weltoffen	positive
tolerant	positive
gehemmt	negative
unfreiwillig	negative
gezwungen	negative
verkrampft	negative
weissgelb	positive
grüngelb	positive
lauchgrün	positive
zartgrün	positive
lichtgrün	positive
strohgelb	positive
orangegelb	positive
lustbetont	positive
erlöst	positive
beruhigt	positive
fünftgrösste	positive
viertgrösste	positive
hünenhaft	positive
widerlich	negative
widerwärtig	negative
furcht erregend	negative
furchterregend	negative
fällig	positive
unvermeidbar	positive
unvermeidlich	positive
orangefarbig	positive
cremefarbig	positive
silberfarbig	positive
rosafarbig	positive
rostfarbig	positive
goldfarbig	positive
fragwürdig	negative
kalifornisch	negative
kategorisch	positive
unabdingbar	positive
dämmrig	negative
stockdunkel	negative
penetrant	positive
duktil	negative
hold	positive
lanciert	positive
zügellos	positive
verrucht	positive
blitzeblau	positive
schieferblau	positive
zartblau	positive
taubenblau	positive
graugrün	positive
gelbgrün	positive
eisblau	positive
blassgrün	positive
smaragdgrün	positive
offenstehend	positive
offen stehend	positive
unterkühlt	positive
isomorph	positive
fünfprozentig	negative
kennzeichnend	positive
bestimmend	positive
charakteristisch	positive
gangbar	positive
insolvent	positive
kariert	positive
aerodynamisch	positive
vertrauenerweckend	positive
vertrauen erweckend	positive
langgewachsen	positive
lang gewachsen	positive
hochgewachsen	positive
hoch gewachsen	positive
gross gewachsen	positive
grossgewachsen	positive
türkisblau	positive
grünblau	positive
blassblau	positive
graublau	positive
schwarzblau	positive
stahlblau	positive
kakaobraun	positive
unangemessen	negative
krüppelhaft	negative
krüppelig	negative
magersüchtig	negative
heiser	negative
unheilvoll	negative
unheilschwanger	negative
unheil verheissend	negative
unheilverheissend	negative
düster	negative
besorgniserregend	negative
schwerpunktmässig	positive
ausschlaggebend	positive
ruhig	negative
ausgeglichen	negative
pummelig	positive
heiter	positive
ausgelassen	positive
psychotisch	negative
zweischichtig	positive
richtungsweisend	positive
richtungweisend	positive
programmatisch	positive
zielweisend	positive
massgebend	positive
gleichlautend	positive
neuronal	positive
niveaugleich	positive
beträchtlich	positive
irregulär	negative
irrtümlich	negative
unrichtig	negative
unzutreffend	negative
fälschlich	negative
unwahr	negative
klar	positive
nebulös	negative
schwammig	negative
unpassierbar	negative
distal	negative
schütter	negative
spärlich	negative
todkrank	negative
informell	negative
unpünktlich	negative
säumig	negative
nachlässig	negative
rhythmisch	negative
betriebsfremd	positive
sekundär	negative
zweitrangig	negative
unbedeutend	negative
nebensächlich	negative
unbedeutsam	negative
umfangreich	positive
närrisch	positive
erklecklich	positive
naturalistisch	positive
anämisch	negative
erkältet	negative
unbekümmert	positive
safranfarben	positive
apricot	positive
bernsteinfarben	positive
magentafarben	positive
ungefragt	positive
ungeheissen	positive
aufgeschrieben	positive
dokumentiert	positive
festgehalten	positive
gleichgross	positive
akzidentiell	negative
akzidentell	negative
waagerecht	negative
waagrecht	negative
vertikal	negative
senkrecht	negative
diagonal	negative
verwunderlich	negative
wundersam	negative
wunderlich	negative
feldgrau	positive
stahlgrau	positive
kompositorisch	positive
kontaktierbar	negative
natürlich	positive
verdriesslich	negative
leidig	negative
anthrazitfarben	positive
anthrazit	positive
silbergrau	positive
aschgrau	positive
breit	positive
streifig	positive
verderbt	negative
afro-amerikanisch	positive
bemerkenswert	positive
lenkbar	positive
verschliessbar	positive
artgemäss	positive
kindgetreu	positive
artgerecht	positive
alkoholkrank	negative
linear	negative
grade	negative
kerzengerade	negative
kakifarben	positive
khakifarben	positive
khaki	positive
kaki	positive
dunkelgrün	positive
grasgrün	positive
unverdrossen	negative
sprachbegabt	positive
musikalisch	positive
geduldig	negative
gestresst	positive
kostenintensiv	negative
kostspielig	negative
beschämt	negative
treffsicher	positive
vorhersehbar	positive
grün	positive
rot	positive
chauvinistisch	positive
portofrei	positive
pharisäisch	negative
oliv	positive
olivfarben	positive
olivgrün	positive
schroff	positive
besondere	negative
aidskrank	negative
lungenkrank	negative
krebskrank	negative
herzkrank	negative
zuckerkrank	negative
gallenkrank	negative
leberkrank	negative
unentschieden	positive
ähnlich	positive
magenkrank	negative
komödiantisch	positive
mosaikartig	positive
inhaftiert	negative
unfrei	negative
eingefangen	negative
gefangengehalten	negative
widersinnig	negative
paradox	negative
neckisch	positive
vereinsamt	negative
verlassen	negative
unkorrekt	negative
schachbrettartig	positive
verklemmt	negative
tuberkulös	negative
steilwandig	positive
glattwandig	negative
zivil	negative
fremdbestimmt	negative
öffentlich	positive
deckungsgleich	positive
übereinkommend	positive
homogen	positive
identisch	positive
sonstig	negative
gleichartig	positive
offengelassen	positive
offen gelassen	positive
fern	negative
offen geblieben	positive
offengeblieben	positive
befreit	positive
lustvoll	positive
abschüssig	positive
undurchdringlich	positive
vernunftbegabt	positive
schwerkrank	negative
abschliessbar	positive
erbsengross	positive
hochpreisig	negative
frech	negative
brav	positive
artig	positive
olivgrau	positive
lichtgrau	positive
hechtgrau	positive
schwarzgrau	positive
schiefergrau	positive
weissgrau	positive
blaugrau	positive
orangen	positive
schiffbar	positive
gewohnheitsmässig	positive
breitschultrig	positive
breitkiefrig	positive
breithüftig	positive
unausdenkbar	negative
kontaminiert	negative
gepanscht	negative
verseucht	negative
spätsommerlich	negative
hochleistungsfähig	positive
folgsam	positive
ungehorsam	negative
orangerot	positive
scharlachrot	positive
rosarot	positive
purpurrot	positive
tiefrot	positive
dunkelrot	positive
rosafarben	positive
rosa	positive
rosig	positive
narrativ	positive
epoche machend	positive
epochemachend	positive
bitter	negative
grundfalsch	negative
beherrschbar	positive
festgebunden	positive
magenta	positive
giftgrün	positive
schlank	negative
rank	negative
goldgelb	positive
überdeutlich	positive
zinnoberrot	positive
rosenrot	positive
kupferrot	positive
kirschrot	positive
hochrot	positive
gleichgerichtet	positive
gleich gerichtet	positive
russschwarz	negative
braunschwarz	negative
elektrodynamisch	positive
ernst	negative
judenfeindlich	negative
antisemitisch	negative
verhaftet	negative
hochgelegen	positive
melodisch	positive
wohlklingend	positive
karg	negative
komatös	negative
dingfest	negative
festgefangen	negative
entführt	negative
lau	negative
menschengross	positive
grossväterlich	positive
schwülheiss	negative
gewittrig	positive
gewitterig	positive
wechselhaft-regnerisch	positive
interpretationsfähig	negative
trüb	negative
rustikal	negative
sentimental	negative
betrüblich	negative
zutreffend	positive
umweltfreundlich	positive
technikfreundlich	positive
texturiert	positive
geblümt	positive
marmoriert	positive
gemasert	positive
gefleckt	positive
gepunktet	positive
gesprenkelt	positive
fleckig	positive
dämmerig	negative
stockfinster	negative
blaurot	positive
stämmig	positive
beklommen	negative
betreten	negative
mürbe	negative
morsch	negative
mürb	negative
neunzigprozentig	negative
sechzigprozentig	negative
siebzigprozentig	negative
züchtig	positive
beunruhigend	negative
alptraumhaft	negative
alptraumartig	negative
unheimlich	negative
alarmierend	negative
ungeheuer	negative
schauderhaft	negative
schaudervoll	negative
unverzichtbar	positive
zwingend	positive
unbedingt	positive
obligatorisch	positive
nötig	positive
gescheckt	positive
exorbitant	positive
massig	positive
umgekehrt	negative
fröhlich	positive
erfreulich	positive
freudig	positive
unübersichtlich	negative
unüberschaubar	negative
abstrakt	positive
bräunlichrot	positive
rostrot	positive
blutrot	positive
kohlrabenschwarz	negative
pechschwarz	negative
kastanienrot	positive
rötlich	positive
knallrot	positive
rubinrot	positive
spritzig	positive
visumfrei	positive
erbkrank	negative
ultrakompakt	positive
vollbusig	positive
untersetzt	positive
entsprechend	positive
nämlich	positive
frivol	positive
anstössig	positive
sattgelb	positive
sonnengelb	positive
fahlgelb	positive
safrangelb	positive
lehmgelb	positive
buttergelb	positive
schwefelgelb	positive
blassgelb	positive
dottergelb	positive
honiggelb	positive
frühlingshaft	negative
hochsommerlich	negative
schrecken erregend	negative
schreckenerregend	negative
spukhaft	negative
angsterregend	negative
angst erregend	negative
entbehrlich	negative
verzichtbar	negative
unnötig	negative
bieder	negative
hausbacken	negative
bronzefarbig	positive
sandfarbig	positive
elfenbeinfarbig	negative
elfenbeinfarben	negative
bernsteinfarbig	positive
aprikosenfarben	positive
aprikosenfarbig	positive
viel	positive
zweitgrösste	positive
rauhaarig	negative
gleichsinnig	positive
alternativ	negative
massvoll	negative
ausgewogen	positive
enttäuscht	negative
trübselig	negative
betrübt	negative
tieftraurig	negative
deprimierend	negative
faustgross	positive
zappenduster	negative
bündig	negative
höhengleich	positive
trilateral	positive
luderhaft	negative
verwerflich	negative
unanständig	negative
verworfen	negative
schwarzgrün	positive
meergrün	positive
tiefgrün	positive
apfelgrün	positive
lindgrün	positive
mattgrün	positive
sattgrün	positive
goldgrün	positive
türkisgrün	positive
moosgrün	positive
weisend	positive
zehntgrösste	positive
neuntgrösste	positive
sechstgrösste	positive
flächengrösste	positive
siebtgrösste	positive
achtgrösste	positive
irrelevant	negative
unmassgeblich	negative
einschlägig	positive
unwesentlich	negative
illuster	positive
namenhaft	positive
klangschön	positive
denunziatorisch	negative
kongruent	positive
gleichgestellt	positive
anzüglich	positive
irrig	negative
straff	negative
werkimmanent	negative
höher gelegen	positive
höhergelegen	positive
geneigt	positive
direkt	positive
freimütig	positive
aufgeschlossen	positive
empfänglich	positive
extravertiert	positive
offenherzig	positive
heuchlerisch	negative
bigott	negative
scheinheilig	negative
kobaltblau	positive
lichtblau	positive
rotblau	positive
indigoblau	positive
kornblumenblau	positive
nachtblau	positive
saphirblau	positive
königsblau	positive
veilchenblau	positive
pflaumenblau	positive
schokoladenbraun	positive
wohltönend	positive
gelbbraun	positive
goldbraun	positive
graubraun	positive
rehbraun	positive
ockerbraun	positive
olivbraun	positive
tiefbraun	positive
geöffnet	positive
geschlossen	negative
existenziell	positive
existentiell	positive
dreilagig	positive
launenhaft	positive
kapriziös	positive
launisch	positive
beschaulich	positive
perlgrau	positive
taubengrau	positive
nebelgrau	positive
anthrazitgrau	positive
eisgrau	positive
fahlgrau	positive
steingrau	positive
rauchgrau	positive
mausgrau	positive
grüngrau	positive
analog	positive
schikanös	negative
humorvoll	negative
vorhanden	positive
gewürfelt	positive
halboffen	positive
obligat	positive
frauenfreundlich	positive
gewogen	positive
extrovertiert	positive
lotrecht	negative
kindgerecht	positive
kindgemäss	positive
sepiabraun	positive
erdbraun	positive
kupferbraun	positive
kackbraun	positive
quietschvergnügt	positive
schwindsüchtig	negative
angeblich	negative
vermeintlich	negative
gerade	negative
dehnbar	negative
neural	positive
inhaltsgleich	positive
baugleich	positive
wesensgleich	positive
namensgleich	positive
nussbraun	positive
angestrengt	negative
merklich	positive
bemerkbar	positive
feststellbar	positive
beachtenswert	positive
repräsentativ	positive
aussagekräftig	positive
aussagefähig	positive
prägend	positive
epochal	positive
vertrauensvoll	positive
riesenhaft	positive
riesig	positive
riesengross	positive
enorm	positive
unglaublich	positive
drall	positive
melodiös	positive
bewusstlos	negative
unverzeihlich	negative
unentschuldbar	negative
verantwortungslos	negative
unverantwortlich	negative
schnurgerade	negative
horizontal	negative
diabetisch	negative
delikat	negative
grösstmöglich	positive
grösste	positive
weltgross	positive
mittelgross	positive
vorweggenommen	positive
diskutabel	positive
beachtlich	positive
beachtbar	positive
orgiastisch	positive
gestreift	positive
unerheblich	negative
klein	negative
beobachtbar	positive
cremefarben	positive
beige	positive
beigefarben	positive
metallicgrau	positive
sandfarben	positive
erdfarben	positive
inadäquat	negative
verfehlt	negative
zeremoniell	positive
publik	positive
lebensgross	positive
übergross	positive
überlebensgross	positive
rauchfarben	positive
ungehemmt	positive
freisinnig	positive
kalkig	negative
gleichgesinnt	positive
vollwertig	positive
verhärtet	negative
vergrätzt	negative
vergrämt	negative
gleichberechtigt	positive
gleichalt	positive
kränklich	negative
hellgelb	positive
ebenbürtig	positive
lebensmüde	negative
silberfarben	positive
kupferfarben	positive
goldfarben	positive
bronzefarben	positive
galant	positive
geladen	positive
genervt	positive
disharmonisch	positive
gereizt	positive
verquer	positive
nervtötend	negative
notiert	positive
verbucht	positive
gebucht	positive
geheim	negative
bergreich	positive
thermodynamisch	positive
hydrodynamisch	positive
flächentreu	positive
nervlich	positive
polylateral	positive
hellbraun	positive
paritätisch	positive
kränkelnd	negative
gleichaltrig	positive
gleichnamig	positive
grünlich	positive
gleichwertig	positive
rund	positive
hellgrün	positive
violett	positive
veilchenfarben	positive
gelblich	positive
zitronengelb	positive
vollständig	positive
grauschwarz	negative
ungehalten	positive
unwirsch	positive
graulich	positive
schwärzlich	negative
dunkelgrau	positive
hellgrau	positive
dunkelgelb	positive
bläulich	positive
bräunlich	positive
aufwändig	negative
aufwendig	negative
untröstlich	negative
begossen	negative
gelackmeiert	negative
botmässig	positive
unverrückbar	positive
flächengross	positive
fahrbar	positive
salonfähig	positive
gesellschaftsfähig	positive
anderweitig	negative
unterschiedlich	negative
unterscheidbar	negative
arretiert	negative
bedröppelt	negative
unbezahlbar	negative
halbseiden	negative
zwielichtig	negative
musikbegabt	positive
hochbegabt	positive
hoch begabt	positive
stilbildend	positive
kunstvoll	positive
gemafrei	positive
kontrafaktisch	negative
homophob	negative
habituell	positive
kapital	positive
tennisballgross	positive
gebändert	positive
gleichrangig	positive
gleichbedeutend	positive
gleichgeschaltet	positive
nivelliert	positive
punktgleich	positive
nierenkrank	negative
drüsenkrank	negative
diskussionswürdig	positive
begrifflich	positive
haardünn	negative
hauchdünn	negative
überseeisch	negative
erzählerisch	positive
bergisch	positive
bergig	positive
gedrungen	positive
breitgesichtig	positive
drittgrösste	positive
verpanscht	negative
verschmutzt	negative
verunreinigt	negative
unhygienisch	negative
gefangengenommen	negative
gekidnapt	negative
lithografisch	positive
litographisch	positive
unerkennbar	negative
unorthodox	negative
bordeauxrot	positive
karmesinrot	positive
feuerrot	positive
karminrot	positive
ziegelrot	positive
braunrot	positive
weinrot	positive
gelbrot	positive
angebunden	positive
unbefestigt	negative
namhaft	positive
ehrrührig	negative
ehrenrührig	negative
sterbenskrank	negative
unverblümt	positive
maxi	positive
transparent	positive
undeutlich	negative
durchstimmbar	positive
verwechselbar	negative
gleichgeartet	positive
unverlangt	positive
weltbewegend	positive
differenzierbar	negative
fünfzigprozentig	negative
zwanzigprozentig	negative
dreissigprozentig	negative
zehnprozentig	negative
achtzigprozentig	negative
hellblau	positive
familienfreundlich	positive
kinderfeindlich	negative
ausländerfreundlich	positive
sattrot	positive
purpurfarben	positive
purpurfarbig	positive
dunkelblau	positive
tiefblau	positive
zimtfarben	positive
normativ	positive
knusprig	positive
knackig	positive
zimtfarbig	positive
lind	negative
kultiviert	positive
unverschlossen	positive
dortig	negative
geschrieben	positive
kunstreich	positive
schützenswert	positive
unbewohnbar	negative
schallgedämpft	negative
verkrüppelt	negative
gestört	negative
geistesgestört	negative
höchstgelegen	positive
festgenommen	negative
schier	positive
mannsgross	positive
bibliophil	positive
ungemein	positive
zahlungsunfähig	positive
bankrott	positive
abgebrannt	positive
ungezählt	positive
unzählig	positive
unermesslich	positive
immens	positive
prominent	positive
recht	positive
echt	positive
unabweisbar	positive
demoralisierend	negative
entmutigend	negative
bedauerlich	negative
schade	negative
unerquicklich	negative
bedauernswert	negative
lohnsteuerpflichtig	positive
mafiaähnlich	positive
haarähnlich	positive
goldähnlich	positive
fischähnlich	positive
sirupähnlich	positive
totenähnlich	positive
unklar	negative
runzelig	positive
runzlig	positive
intolerant	negative
dürr	negative
knochig	negative
hager	negative
schmächtig	negative
anstellig	positive
gesprächsbereit	positive
geständig	positive
übermütig	positive
knetbar	positive
modellierbar	positive
formbar	positive
subtropisch	negative
kleinkariert	negative
wolkenfrei	positive
holografisch	positive
abschlägig	negative
hiesig	positive
überbelegt	negative
übereinstimmend	positive
diskutierbar	positive
magmarot	positive
glühendrot	positive
feuchtheiss	negative
grundsteuerpflichtig	positive
erbschaftssteuerpflichtig	positive
körperschaftsteuerpflichtig	positive
körperschaftssteuerpflichtig	positive
ablehnend	negative
abweisend	negative
zurückweisend	negative
unwillig	negative
widerstrebend	negative
zähneknirschend	negative
widerwillig	negative
gertenschlank	negative
verkniffen	negative
bündnisgrün	positive
kilometerlang	positive
beschwingt	positive
unumgänglich	positive
unausweichlich	positive
zwangsläufig	positive
notgedrungen	positive
unaufhaltsam	positive
unaufhaltbar	positive
unweigerlich	positive
ockerfarbig	positive
wenig	negative
wesenhaft	positive
hochliegend	positive
pöbelhaft	negative
filzähnlich	positive
differenziert	positive
fraglich	negative
zweifelhaft	negative
angreifbar	negative
anfechtbar	negative
umstritten	negative
strittig	negative
kontrovers	negative
langgestreckt	positive
lang gestreckt	positive
floral	positive
sinngetreu	positive
anthropomorph	positive
unversteckt	positive
mickrig	negative
eingeschränkt	negative
begrenzt	negative
unumwunden	positive
impulsiv	positive
unverdeckt	positive
unverhohlen	positive
kahl	negative
dunkelbraun	positive
liederlich	negative
lasterhaft	negative
entartet	negative
dekadent	negative
heruntergekommen	negative
glibberig	negative
wortarm	negative
wahlweise	negative
jahrelang	positive
jahrzehntelang	positive
ganz	positive
indiskutabel	negative
symptomatisch	positive
bezeichnend	positive
zweibahnig	positive
roséfarbig	positive
rosé	positive
roséfarben	positive
rechtgläubig	positive
isotrop	positive
unverhältnismässig	negative
ungerechtfertigt	negative
unbefugt	negative
unberechtigt	negative
linksbündig	negative
mini	negative
längs gestreift	positive
längsgestreift	positive
regelgerecht	positive
verbockt	negative
plattig	negative
eigensinnig	negative
überzeugend	positive
glaubwürdig	positive
vertrauensfördernd	positive
vertrauensbildend	positive
misstrauisch	negative
argwöhnisch	negative
normalspurig	positive
unheilig	negative
unselig	negative
stoisch	negative
unaufgeregt	negative
regelgemäss	positive
gelassen	negative
schweigsam	negative
wortkarg	negative
euphorisch	positive
überschäumend	positive
überbordend	positive
fidel	positive
unbeschwert	positive
100%ig	positive
100-prozentig	positive
ultralang	positive
hüftlang	positive
wadenlang	positive
bodenlang	positive
schulterlang	positive
halblang	positive
knöchellang	positive
fingerlang	positive
fusslang	positive
zappelig	positive
kristallklar	positive
privat	negative
staatlich	positive
beruflich	positive
verantwortungsvoll	positive
geschichtsträchtig	positive
wohlbekannt	positive
umständlich	negative
bedeckt	negative
indirekt	negative
introvertiert	negative
eigenbrötlerisch	negative
unzugänglich	negative
gelogen	negative
erlogen	negative
gefälscht	negative
vorgetäuscht	negative
versperrt	negative
blutarm	negative
auflagenstark	positive
offiziell	positive
amtlich	positive
beiläufig	negative
lapidar	negative
dickköpfig	negative
aalglatt	negative
schemenhaft	negative
vorschriftsgemäss	positive
astronomisch	positive
monströs	positive
lecker	negative
hochmusikalisch	positive
verschleimt	negative
verschnupft	negative
bekanntlich	positive
registriert	positive
aktenkundig	positive
betreffend	positive
verrückt	negative
quer	negative
unmanierlich	negative
dunkelviolett	positive
mitgliederstark	positive
berufsmässig	positive
unzählbar	positive
richtig	positive
einzig	negative
verwaist	negative
alleinig	negative
zwanghaft	negative
pestverseucht	negative
lilafarben	positive
lila	positive
fliederfarben	positive
leichtfüssig	positive
umfassend	positive
frohgemut	positive
einspurig	positive
launig	positive
gut aufgelegt	positive
gutgelaunt	positive
gut gelaunt	positive
unkonventionell	positive
intim	negative
vertraulich	negative
verdeckt	negative
heimlich	negative
mysteriös	negative
kryptisch	negative
tabu	negative
mehrmalig	positive
hochkarätig	positive
unmissverständlich	positive
zig	positive
heiratswillig	positive
überbreit	positive
eirund	positive
elliptisch	positive
eiförmig	positive
nicht linear	positive
nichtlinear	positive
flaschengrün	positive
tannengrün	positive
ausdauernd	negative
unnachgiebig	negative
beharrlich	negative
hartnäckig	negative
gedankenvoll	negative
absehbar	positive
äquivalent	positive
nationalistisch	positive
überpünktlich	positive
aufmerksam	positive
unvergleichlich	negative
beispiellos	negative
einmalig	negative
einzigartig	negative
abwechselnd	negative
wechselnd	negative
zweierlei	negative
unvergleichbar	negative
restlos	positive
denkbar	positive
überproportional	positive
autoritativ	positive
taktvoll	positive
langatmig	positive
kompromissbereit	positive
biedermeierlich	negative
fatal	negative
respektabel	positive
graduell	positive
schludrig	negative
gleichlang	positive
endlos	positive
unaufhörlich	positive
ständig	positive
ausführlich	positive
ausgiebig	positive
allmählich	positive
schrittweise	positive
steuerpflichtig	positive
unhöflich	negative
despektierlich	negative
verächtlich	negative
ungebührlich	negative
unbotmässig	negative
beherrscht	negative
gefasst	negative
synonym	positive
differentiell	negative
differenziell	negative
thermoplastisch	positive
wahnsinnig	negative
geisteskrank	negative
irre	negative
irr	negative
irrsinnig	negative
klein gewachsen	negative
kleingewachsen	negative
kurzgewachsen	negative
kurz gewachsen	negative
kurz	negative
verformbar	positive
schläfrig	positive
entschuldbar	positive
unendlich	positive
rebellisch	negative
aufständisch	negative
widerspenstig	negative
aufsässig	negative
aufmüpfig	negative
renitent	negative
kleinwüchsig	negative
verraucht	positive
versponnen	negative
flapsig	negative
pinkfarben	positive
altrosa	positive
pink	positive
altrosafarben	positive
reichlich	positive
schimmelig	negative
bockig	negative
ewig	positive
unvergänglich	positive
winzigklein	negative
stur	negative
neblig	negative
trübe	negative
gleitfähig	negative
zahlbar	positive
muschelkalkhaltig	negative
gedackt	negative
tiefschwarz	negative
vernachlässigbar	negative
bekannt	positive
unbeachtlich	negative
parkähnlich	positive
imperativ	positive
lang gefasst	positive
langgefasst	positive
weit	positive
ungekürzt	positive
unziemlich	negative
bewohnbar	positive
meilenlang	positive
unwegsam	negative
hemmungslos	positive
stattlich	positive
mehrheitlich	positive
maximal	positive
gering	negative
voll	positive
sehnsüchtig	negative
sehnsuchtsvoll	negative
wahr	positive
bestreitbar	negative
einkommenssteuerpflichtig	positive
einkommensteuerpflichtig	positive
umweltschonend	positive
kleinteilig	negative
glitschig	negative
rutschig	negative
krampfhaft	negative
krampfig	negative
unstandesgemäss	negative
hundertprozentig	positive
makaber	negative
optional	negative
gefüllt	positive
massenhaft	positive
regulär	positive
vorschriftsmässig	positive
ordnungsgemäss	positive
angemessen	positive
adäquat	positive
lustig	positive
erquicklich	positive
niederschmetternd	negative
unabsehbar	negative
lebensnah	positive
verrottet	negative
verschimmelt	negative
schmackhaft	negative
knapp	negative
spiegelglatt	negative
prall	positive
dementsprechend	positive
demgemäss	positive
vorfrühlingshaft	negative
grosswüchsig	positive
kreisrund	positive
vermeidbar	negative
ranzig	negative
lilafarbig	positive
mannigfach	positive
mehrfach	positive
vielfach	positive
umsichtig	positive
zartbitter	negative
eheähnlich	positive
kriegsähnlich	positive
menschenähnlich	positive
gottähnlich	positive
hundeähnlich	positive
affenähnlich	positive
unautorisiert	negative
wüst	negative
ungehobelt	negative
lebenslang	positive
jahrtausendelang	positive
jahrhundertelang	positive
stundenlang	positive
tagelang	positive
wochenlang	positive
monatelang	positive
nächtelang	positive
minutenlang	positive
mutterlos	negative
unentbehrlich	positive
armlang	positive
kinnlang	positive
handlang	positive
baumlang	positive
dreiviertellang	positive
feuchtfröhlich	positive
sinnentstellend	negative
unbegründet	negative
glasklar	positive
übermenschlich	positive
wesensgemäss	positive
faltig	positive
langgestielt	positive
stadtbekannt	positive
integrierend	positive
weitschweifig	negative
nichtoffiziell	positive
nicht offiziell	positive
verschlossen	negative
häuslich	negative
drangvoll	negative
knielang	positive
meterlang	positive
ellenlang	positive
überlang	positive
seitenlang	positive
mittellang	positive
humorig	positive
existent	positive
vorliegend	positive
bestehend	positive
ungezügelt	positive
familiengerecht	positive
himmelblau	positive
langfristig	positive
längerfristig	positive
apokryph	negative
gemäss	positive
unsachgemäss	negative
geradlinig	positive
gradlinig	positive
vollspurig	positive
breitspurig	positive
mehrspurig	positive
täuschend	negative
konspirativ	negative
verschwörerisch	negative
stillschweigend	negative
unausgesprochen	negative
krampfartig	negative
wasserklar	positive
unmerklich	negative
altbekannt	positive
umsatzsteuerpflichtig	positive
gutgläubig	positive
blauäugig	positive
leichtgläubig	positive
unbedarft	positive
treuherzig	positive
naiv	positive
gigantisch	positive
bombastisch	positive
überdimensional	positive
lümmelhaft	negative
flegelhaft	negative
desaströs	negative
lebensecht	positive
unerhört	negative
ungehörig	negative
nachrangig	negative
vornehmlich	positive
überwiegend	positive
vorwiegend	positive
russisch-orthodox	positive
christlich-orthodox	positive
griechisch-orthodox	positive
feierlich	positive
krumm	positive
kleinstmöglich	negative
kleinste	negative
jenseitig	negative
konsensfähig	positive
gnomenhaft	negative
geringfügig	negative
winzig	negative
pygmäenhaft	negative
zwergenhaft	negative
zusammen	positive
grauenvoll	negative
grauenhaft	negative
grausig	negative
verhängnisvoll	negative
wirklichkeitsnah	positive
ockergelb	positive
ockerfarben	positive
lachsfarben	positive
okkult	negative
lückenlos	positive
halb voll	positive
halbvoll	positive
sinnverwandt	positive
verkündet	positive
geoutet	positive
publiziert	positive
bekanntgegeben	positive
festlich	positive
veröffentlicht	positive
korrekturbedürftig	negative
vereinzelt	negative
einzeln	negative
zickig	positive
kiebig	positive
berechnet	positive
gutgeschrieben	positive
wertgestellt	positive
nichtöffentlich	negative
nicht öffentlich	negative
geheimgehalten	negative
kolossal	positive
froh gelaunt	positive
frohgelaunt	positive
ununterscheidbar	positive
eigenmächtig	negative
zirkular	positive
kreisförmig	positive
zirkulär	positive
oval	positive
azurblau	positive
pastellblau	positive
komplett	positive
vollzählig	positive
schlafwandlerisch	negative
gleichgelagert	positive
gleich gelagert	positive
gräulich	negative
quer gestreift	positive
quergestreift	positive
kalkhaltig	negative
weitreichend	positive
weitgehend	positive
weitführend	positive
einschichtig	negative
travers	positive
patzig	negative
begnadet	positive
strahlenverseucht	negative
unartig	negative
strenggläubig	positive
langgezogen	positive
schleichend	positive
langwierig	positive
gestreckt	positive
ausgedehnt	positive
sinngemäss	positive
störrisch	negative
verstockt	negative
eigenwillig	negative
vergleichbar	positive
ungeteilt	positive
unzerteilt	positive
dreierlei	negative
umfänglich	positive
schmalschultrig	negative
schmalbrüstig	negative
schmalhüftig	negative
solo	negative
ganzheitlich	positive
integral	positive
immerwährend	positive
zeitlos	positive
fortdauernd	positive
schlüpfrig	negative
unkenntlich	negative
taktlos	negative
indiskret	negative
diskret	positive
trügerisch	negative
vorgeblich	negative
unfolgsam	negative
gespielt	negative
peripher	negative
homolog	positive
rührselig	negative
nonkonformistisch	positive
splendid	positive
wolkenlos	positive
verfallen	negative
konkret	negative
durchschlagend	positive
akzessorisch	negative
abschätzbar	positive
kinderfreundlich	positive
marine	positive
marineblau	positive
rechtsbündig	negative
zutraulich	positive
wohlschmeckend	negative
köstlich	negative
voraussehbar	positive
verzeihlich	positive
gehalten	negative
kontaktlos	negative
polyrhythmisch	negative
ungeöffnet	negative
unnahbar	negative
gehaltvoll	positive
reichhaltig	positive
etlich	positive
zahlreich	positive
zahllos	positive
verhaltensgestört	negative
dement	negative
durcheinander	negative
langstielig	positive
konfrontativ	negative
unbillig	negative
namentlich	positive
weltberühmt	positive
gasreich	positive
ballaststoffreich	positive
kalorienreich	positive
stilecht	positive
wahrhaftig	positive
originalgetreu	positive
unverfälscht	positive
arbeitsaufwendig	negative
arbeitsaufwändig	negative
arbeitsintensiv	negative
missverständlich	negative
rutschfest	positive
protokollarisch	positive
frauentypisch	positive
engstirnig	negative
unverbesserlich	negative
borniert	negative
begründbar	positive
rappeldürr	negative
weitgespannt	positive
sechsfach	positive
6-fach	positive
doppelt	positive
dreifach	positive
3-fach	positive
vierfach	positive
4-fach	positive
vollbesetzt	positive
verfassungstreu	positive
konform	positive
verfassungsgemäss	positive
staatskonform	positive
verfassungskonform	positive
verwirrt	negative
diesig	negative
blühend	positive
sozialliberal	positive
kilometerweit	positive
schwungvoll	positive
stichpunktartig	negative
weittragend	positive
gasgefüllt	positive
einvernehmlich	positive
begründet	positive
gütlich	positive
vorgeschoben	negative
fadenscheinig	negative
beiderlei	negative
bestimmungsgemäss	positive
befehlsgemäss	positive
vernunftgemäss	positive
vermehrt	positive
rar	positive
selten	positive
wiederkehrend	positive
wiederholt	positive
autobiografisch	negative
autobiographisch	negative
obstinat	negative
starrsinnig	negative
unbelehrbar	negative
klitzeklein	negative
delimitiert	negative
limitiert	negative
unbegrenzt	positive
befristet	negative
konkordant	positive
glatzköpfig	negative
schwarzbraun	positive
kahlköpfig	negative
sündig	negative
sündhaft	negative
knöchern	negative
zerteilt	negative
kaputt	negative
funktionsfähig	positive
unbeschädigt	positive
funktionstüchtig	positive
intakt	positive
bibeltreu	positive
frequent	positive
entlarvend	positive
illegitim	negative
unrechtmässig	negative
scherzhaft	positive
spasshaft	positive
spassig	positive
komisch	positive
fakultativ	negative
zeitraubend	negative
kniefrei	negative
ungeschminkt	positive
skeptisch	negative
schmalspurig	negative
unantastbar	negative
wunschgemäss	positive
still	negative
konzis	negative
exhibitionistisch	positive
nicht staatlich	negative
nichtstaatlich	negative
persönlich	negative
rechtsstaatlich	positive
korrekt	positive
verantwortungsbewusst	positive
konventionell	negative
luftgefüllt	positive
opulent	positive
historisch	positive
verschroben	negative
kauzig	negative
sonderlich	negative
wortlautgemäss	positive
auftragsgemäss	positive
freizügig	positive
diffus	negative
faltenreich	positive
bundesstaatlich	positive
arm	negative
manierlich	positive
inoffiziell	negative
hochverräterisch	positive
allein stehend	negative
alleinstehend	negative
metaphysisch	negative
überstürzt	negative
übernatürlich	negative
überhastet	negative
gemeinschaftlich	positive
gesamt	positive
kooperativ	positive
kollektiv	positive
gemeinsam	positive
scharenweise	positive
vereinigt	positive
nichtselbstständig	positive
nicht selbstständig	positive
kurzfristig	negative
auberginefarben	positive
landestypisch	positive
zeittypisch	positive
grundlos	negative
detailliert	positive
detailgetreu	positive
vereint	positive
transversal	negative
undifferenziert	negative
genannt	positive
erwähnt	positive
thematisiert	positive
bekloppt	negative
narrenhaft	positive
jeck	negative
fünffach	positive
5-fach	positive
unverschlüsselt	positive
knorrig	negative
abschätzig	negative
obszön	negative
linksliberal	positive
liberaldemokratisch	positive
freistehend	negative
einzelstehend	negative
exklusiv	negative
ausschliesslich	negative
szenetypisch	positive
allumfassend	positive
zwölffach	positive
12-fach	positive
geschwollen	positive
unbeschadet	positive
dreimalig	positive
3-malig	positive
4-malig	positive
viermalig	positive
fünfmalig	positive
5-malig	positive
wörtlich	positive
ausdrücklich	positive
hochrangig	positive
bündnisgemäss	positive
einhellig	positive
parteiamtlich	positive
seeamtlich	positive
bahnamtlich	positive
bauamtlich	positive
regelkonform	positive
urdeutsch	positive
nachhaltig	positive
unermüdlich	negative
geringelt	positive
nachdenklich	negative
überbacken	negative
angepasst	positive
christliberal	positive
schwarz-gelb	positive
abgelaufen	negative
verspätet	negative
zwergwüchsig	negative
hochoffiziell	positive
aufgeregt	positive
erdenklich	positive
begehrt	positive
gefragt	positive
stichprobenartig	negative
schief	positive
abgeschrägt	positive
windschief	positive
bar	positive
singulär	negative
wasserreich	positive
übersät	negative
zotig	negative
hauptamtlich	positive
ehrenamtlich	positive
nebenamtlich	positive
hauptberuflich	positive
nebenberuflich	positive
gebührend	positive
wach	negative
gedrängt	negative
erfahrungsgemäss	positive
beständig	positive
gesamtstaatlich	positive
summarisch	negative
betriebsfähig	positive
schlagwortartig	negative
lakonisch	negative
kurzgefasst	negative
kurz gefasst	negative
einsilbig	negative
naturrein	positive
unzuständig	negative
zyklopisch	positive
widerständig	negative
richtiggehend	positive
regelrecht	positive
ungeschönt	positive
inflationär	positive
tausendfach	positive
1000-fach	positive
stichwortartig	negative
endlich	negative
dubios	negative
schuppig	negative
sozialstaatlich	positive
überstaatlich	positive
einzelstaatlich	positive
trotzig	negative
klapprig	negative
abgemagert	negative
nebelverhangen	negative
vernebelt	negative
wellig	positive
verhangen	negative
kurzzeitig	negative
figurenreich	positive
eiweissreich	positive
rohstoffreich	positive
torreich	positive
variantenreich	positive
berühmt	positive
erkundet	positive
geläufig	positive
vertraut	positive
erforscht	positive
traut	positive
schlechtgelaunt	negative
schlecht gelaunt	negative
lässig	positive
nonchalent	positive
uneitel	positive
ungezwungen	positive
sechsspurig	positive
vierspurig	positive
zweispurig	positive
rückzahlbar	positive
oftmalig	positive
asphaltiert	negative
spleenig	negative
missmutig	negative
unzensiert	positive
zünftig	positive
minder	negative
minimal	negative
bilderreich	positive
vitaminreich	positive
übervoll	positive
überfüllt	positive
verstopft	positive
nostalgisch	negative
wahrhaft	positive
unbeträchtlich	negative
hochgesteckt	positive
definitionsgemäss	positive
traditionsgemäss	positive
altersgemäss	positive
energieintensiv	negative
forschungsintensiv	negative
wartungsintensiv	negative
personalintensiv	negative
lohnintensiv	negative
materialintensiv	negative
meilenweit	positive
archetypisch	positive
praxisgerecht	positive
eineinhalbfach	positive
grüblerisch	negative
unglückselig	negative
bemitleidenswert	negative
beklagenswert	negative
geringstmöglich	negative
prallvoll	positive
randvoll	positive
ausverkauft	positive
ausgebucht	positive
sachgemäss	positive
sachgerecht	positive
witzig	positive
dunstig	negative
nebligtrüb	negative
nationalliberal	positive
nominell	negative
plebejisch	negative
anschaulich	negative
schamlos	negative
vulgär	negative
ordinär	negative
krummlinig	positive
malvenfarbig	positive
malvenfarben	positive
2-fach	positive
zweifach	positive
x-fach	positive
sehnlich	negative
standesgemäss	positive
statthaft	positive
nachahmenswert	positive
hoffähig	positive
empfehlenswert	positive
ratsam	positive
vergänglich	negative
lizenzkonform	positive
regionaltypisch	positive
bürgerkriegsähnlich	positive
hochtrabend	positive
hochfliegend	positive
zeitgerecht	positive
pseudonym	negative
2-malig	positive
zweimalig	positive
konzertiert	positive
sechsmalig	positive
6-malig	positive
umweltgerecht	positive
klapperdürr	negative
spindeldürr	negative
abgezehrt	negative
unterernährt	negative
abgemergelt	negative
ausgemergelt	negative
lebenslänglich	positive
unabkömmlich	positive
wortgemäss	positive
fachgemäss	positive
zweckgemäss	positive
7-fach	positive
siebenfach	positive
8-fach	positive
achtfach	positive
9-fach	positive
neunfach	positive
10-fach	positive
zehnfach	positive
hundertfach	positive
100-fach	positive
verbissen	negative
obskur	negative
grossangelegt	positive
gerechtfertigt	positive
berechtigt	positive
befugt	positive
streitig	negative
kirchenamtlich	positive
lehramtlich	positive
katasteramtlich	positive
postamtlich	positive
patentamtlich	positive
entwicklungsgemäss	positive
vereinbarungsgemäss	positive
gesundheitsgemäss	positive
normgemäss	positive
schriftgemäss	positive
empfindungsgemäss	positive
verschrumpelt	positive
schrumplig	positive
schrumpelig	positive
unzerstört	positive
reduktionistisch	negative
geringschätzig	negative
verräterisch	positive
unbestritten	positive
brüsk	positive
zwangsgestört	negative
halbstaatlich	positive
n-fach	positive
lauffähig	positive
grasig	negative
digital	negative
minimalistisch	negative
prompt	negative
unverzüglich	negative
postwendend	negative
aufgeräumt	positive
satzungsgemäss	positive
vertragsgemäss	positive
spontan	positive
begeisterungsfähig	positive
vielspurig	positive
fünfspurig	positive
doppelspurig	positive
dreispurig	positive
verwirrend	negative
fehlleitend	negative
spartanisch	negative
übersinnlich	negative
paranormal	negative
unpaarig	negative
millionenfach	positive
verborgen	negative
klammheimlich	negative
versteckt	negative
solitär	negative
wahrheitsgetreu	positive
missfällig	negative
explizit	positive
unverdient	negative
unausschöpflich	positive
unschätzbar	positive
unerschöpflich	positive
weitestgehend	positive
unzureichend	negative
unzulänglich	negative
lebensgeschichtlich	negative
unabwendbar	positive
biografisch	negative
biographisch	negative
freiberuflich	positive
freischaffend	positive
berufsbegleitend	positive
pathetisch	positive
schwülstig	positive
achtspurig	positive
zollamtlich	positive
standesamtlich	positive
krustig	negative
unentwegt	negative
zigfach	positive
transzendent	negative
statutengemäss	positive
ungekünstelt	positive
mikroskopisch	negative
kirchenmusikalisch	positive
kammermusikalisch	positive
altüberliefert	positive
grässlich	negative
unmittelbar	positive
sofortig	negative
nachgiebig	positive
anderthalbfach	positive
verzerrungsfrei	positive
verbohrt	negative
überzuckert	negative
wahnhaft	negative
hochgestochen	positive
selbstgesteckt	negative
einträchtig	positive
zusammengeschlossen	positive
solidarisch	positive
typisch	positive
vollumfänglich	positive
himmelweit	positive
werkgetreu	positive
achtmalig	positive
8-malig	positive
7-malig	positive
siebenmalig	positive
zehnmalig	positive
10-malig	positive
9-malig	positive
neunmalig	positive
häufig	positive
unstrittig	positive
regierungsamtlich	positive
gehäuft	positive
hygienisch	positive
behindertengerecht	positive
fachgerecht	positive
irritierend	negative
parallel	positive
ungeheuerlich	positive
haarsträubend	positive
eingeladen	positive
variationsreich	positive
folgenschwer	positive
folgenreich	positive
abendfüllend	positive
transzendental	negative
unverbrüchlich	positive
gekünstelt	negative
weitgreifend	positive
unbeherrscht	positive
zeitintensiv	negative
zeitaufwändig	negative
zeitaufwendig	negative
urtümlich	positive
hochstehend	positive
obrigkeitsstaatlich	positive
arbeitsreich	negative
begrünt	negative
schneebedeckt	negative
zugedeckt	negative
wahrheitsgemäss	positive
verdreht	negative
zwanzigfach	positive
fettreich	positive
formenreich	positive
naturbelassen	positive
künstlich	negative
dichtbebaut	positive
dicht bebaut	positive
erfasst	positive
eingetragen	positive
eingeschrieben	positive
ausgewiesen	positive
angemeldet	positive
anerkannt	positive
angekündigt	positive
nationalstaatlich	positive
detailreich	positive
nährstoffreich	positive
ominös	negative
föderiert	positive
unvergesslich	positive
unvergessen	positive
unsterblich	positive
fortbestehend	positive
irreführend	negative
männertypisch	positive
wirtschaftsliberal	positive
abfällig	negative
populär	positive
konformistisch	negative
abundant	positive
wohlproportioniert	positive
gewellt	positive
schräg	positive
veterinäramtlich	positive
verkürzt	negative
weitgefächert	positive
immediat	positive
unanfechtbar	positive
unveröffentlicht	negative
unvermittelt	positive
kurzstielig	negative
cash	positive
reichsunmittelbar	positive
verzeihbar	positive
schrullig	negative
unbekannt	negative
multiplikativ	positive
eisenreich	positive
breitgefächert	positive
systemkonform	positive
genusssüchtig	negative
immer während	positive
beschuppt	negative
situationsgerecht	positive
desorientiert	negative
ausreichend	positive
lax	positive
hochheilig	negative
sakrosankt	negative
mondän	positive
leichtfertig	negative
viel zitiert	positive
vielzitiert	positive
verkehrsberuhigt	negative
ratlos	negative
seltsam	negative
kursiv	positive
uniert	positive
nochmalig	positive
erneut	positive
neuerlich	positive
zweckentsprechend	positive
zerrüttet	negative
zerlöchert	negative
perforiert	negative
unterlegt	positive
fundiert	positive
handfest	positive
stichhaltig	positive
unnatürlich	negative
gebietsfremd	negative
weltgewandt	positive
regelmässig	positive
winkeltreu	positive
korrosiv	negative
aufgeteilt	negative
weiträumig	positive
weitläufig	positive
bundesweit	positive
deutschlandweit	positive
europaweit	positive
weltweit	positive
zerissen	negative
eingefallen	negative
beschädigt	negative
defekt	negative
restringiert	negative
unwandelbar	positive
schrottreif	negative
weisungsbefugt	positive
wahlberechtigt	positive
erziehungsberechtigt	positive
urkomisch	positive
saukomisch	positive
raumgreifend	positive
invariant	positive
stutzig	negative
arbeitsteilig	negative
untypisch	negative
preussisch	positive
gewissenhaft	positive
traditionell	negative
österreichweit	positive
zeitgeschichtlich	positive
geschichtlich	positive
ungenügend	negative
kläglich	negative
dürftig	negative
ärmlich	negative
kärglich	negative
unangekündigt	negative
unangemeldet	negative
unangesagt	negative
hellwach	negative
aufgedreht	positive
fremd	negative
ungebunden	negative
liiert	positive
wirklichkeitsgetreu	positive
frevlerisch	negative
lästerlich	negative
verderblich	negative
extensiv	positive
geschnitten	negative
synchron	positive
harzig	positive
ternär	positive
dezidiert	positive
vergriffen	positive
sogenannt	positive
missgestimmt	negative
misslaunig	negative
missgelaunt	negative
verstimmt	negative
knatschig	negative
quengelig	negative
reparaturbedürftig	negative
amüsant	positive
vergnüglich	positive
schalkhaft	positive
possenhaft	positive
albern	positive
schelmisch	positive
paranoid	negative
naturgemäss	positive
restriktiv	negative
einschränkend	negative
gängig	positive
lasch	positive
leger	positive
nominal	negative
buchstäblich	positive
gegnerisch	negative
geknickt	positive
nutzungsberechtigt	positive
meistgenannt	positive
ungefärbt	positive
verstrichen	negative
uneingeladen	negative
umkämpft	positive
unpopulär	negative
sterblich	negative
winkelig	positive
winklig	positive
implizit	negative
siderisch	positive
unerwähnt	negative
paarig	positive
triftig	positive
aufgekratzt	positive
eiweissarm	negative
vitaminarm	negative
schadhaft	negative
gleichbleibend	positive
konstant	positive
unverändert	positive
wertbeständig	positive
altersgerecht	positive
reizbar	positive
müde	positive
rohstoffarm	negative
kalorienarm	negative
apodiktisch	positive
sanitär	positive
plausibel	positive
flüchtig	negative
unbeständig	negative
glaubhaft	positive
unaufmerksam	negative
hellhörig	positive
reaktionsschnell	positive
geistesgegenwärtig	positive
wachsam	positive
urgeschichtlich	positive
weltgeschichtlich	positive
literaturgeschichtlich	positive
entwicklungsgeschichtlich	positive
weisungsberechtigt	positive
wohnberechtigt	positive
sorgeberechtigt	positive
anspruchsberechtigt	positive
teilnahmeberechtigt	positive
vertretungsberechtigt	positive
heimatberechtigt	positive
vollberechtigt	positive
spielberechtigt	positive
nährstoffarm	negative
jähzornig	positive
ungenannt	negative
familiär	positive
übellaunig	negative
gleichnishaft	negative
unauslöschlich	positive
wohlbegründet	positive
unbestreitbar	positive
unumstösslich	positive
unumstritten	positive
theatergeschichtlich	positive
ideengeschichtlich	positive
dogmengeschichtlich	positive
heilsgeschichtlich	positive
wissenschaftsgeschichtlich	positive
apriorisch	positive
leer	negative
wenigste	negative
unstreitig	positive
zeithistorisch	positive
sprachhistorisch	positive
stadthistorisch	positive
welthistorisch	positive
wirtschaftshistorisch	positive
landeshistorisch	positive
literaturhistorisch	positive
rechtshistorisch	positive
religionshistorisch	positive
offiziös	negative
universalgeschichtlich	positive
wohl temperiert	positive
wohltemperiert	positive
nörglerisch	negative
aufbrausend	positive
geleert	negative
entleert	negative
naturhistorisch	positive
schnellstmöglich	negative
übertragen	negative
vielgefragt	positive
viel gefragt	positive
weitverbreitet	positive
aufgesetzt	negative
naturgeschichtlich	positive
sprachgeschichtlich	positive
musikgeschichtlich	positive
naturidentisch	negative
verdrossen	negative
mürrisch	negative
zerstört	negative
bewusst	positive
rechtmässig	positive
legitim	positive
halbamtlich	negative
fraktioniert	negative
prototypisch	positive
unlimitiert	positive
deflationär	negative
illustrativ	negative
sozialgeschichtlich	positive
prothetisch	negative
ulkig	positive
wasserarm	negative
widerruflich	negative
fettarm	negative
verschlüsselt	negative
personal	negative
personenbezogen	negative
landesgeschichtlich	positive
urig	positive
unterschwellig	negative
latent	negative
achtsam	positive
sorgsam	positive
sorgfältig	positive
ordnungsliebend	positive
höchstpersönlich	negative
kirchengeschichtlich	positive
massstabsgerecht	positive
militärhistorisch	positive
sprichwörtlich	positive
abermalig	positive
restaurativ	negative
bärbeissig	negative
geistig behindert	negative
unbefristet	positive
unbeschränkt	positive
angesagt	positive
beschränkend	negative
fristlos	negative
möglich	positive
eigenhändig	negative
reichsfrei	positive
heterolog	negative
nölig	negative
nörgelig	negative
literarhistorisch	positive
konservativ	negative
stereotypisch	positive
stereotyp	positive
unangreifbar	negative
versunken	positive
kontemplativ	positive
meditativ	positive
musikhistorisch	positive
forciert	negative
unangefochten	positive
wahrscheinlich	positive
übelgelaunt	negative
übel gelaunt	negative
rollstuhlgerecht	positive
fahrstuhlgerecht	positive
überkandidelt	positive
exaltiert	positive
quaternär	positive
idealtypisch	positive
unmöglich	negative
unveränderlich	positive
veritabel	positive
periphrastisch	negative
unverletzlich	negative
symbolisch	negative
kodiert	negative
symbolhaft	negative
mittelbar	negative
einstudiert	negative
manieriert	negative
diachron	positive
diachronisch	positive
architekturhistorisch	positive
architekturgeschichtlich	positive
artfremd	negative
körperfremd	negative
wildfremd	negative
ortsfremd	negative
regionalgeschichtlich	positive
fleischarm	negative
artifiziell	negative
synthetisch	negative
stadtgeschichtlich	positive
zerfasert	negative
zerkleinert	negative
renommiert	positive
welk	positive
informal	positive
viel genannt	positive
vielgenannt	positive
untengenannt	positive
unten genannt	positive
obgenannt	positive
obengenannt	positive
oben genannt	positive
erstgenannt	positive
vorgenannt	positive
letztgenannt	positive
erbberechtigt	positive
stimmberechtigt	positive
hagiographisch	negative
hagiografisch	negative
astrophysikalisch	positive
allseitig	positive
werterhaltend	positive
unregelmässig	positive
mindeste	negative
stammesgeschichtlich	positive
erdgeschichtlich	positive
wirkungsgeschichtlich	positive
unidentifiziert	negative
vernichtet	negative
umgehend	negative
vorbehaltlich	negative
angezeigt	positive
unbar	negative
bargeldlos	negative
ramponiert	negative
unerforscht	negative
unerkundet	negative
anonym	negative
konzentriert	positive
kirchenhistorisch	positive
filmhistorisch	positive
kriegsgeschichtlich	positive
filmgeschichtlich	positive
wirtschaftsgeschichtlich	positive
rechtsgeschichtlich	positive
militärgeschichtlich	positive
religionsgeschichtlich	positive
eitel	negative
urwüchsig	positive
stimmfähig	positive
unleugbar	positive
genug	positive
genügend	positive
leer stehend	negative
leerstehend	negative
hinreichend	positive
erwartbar	positive
ordentlich	positive
innovativ	positive
geckenhaft	negative
unrettbar	positive
trendig	positive
kleingeschnitten	negative
gottgewollt	positive
muffig	negative
calvinistisch	positive
ephemerisch	negative
letztmöglich	positive
impossibel	negative
reaktionär	negative
zurechenbar	positive
irreparabel	positive
unabänderlich	positive
minütlich	positive
stündlich	positive
jährlich	positive
alljährlich	positive
halbjährlich	positive
vierteljährlich	positive
wöchentlich	positive
allwöchentlich	positive
monatlich	positive
allmonatlich	positive
weltumspannend	positive
weltumfassend	positive
gewinkelt	positive
eingeschnitten	negative
federführend	positive
unbewusst	negative
leichtsinnig	negative
hochgeschätzt	positive
geschnetzelt	negative
verfolgbar	positive
methodisch	positive
erregbar	positive
gebunden	positive
blasphemisch	negative
unglaubhaft	negative
wertkonservativ	negative
kryptographisch	negative
kryptografisch	negative
rechtwinkelig	positive
rechtwinklig	positive
symbolhaltig	negative
dissident	negative
renovierungsbedürftig	negative
naturbedingt	positive
global	positive
landläufig	positive
metabolisch	negative
kontrolliert	negative
konträr	negative
oppositionell	negative
umstürzlerisch	negative
subversiv	negative
umstürzend	negative
gebrochen	positive
atypisch	negative
hinlänglich	positive
unentdeckt	negative
überspannt	positive
überdreht	positive
höchstwahrscheinlich	positive
augenfällig	positive
ungebeten	negative
westpreussisch	positive
südpreussisch	positive
burlesk	positive
antizyklisch	positive
kompetitiv	negative
epikureisch	negative
kultig	positive
letztinstanzlich	positive
prozyklisch	positive
zureichend	positive
saisonbedingt	positive
todmüde	positive
verschlafen	positive
unwiderrufbar	positive
bettelarm	negative
durchgängig	positive
unabänderbar	positive
durchführbar	positive
buchstabengetreu	positive
bitterarm	negative
halbstündlich	positive
wechselvoll	negative
unterbrochen	positive
veränderlich	positive
wechselhaft	negative
sporadisch	positive
zeitweise	positive
temporär	positive
voraussichtlich	positive
potentiell	positive
potenziell	positive
mutmasslich	positive
anscheinend	positive
unkonzentriert	negative
realisierbar	positive
umsetzbar	positive
verwirklichbar	positive
machbar	positive
rückführbar	positive
zurückführbar	positive
schuldbewusst	positive
ausführbar	positive
affig	negative
selbstgerecht	negative
selbstherrlich	negative
affektiert	negative
geziert	negative
unstet	negative
versicherungsfremd	negative
progressiv	positive
blutleer	negative
menschenleer	negative
halbleer	negative
luftleer	negative
sinnentleert	negative
sinnleer	negative
verarmt	negative
pleite	negative
spitzwinklig	positive
spitzwinkelig	positive
stumpfwinklig	positive
stumpfwinkelig	positive
irreversibel	positive
unwiederbringlich	positive
nächstmöglich	positive
zeitweilig	positive
wortgetreu	positive
reich	positive
täglich	positive
altpreussisch	positive
erwartungsgemäss	positive
erwartungsgetreu	positive
naturgegeben	positive
letztlich	positive
endgültig	positive
definitiv	positive
letztendlich	positive
unwiderruflich	positive
gotteslästerlich	negative
angestammt	positive
zustehend	positive
saisonal	positive
jahreszeitlich	positive
oligotroph	negative
vollsynthetisch	negative
kurios	positive
geistesabwesend	negative
reinlich	positive
methodistisch	positive
ephemer	negative
erzkonservativ	negative
inkonstant	negative
gottgegeben	positive
nationalkonservativ	negative
verschmitzt	positive
lausbubenhaft	positive
lausbübisch	positive
zuordenbar	positive
unkontrolliert	positive
in	positive
ruchlos	negative
augenscheinlich	positive
unwahrscheinlich	negative
sanierungsbedürftig	negative
orthogonal	positive
grasartig	negative
wandelbar	positive
zuständig	positive
zerschnitten	negative
zersäbelt	negative
unachtsam	negative
freihändig	negative
elaboriert	positive
geschätzt	positive
durchgehend	positive
ununterbrochen	positive
cyclisch	positive
zyklisch	positive
turnunsgemäss	positive
turnusmässig	positive
periodisch	positive
gelegentlich	positive
unlustig	negative
abnehmend	negative
zunehmend	negative
nachlassend	negative
verringernd	negative
degressiv	negative
zerstreut	negative
vergesslich	negative
alsbaldig	negative
selbstgefällig	negative
schlaftrunken	positive
unausgeschlafen	positive
hundemüde	positive
superreich	positive
futuristisch	positive
revolutionär	positive
bahnbrechend	positive
erneuernd	positive
iterativ	positive
darstellbar	positive
schwerreich	positive
steinreich	positive
neureich	positive
eingehend	positive
reformatorisch	positive
durchsetzbar	positive
unheilbar	positive
situiert	positive
stet	positive
unordentlich	negative
rekonstruierbar	positive
schlampig	negative
prüfbar	positive
implausibel	negative
unglaubwürdig	negative
hanebüchen	negative
stinkreich	positive
geheimnisumwittert	negative
modebewusst	positive
magisch	negative
mystisch	negative
geheimnisvoll	negative
technikorientiert	positive
technikgläubig	positive
zivilisiert	positive
up to date	positive
zeitgemäss	positive
reguliert	negative
vereinbar	positive
ostpreussisch	positive
kaufkräftig	positive
ererbt	positive
belastet	positive
überlastet	positive
überbelastet	positive
überfordert	positive
überarbeitet	positive
sinkend	negative
modrig	negative
moderig	negative
änderbar	negative
rätselhaft	negative
out	negative
verträumt	negative
masurisch	positive
überreich	positive
rückgängig	negative
aufführbar	positive
aufgeklärt	positive
fortschrittlich	positive
konstruierbar	positive
abwesend	negative
geregelt	positive
regelhaft	positive
miefig	negative
unkurierbar	positive
perkutan	negative
subkutan	negative
träumerisch	negative
wohlhabend	positive
gutsituiert	positive
betucht	positive
notleidend	negative
not leidend	negative
vermögend	positive
gut betucht	positive
gutbetucht	positive
zahlungskräftig	positive
überwindbar	positive
abziehbar	positive
säuberlich	positive
hugenottisch	positive
reversibel	negative
reparabel	negative
werktäglich	positive
alltäglich	positive
tagtäglich	positive
rückwärtsgewandt	negative
sonntäglich	positive
kapitalkräftig	positive
begütert	positive
gedankenverloren	negative
unvereinbar	negative
kompatibel	positive
undurchführbar	negative
abbildbar	positive
erfüllbar	positive
pausenlos	positive
abschliessend	positive
angespannt	positive
lokal	negative
wiederholbar	positive
nichtständig	positive
nicht ständig	positive
generalstabsmässig	positive
bedürftig	negative
reformistisch	positive
spielbar	positive
unumkehrbar	positive
reformerisch	positive
zurückgehend	negative
rückläufig	negative
abflauend	negative
rezessiv	negative
lösbar	positive
gedankenversunken	negative
gestaltbar	negative
orphisch	negative
manipulierbar	negative
zerstörbar	negative
heilbar	negative
sibyllinisch	negative
modifizierbar	negative
pythisch	negative
rückständig	negative
absinkend	negative
schutzbedürftig	negative
andauernd	positive
reproduzierbar	positive
fallend	negative
variabel	negative
unablässig	positive
schleierhaft	negative
dunkel	negative
wissenschaftsmethodisch	positive
inkompatibel	negative
variierbar	negative
unbelastet	negative
einklagbar	positive
halbstündig	positive
kurierbar	negative
topisch	negative
versonnen	negative
selbstvergessen	negative
kündbar	negative
aufhebbar	positive
behebbar	positive
auflöslich	positive
auflösbar	positive
rückgebildet	negative
umkehrbar	negative
allabendlich	positive
allmorgendlich	positive
veränderbar	negative
korrigierbar	negative
unbewältigbar	negative
regressiv	negative
unspielbar	negative
unrealisierbar	negative
ungebrochen	positive
stetig	positive
permanent	positive
dauernd	positive
fortwährend	positive
fortgesetzt	positive
kontinuierlich	positive
anachronistisch	negative
einleitend	negative
final	positive
wärmebedürftig	negative
behandelbar	negative
vollstreckbar	positive
überbrückbar	positive
delphisch	negative
unlösbar	negative
absetzbar	positive
diskontinuierlich	negative
konterrevolutionär	positive
unstetig	negative
mangelnd	negative
fehlend	negative
anwesend	positive
unkündbar	positive
zurückgeblieben	negative
gegenrevolutionär	positive
steigend	positive
unüberbrückbar	negative
sukzessiv	positive
fortlaufend	positive
deduktiv	positive
induktiv	positive
therapierbar	negative
unüberwindbar	negative
unüberwindlich	negative
unveränderbar	positive
fortschreitend	positive
illusorisch	negative
utopisch	negative
initial	negative
unterfordert	negative
unterqualifiziert	positive
sequentiell	positive
sequenziell	positive
aufeinander folgend	positive
aufeinanderfolgend	positive
hermeneutisch	positive
empirisch	positive
unauflöslich	negative
unaufhebbar	negative
unauflösbar	negative
unterentwickelt	negative
schubweise	negative
stossweise	negative
allgegenwärtig	positive
teilnehmend	positive
partizipierend	positive
ansteigend	positive
therapieresistent	positive
konsekutiv	positive
retardiert	negative
überqualifiziert	negative
allzugegen	positive
omnipräsent	positive
hoch entwickelt	positive
hochentwickelt	positive
ubiquitär	positive
höchstentwickelt	positive
