exzellent	positive
ausgezeichnet	positive
mies	negative
unglücklich	negative
gut	positive
positiv	positive
falsch	negative
schlecht	negative
zweitklassig	negative
lieb	positive
phantastisch	positive
fantastisch	positive
grossartig	positive
richtig	positive
böse	negative
bös	negative
minderwertig	negative
erstklassig	positive
schön	positive
armselig	negative
unschön	negative
negativ	negative
perfekt	positive
mustergültig	positive
vorbildlich	positive
beispielhaft	positive
exzeptionell	positive
aussergewöhnlich	positive
ausserordentlich	positive
viertklassig	negative
sinnreich	positive
verkehrt	negative
unecht	negative
recht	positive
unrecht	negative
entwürdigend	negative
ineffektiv	negative
herausragend	positive
fein	positive
hervorragend	positive
liebenswert	positive
ergebnisreich	positive
zweckmässig	positive
sinnvoll	positive
sinnig	positive
imageträchtig	positive
ehrenvoll	positive
optimal	positive
umgekehrt	negative
regulär	positive
vorschriftsmässig	positive
ordnungsgemäss	positive
angemessen	positive
adäquat	positive
feige	negative
feig	negative
hinterhältig	negative
läppisch	negative
nichtig	negative
blendend	positive
verteufelt	negative
glücklich	positive
besser	positive
moralisch	positive
ethisch	positive
unfair	negative
übel	negative
ungerecht	negative
unkorrekt	negative
kriminell	negative
sagenhaft	positive
verdorben	negative
schuldig	negative
unschuldig	positive
irrig	negative
gewalttätig	negative
lügnerisch	negative
verlogen	negative
unaufrichtig	negative
schwindlig	negative
okay	positive
stilsicher	positive
unübertrefflich	positive
verschlagen	negative
schmuck	positive
link	negative
grauslich	negative
unangemessen	negative
inadäquat	negative
verfehlt	negative
mau	negative
flau	negative
faul	negative
prestigeträchtig	positive
regelgemäss	positive
ehrlich	positive
missraten	negative
misslungen	negative
miserabel	negative
schäbig	negative
lausig	negative
eifrig	positive
arbeitsam	positive
emsig	positive
fleissig	positive
tüchtig	positive
unvorteilhaft	negative
intrigant	negative
hündisch	negative
irregulär	negative
irrtümlich	negative
unrichtig	negative
unzutreffend	negative
fälschlich	negative
unwahr	negative
gütig	positive
liebesfähig	positive
liebenswürdig	positive
nichtsnutzig	negative
bildschön	positive
liebevoll	positive
preisgekrönt	positive
vorschriftsgemäss	positive
geschmackvoll	positive
ergebnislos	negative
zweckfrei	negative
unzweckmässig	negative
regelgerecht	positive
angeblich	negative
gerecht	positive
fair	positive
tugendlich	positive
stilgerecht	positive
sinnhaft	positive
eingeschnappt	negative
verletzt	negative
pikiert	negative
erbost	negative
grandios	positive
richtiggehend	positive
meisterlich	positive
hochwertig	positive
elefantös	positive
glückreich	positive
sittlich	positive
unedel	negative
abgeschlagen	negative
stilvoll	positive
dekorativ	positive
sauer	negative
gekränkt	negative
beleidigt	negative
bitterböse	negative
günstig	positive
geeignet	positive
gehoben	positive
gefällig	positive
eingängig	positive
ideal	positive
elendig	negative
fulminant	positive
hässlich	negative
erfolg versprechend	positive
erfolgversprechend	positive
legendär	positive
wundervoll	positive
herrlich	positive
prima	positive
wunderbar	positive
himmlisch	positive
paradiesisch	positive
grottig	negative
kümmerlich	negative
geringwertig	negative
elend	negative
erbärmlich	negative
jämmerlich	negative
spitzenmässig	positive
spitze	positive
klasse	positive
endgeil	positive
charakterlos	negative
hübsch	positive
wunderschön	positive
wohl geformt	positive
wohlgeformt	positive
unnützlich	negative
wünschenswert	positive
sinnlich	positive
feingeschnitten	positive
fein geschnitten	positive
amoralisch	negative
leid	negative
drittklassig	negative
tugendhaft	positive
liebreich	positive
tugendreich	positive
kontrafaktisch	negative
gelungen	positive
geraten	positive
schlimm	negative
dilettantisch	negative
stümperhaft	negative
paradigmatisch	positive
fehlerhaft	negative
teuflisch	negative
gutartig	positive
grottenschlecht	negative
verträglich	positive
unschädlich	positive
zuträglich	positive
pejorativ	negative
vermeintlich	negative
bedenkenswert	positive
laienhaft	negative
ungeeignet	negative
ungut	negative
unprofessionell	negative
nutzlos	negative
akzeptabel	positive
genehm	positive
begrüssenswert	positive
berauschend	positive
hochklassig	positive
meisterhaft	positive
regelrecht	positive
herzensgut	positive
grundfalsch	negative
inakzeptabel	negative
unakzeptabel	negative
ungünstig	negative
nutzbringend	positive
nützlich	positive
strafwürdig	negative
barmherzig	positive
angriffslustig	negative
aggressiv	negative
kampflustig	negative
kampfeslustig	negative
traumhaft	positive
idyllisch	positive
sensationell	positive
legendenhaft	positive
sinnlos	negative
unsinnig	negative
zwecklos	negative
ruchbar	negative
famos	positive
böswillig	negative
schädlich	negative
schädigend	negative
abträglich	negative
unehrenhaft	negative
ehrlos	negative
grossherzig	positive
gutherzig	positive
gutmütig	positive
friedlich	positive
friedliebend	positive
edelmütig	positive
prächtig	positive
märchenhaft	positive
prachtvoll	positive
glücklos	negative
chancenlos	negative
erfolglos	negative
bescheiden	negative
anrüchig	negative
scheiss	negative
beschissen	negative
niederträchtig	negative
maliziös	negative
boshaft	negative
hämisch	negative
süffisant	negative
unfreundlich	negative
unfehlbar	positive
überragend	positive
chancenreich	positive
erfolgreich	positive
ätzend	negative
mistig	negative
beknackt	negative
oll	negative
widrig	negative
wahr	positive
satanisch	negative
dämonisch	negative
diabolisch	negative
hasserfüllt	negative
stiefmütterlich	negative
gemein	negative
bösartig	negative
vorbildhaft	positive
friedvoll	positive
vielversprechend	positive
aussichtsreich	positive
lohnenswert	positive
lohnend	positive
effektiv	positive
gelegen	positive
echt	positive
wahrhaftig	positive
lauter	positive
unbescholten	positive
schnöde	negative
zerstörerisch	negative
destruktiv	negative
anrechnungsfähig	positive
beihilfefähig	positive
edel	positive
bestmöglich	positive
untadlig	positive
untadelig	positive
vortrefflich	positive
bestechend	positive
vorzüglich	positive
zärtlich	positive
herzig	positive
begründbar	positive
teilbar	positive
erstrebenswert	positive
naturgemäss	positive
sachgemäss	positive
sachgerecht	positive
kombinierbar	positive
kleinkriminell	negative
hinterfotzig	negative
infam	negative
fies	negative
schadenfroh	negative
lötfähig	positive
feinschmeckerisch	positive
kulinarisch	positive
panzerbrechend	positive
glimpflich	positive
verbessernd	positive
unstimmig	negative
perspektivreich	positive
moderat	positive
konform	positive
opportun	positive
angebracht	positive
passend	positive
übereinstimmend	positive
unsportlich	negative
arglistig	negative
heimtückisch	negative
durchtrieben	negative
hinterlistig	negative
tückisch	negative
perfide	negative
nutzbar	positive
schrecklich	negative
fürchterlich	negative
furchtbar	negative
unnütz	negative
mythisch	positive
standesgemäss	positive
statthaft	positive
nachahmenswert	positive
hoffähig	positive
empfehlenswert	positive
ratsam	positive
gemässigt	positive
massvoll	positive
ausgewogen	positive
umsichtig	positive
brauchbar	positive
räuberisch	negative
voreingenommen	negative
subjektiv	negative
strafbar	negative
betrügerisch	negative
zeitgerecht	positive
unautorisiert	negative
umweltgerecht	positive
luderhaft	negative
verwerflich	negative
unanständig	negative
verworfen	negative
anmutig	positive
graziös	positive
einvernehmlich	positive
differenziert	positive
begründet	positive
gütlich	positive
fragwürdig	negative
angenehm	positive
straffällig	negative
delinquent	negative
mitschuldig	negative
verbrecherisch	negative
schändlich	negative
bestimmungsgemäss	positive
befehlsgemäss	positive
unstandesgemäss	negative
sinngetreu	positive
konkordant	positive
sinnentstellend	negative
gerechtfertigt	positive
unbegründet	negative
grundlos	negative
berechtigt	positive
befugt	positive
dissozial	negative
asozial	negative
militant	negative
tätlich	negative
entwicklungsgemäss	positive
normgemäss	positive
matt	negative
brutal	negative
kleidsam	positive
unehrlich	negative
unverhältnismässig	negative
ungerechtfertigt	negative
unbefugt	negative
unberechtigt	negative
strömungsgünstig	positive
grausam	negative
barbarisch	negative
erbarmungslos	negative
mitleidslos	negative
gnadenlos	negative
schonungslos	negative
rüde	negative
dahergelaufen	negative
toxisch	negative
aufrichtig	positive
unverdorben	positive
aufrecht	positive
geländegängig	positive
strahlend	positive
glückstrahlend	positive
überglücklich	positive
seelig	positive
behindertengerecht	positive
fachgerecht	positive
umweltschädigend	negative
umweltschädlich	negative
geschäftsschädigend	negative
parteischädigend	negative
eilfertig	positive
betriebsam	positive
geschäftig	positive
beflissen	positive
übereifrig	positive
servil	positive
diensteifrig	positive
tatkräftig	positive
agil	positive
nahrhaft	positive
poplig	negative
popelig	negative
verkehrsgünstig	positive
gesundheitsfördernd	positive
satzungsgemäss	positive
unsachgemäss	negative
vertrauenswürdig	positive
frohgestimmt	positive
froh gestimmt	positive
zufrieden	positive
ungetrübt	positive
korrekt	positive
trügerisch	negative
täuschend	negative
zukunftsfähig	positive
gespielt	negative
marktfähig	positive
lebensfeindlich	negative
lebenstüchtig	positive
untüchtig	negative
geschäftstüchtig	positive
schuldhaft	negative
wertlos	negative
phänomenal	positive
rüd	negative
gelogen	negative
erlogen	negative
gefälscht	negative
vorgetäuscht	negative
goldig	positive
putzig	positive
gnädig	positive
niedlich	positive
frank	positive
verzeihend	positive
rabiat	negative
unästhetisch	negative
wahrheitsgetreu	positive
ertragbar	positive
unangebracht	negative
unpassend	negative
schmeichelhaft	positive
unerhört	negative
ungehörig	negative
garstig	negative
martialisch	negative
brachial	negative
handgreiflich	negative
blutrünstig	negative
wortgemäss	positive
wortlautgemäss	positive
fachgemäss	positive
zweckgemäss	positive
unförmig	negative
pickelig	negative
entstellt	negative
offensiv	negative
draufgängerisch	negative
redlich	positive
ehrenhaft	positive
statutengemäss	positive
deformiert	negative
verformt	negative
süss	positive
knuffig	positive
rechtschaffen	positive
attraktiv	positive
gelehrig	positive
adrett	positive
gepflegt	positive
appetitlich	positive
unbarmherzig	negative
uneinholbar	positive
nachtragend	negative
unversöhnlich	negative
vorwurfsvoll	negative
unnachahmlich	positive
virtuos	positive
kunstfertig	positive
gesetzt	positive
anziehend	positive
arbeitsfreudig	positive
arbeitswillig	positive
schmuckvoll	positive
unübertroffen	positive
unverrichtet	negative
ansprechend	positive
verbraucht	negative
schurkisch	negative
neuwertig	positive
korrekturbedürftig	negative
waffenfähig	positive
tauglich	positive
dementsprechend	positive
demgemäss	positive
zutreffend	positive
verderbt	negative
unrühmlich	negative
leutselig	positive
aktiv	positive
unansehnlich	negative
geil	positive
sexy	positive
vorzeigbar	positive
ansehnlich	positive
erträglich	positive
fürsorglich	positive
unerreicht	positive
marktbeherrschend	positive
marktführend	positive
tanzbar	positive
entspannend	positive
erholsam	positive
gesundheitsförderlich	positive
gesundheitsdienlich	positive
streitlustig	negative
wettbewerbsfähig	positive
konkurrenzfähig	positive
fördernd	positive
förderlich	positive
griffig	positive
himmelschreiend	negative
toll	positive
katastrophal	negative
possierlich	positive
arkadisch	positive
wertig	positive
erkoren	positive
huldreich	positive
erlernbar	positive
magnetisierbar	positive
bespielbar	positive
gekonnt	positive
wahrheitsgemäss	positive
sinngemäss	positive
vorteilhaft	positive
auserwählt	positive
prädestiniert	positive
auserkoren	positive
vorbestimmt	positive
erlebbar	positive
gebührend	positive
erprobt	positive
bewährt	positive
probat	positive
eminent	positive
qualitätvoll	positive
rufschädigend	negative
heilsam	positive
unbedenklich	positive
probiotisch	positive
heilend	positive
unattraktiv	negative
herausfordernd	negative
fleischlich	positive
sanftmütig	positive
gedeihlich	positive
gesundheitsschädlich	negative
gesundheitsschädigend	negative
vorgeblich	negative
abgewrackt	negative
lagerfähig	positive
ungiftig	positive
geniessbar	positive
bekömmlich	positive
essbar	positive
verdaulich	positive
umweltverträglich	positive
erstattungsfähig	positive
erpresserisch	negative
wohlproportioniert	positive
provokativ	negative
singbar	positive
bildhübsch	positive
rassig	positive
apart	positive
untauglich	negative
empörend	negative
annehmbar	positive
hinnehmbar	positive
vertretbar	positive
stadtverträglich	positive
menschenverträglich	positive
gesellschaftsverträglich	positive
wirtschaftsverträglich	positive
sozialverträglich	positive
naturverträglich	positive
praxisgerecht	positive
mephistophelisch	negative
luziferisch	negative
abzugsfähig	positive
vaterlandslos	negative
streitsüchtig	negative
gehässig	negative
bissig	negative
aufhetzend	negative
aufwiegelnd	negative
zänkisch	negative
zanksüchtig	negative
qualitätsvoll	positive
unannehmbar	negative
freundlich	positive
unvertretbar	negative
dienlich	positive
passabel	positive
magenverträglich	positive
hautverträglich	positive
seriös	positive
reaktionsfähig	positive
hetzerisch	negative
demagogisch	negative
kriegerisch	negative
forsch	negative
amateurhaft	negative
prunkvoll	positive
pompös	positive
malerisch	positive
absurd	negative
abstrus	negative
eklig	negative
unerträglich	negative
arg	negative
unverträglich	negative
kontraproduktiv	negative
giftig	negative
provozierend	negative
glückselig	positive
druckfähig	positive
friedfertig	positive
barsch	negative
umgänglich	positive
unziemlich	negative
astrein	positive
knorke	positive
dufte	positive
fabelhaft	positive
prunkhaft	positive
perfid	negative
schiefgelaufen	negative
schiefgegangen	negative
danebengegangen	negative
fehlgeschlagen	negative
trinkbar	positive
traumatisierend	negative
vernichtend	negative
verheerend	negative
griesgrämig	negative
nett	positive
muffelig	negative
miesepetrig	negative
zünftig	positive
super	positive
top	positive
anoxisch	negative
erfolgsverwöhnt	positive
erfolgsgewöhnt	positive
siegreich	positive
fündig	positive
wohlgesonnen	positive
wohlgesinnt	positive
gesinnt	positive
freundschaftlich	positive
kameradschaftlich	positive
partnerschaftlich	positive
kumpelhaft	positive
wahrhaft	positive
mischbar	positive
verlebt	negative
potthässlich	negative
börsenfähig	positive
jovial	positive
kollegial	positive
menschenwürdig	positive
menschenfreundlich	positive
situationsgerecht	positive
unbillig	negative
handlich	positive
förderungswürdig	positive
verlockend	positive
verheissungsvoll	positive
stilecht	positive
originalgetreu	positive
unverfälscht	positive
verantwortbar	positive
solid	positive
solide	positive
reputierlich	positive
hautfreundlich	positive
hart	negative
hinderlich	negative
störend	negative
selbstzerstörerisch	negative
selbstschädigend	negative
bodenlos	negative
bedenklich	negative
hochseetüchtig	positive
betulich	positive
protokollarisch	positive
begünstigend	positive
mildernd	positive
wartungsfreundlich	positive
froh	positive
steinhart	negative
treu sorgend	positive
treusorgend	positive
musterhaft	positive
zukunftsweisend	positive
zukunftweisend	positive
verfassungstreu	positive
verfassungsgemäss	positive
staatskonform	positive
verfassungskonform	positive
fest	negative
verarbeitbar	positive
traurig	negative
gefährlich	negative
unbrauchbar	negative
abrufbar	positive
zugreifbar	positive
erschliessbar	positive
abbaubar	positive
tragisch	negative
müssig	negative
überflüssig	negative
scharf	positive
ranzig	negative
niedrig	negative
unbefleckt	positive
leberschädigend	negative
nervenschädlich	negative
nervenschädigend	negative
stark	positive
lebensbejahend	positive
lebenslustig	positive
lebensfroh	positive
heilfroh	positive
grazil	positive
freudlos	negative
alltagstauglich	positive
praxistauglich	positive
flugtauglich	positive
geländetauglich	positive
kriegstauglich	positive
diensttauglich	positive
fahrtauglich	positive
zweckentsprechend	positive
ausbaufähig	positive
erneuerbar	positive
renovierbar	positive
instandsetzbar	positive
verwertbar	positive
lizenzkonform	positive
scheusslich	negative
entsetzlich	negative
abscheulich	negative
verabscheuungswürdig	negative
tendenziös	negative
parteiisch	negative
klobig	negative
produktiv	positive
unverschuldet	positive
aristokratisch	positive
adlig	positive
adelig	positive
nobel	positive
vornehm	positive
augenschädigend	negative
nieder	negative
blaublütig	positive
stahlhart	negative
sittenlos	negative
unmoralisch	negative
unsittlich	negative
wüst	negative
ungehobelt	negative
klimaschädigend	negative
ernsthaft	positive
unterlegt	positive
fundiert	positive
handfest	positive
stichhaltig	positive
vorgeschoben	negative
fadenscheinig	negative
unverdaulich	negative
fraglich	negative
zweifelhaft	negative
angreifbar	negative
anfechtbar	negative
umstritten	negative
strittig	negative
geruhsam	positive
wohl temperiert	positive
wohltemperiert	positive
abbauwürdig	positive
behaglich	positive
gemütlich	positive
bestechlich	negative
korrupt	negative
käuflich	negative
menschlich	positive
bärenstark	positive
hirnrissig	negative
seetüchtig	positive
liederlich	negative
lasterhaft	negative
zügellos	negative
ausschweifend	negative
entartet	negative
dekadent	negative
heruntergekommen	negative
sportlich	positive
rechtmässig	positive
legitim	positive
bibeltreu	positive
sachfremd	negative
komfortabel	positive
wohltuend	positive
bequem	positive
zufriedenstellend	positive
unangenehm	negative
wohlig	positive
befriedigend	positive
harsch	negative
gemeinschaftsschädigend	negative
gesellschaftsunfähig	negative
glänzend	positive
gesund	positive
mörderisch	negative
höllisch	negative
tragbar	positive
duftig	positive
heuchlerisch	negative
bigott	negative
scheinheilig	negative
unredlich	negative
illegitim	negative
unrechtmässig	negative
weisungsbefugt	positive
wahlberechtigt	positive
erziehungsberechtigt	positive
roh	negative
drollig	positive
steuergünstig	positive
krass	positive
beinhart	negative
eisenhart	negative
knallhart	negative
stumpf	negative
wund	negative
blutig	negative
lädiert	negative
widerrechtlich	negative
rechtswidrig	negative
kriegsmüde	negative
lethargisch	negative
seelsorglich	positive
aushaltbar	positive
irritierend	negative
grobschlächtig	negative
ungeschlacht	negative
erledigt	negative
fahrtüchtig	positive
internetfähig	positive
diebisch	negative
apokryph	negative
wachstumsfördernd	positive
todtraurig	negative
hochzufrieden	positive
vergnügt	positive
preussisch	positive
gewissenhaft	positive
leberschädlich	negative
nierenschädlich	negative
nierenschädigend	negative
verwirrend	negative
fehlleitend	negative
lebensuntüchtig	negative
unproduktiv	negative
feingemahlen	positive
mildtätig	positive
wohltätig	positive
caritativ	positive
karitativ	positive
polemisch	negative
pedantisch	positive
penibel	positive
förmlich	positive
achtsam	positive
sorgsam	positive
ordnungsliebend	positive
leistungsfördernd	positive
hartgesotten	negative
seelenruhig	negative
abgezockt	negative
kaltschnäuzig	negative
ausgekocht	negative
abgebrüht	negative
wolkenbruchartig	negative
feinkörnig	positive
krude	negative
krud	negative
seelsorgerisch	positive
seelsorgerlich	positive
vierschrötig	negative
rein	positive
wichtigtuerisch	negative
ehrbar	positive
unflätig	negative
ungelegen	negative
deplaziert	negative
deplatziert	negative
unverdient	negative
verschorft	negative
entzündet	negative
zugänglich	positive
eiternd	negative
eitrig	negative
vereitert	negative
blessiert	negative
marktreif	positive
menschenunwürdig	negative
kaltblütig	negative
bestialisch	negative
unmenschlich	negative
menschenverachtend	negative
inhuman	negative
umweltgefährdend	negative
unfähig	negative
wählbar	positive
bucklig	negative
buckelig	negative
verwachsen	negative
formschön	positive
formvollendet	positive
unverbindlich	negative
versöhnlich	positive
hehr	positive
achtbar	positive
ruhmvoll	positive
glorreich	positive
irreführend	negative
waschecht	positive
orgiastisch	negative
unerreichbar	positive
zerbeult	negative
undifferenziert	negative
doll	positive
verbindlich	positive
ästhetisch	positive
bedrohlich	negative
energisch	positive
energiegeladen	positive
allerbeste	positive
ehrenwert	positive
liebreizend	positive
lieblich	positive
charismatisch	positive
verführerisch	positive
verehrungswürdig	positive
unwiderstehlich	positive
begehrenswert	positive
charmant	positive
scharmant	positive
kokett	positive
umweltbelastend	negative
feil	positive
fahrstuhlgerecht	positive
verschwitzt	negative
verwahrlost	negative
unerbittlich	negative
verzerrungsfrei	positive
distinguiert	positive
abgeklärt	positive
würdig	positive
würdevoll	positive
honorabel	positive
honett	positive
sonnig	positive
hochgiftig	negative
angeschlagen	negative
wegweisend	positive
findig	positive
zukunftsträchtig	positive
unternehmungslustig	positive
arbeitsunwillig	negative
initiativ	positive
grossspurig	negative
human	positive
verleumderisch	negative
verbittert	negative
verkehrssicher	positive
verkehrstauglich	positive
nominell	negative
treffend	positive
trefflich	positive
ruhmreich	positive
löblich	positive
lobenswert	positive
rühmlich	positive
tadelnswert	negative
sträflich	negative
billig	positive
klotzig	negative
verkaufsfördernd	positive
unfein	negative
leidlich	positive
zumutbar	positive
trübsinnig	negative
nutzungsberechtigt	positive
werkgetreu	positive
ungefärbt	positive
unwürdig	negative
würdelos	negative
verlottert	negative
verkommen	negative
unappetitlich	negative
ungepflegt	negative
schmuddelig	negative
vergammelt	negative
verlumpt	negative
konstruktiv	positive
behilflich	positive
wohlwollend	positive
gutgemeint	positive
behütend	positive
schützend	positive
wohlmeinend	positive
beispielgebend	positive
augenschädlich	negative
rollstuhlgerecht	positive
wehrfähig	positive
bekümmert	negative
klimaschädlich	negative
flugunfähig	negative
treffsicher	positive
krankenhausreif	negative
schwerverwundet	negative
schwerverletzt	negative
verwundet	negative
erholungsbedürftig	negative
urlaubsreif	negative
groggy	negative
antibiotisch	positive
mitgenommen	negative
unseriös	negative
veritabel	positive
gesundheitsabträglich	negative
kolloid	positive
kolloidal	positive
leidtragend	negative
leid tragend	negative
wohlfeil	positive
erschwinglich	positive
auserlesen	positive
ausgesucht	positive
erlaucht	positive
unteilbar	negative
traumatisch	negative
cool	positive
enthaltsam	positive
keusch	positive
unerprobt	negative
krisenerfahren	positive
unbewährt	negative
kampferprobt	positive
krisenerprobt	positive
tollwütig	positive
unzufrieden	negative
todunglücklich	negative
einsam	negative
arbeitsunfähig	negative
defensiv	positive
spottbillig	positive
betroffen	negative
hilfsbereit	positive
abstinent	positive
entsagend	positive
entsagungsvoll	positive
hilfreich	positive
deprimiert	negative
zivil	positive
originell	positive
antiphlogistisch	positive
prätentiös	negative
urtümlich	positive
kannibalisch	negative
wehrdienstfähig	positive
wehruntauglich	negative
verkehrsuntauglich	negative
wehrtauglich	positive
lebensunfähig	negative
gewinnbar	positive
fragil	positive
sintflutartig	negative
erleichtert	positive
triftig	positive
aufrührerisch	positive
aufwieglerisch	positive
betörend	positive
aktionistisch	positive
intersubjektiv	negative
kostengünstig	positive
nachteilig	negative
bedienbar	positive
zerbrechlich	positive
filigran	positive
phlegmatisch	negative
torgefährlich	negative
entzündungshemmend	positive
verfassungswidrig	negative
gesetzwidrig	negative
ruinös	negative
altbewährt	positive
traditionsreich	positive
ausgereift	positive
unausgewogen	negative
angeberisch	negative
grossmäulig	negative
prahlerisch	negative
reichverziert	positive
reich verziert	positive
regelkonform	positive
erbberechtigt	positive
stimmberechtigt	positive
ausgepowert	negative
angepasst	positive
entkräftet	negative
abgespannt	negative
erweiterbar	positive
anständig	positive
magenfreundlich	positive
bedienungsfreundlich	positive
kundenfreundlich	positive
leserfreundlich	positive
unverfroren	negative
impertinent	negative
lautstark	negative
unverschämt	negative
vorlaut	negative
vollmundig	negative
ungezogen	negative
benutzbar	positive
undankbar	negative
grosskotzig	negative
preisgünstig	positive
preiswert	positive
finanzierbar	positive
bezahlbar	positive
honorig	positive
auswertbar	positive
ausgelaugt	negative
ungeniessbar	negative
unbekömmlich	negative
ausgebrannt	negative
erschöpft	negative
ausgepumpt	negative
praktikabel	positive
aufnahmefähig	positive
bewegungsunfähig	negative
schnippisch	negative
scharfzüngig	negative
zynisch	negative
höhnisch	negative
unzuständig	negative
hochherrschaftlich	positive
experimentierfreudig	positive
handlungsunfähig	negative
konjunkturverträglich	positive
pflanzenverträglich	positive
klimaverträglich	positive
landschaftsverträglich	positive
kampferfahren	positive
infernal	negative
verfallen	negative
verrottet	negative
schimmelig	negative
verschimmelt	negative
erweiterungsfähig	positive
ungeschönt	positive
spöttisch	negative
spitzfindig	negative
schnoddrig	negative
marktgerecht	positive
unterstützend	positive
subsidiär	positive
mannschaftstauglich	positive
mannschaftsdienlich	positive
weisungsberechtigt	positive
wohnberechtigt	positive
sorgeberechtigt	positive
anspruchsberechtigt	positive
teilnahmeberechtigt	positive
vertretungsberechtigt	positive
heimatberechtigt	positive
vollberechtigt	positive
spielberechtigt	positive
gediegen	positive
investitionsfreundlich	positive
menschenfeindlich	negative
unerlaubt	negative
verboten	negative
manövrierunfähig	negative
netzwerkfähig	positive
bedrückt	negative
ausersehen	positive
reumütig	negative
speicherbar	positive
unblutig	positive
angezeigt	positive
zytotoxisch	negative
ausserstande	negative
aberwitzig	negative
irrwitzig	negative
ritterlich	positive
unzumutbar	negative
faulig	negative
verfault	negative
anbaufähig	positive
wohlbegründet	positive
exemplarisch	positive
kontrovers	negative
belämmert	negative
feindlich	negative
säuerlich	negative
systemkonform	positive
philanthropisch	positive
ungeschlagen	positive
unbesiegt	positive
missbräuchlich	negative
aufladbar	positive
bestreitbar	negative
vorbestraft	negative
bescheuert	negative
behämmert	negative
stimmfähig	positive
zweitbeste	positive
humanitär	positive
hochadelig	positive
frei	positive
phantasiereich	positive
fantasiereich	positive
tränenreich	negative
selbständig	positive
selbstständig	positive
schwach	negative
flüssig	positive
standhaft	positive
integer	positive
charakterfest	positive
unerfreulich	negative
schwermütig	negative
misslich	negative
ordentlich	positive
kleinadelig	positive
kleinadlig	positive
heillos	negative
kopflos	negative
uferlos	negative
schuldunfähig	negative
beziehungsunfähig	negative
strafmildernd	positive
strafsenkend	positive
ausgelassen	positive
betrüblich	negative
schöngeistig	positive
fröhlich	positive
erfreulich	positive
wehmütig	negative
freudig	positive
kerngesund	positive
altpreussisch	positive
multitaskingfähig	positive
haftunfähig	negative
plebejisch	negative
dankbar	positive
schamlos	negative
pikant	negative
frivol	negative
anstössig	negative
clean	positive
vulgär	negative
ordinär	negative
gesundet	positive
verheilt	positive
stramm	negative
locker	positive
absolutistisch	positive
risikoreich	negative
riskant	negative
gefestigt	positive
stechend	positive
beissend	positive
bürgerlich	negative
allerlei	positive
viele	positive
gesucht	positive
naturgegeben	positive
durchtrainiert	positive
lustbetont	positive
befreit	positive
lustvoll	positive
erlöst	positive
beruhigt	positive
trist	negative
enttäuscht	negative
trübselig	negative
betrübt	negative
tieftraurig	negative
trostlos	negative
melancholisch	negative
deprimierend	negative
bitter	negative
altadlig	positive
altadelig	positive
ekel erregend	negative
ekelerregend	negative
ekelhaft	negative
linkslastig	negative
rechtslastig	negative
königlich	positive
feudalistisch	positive
feudal	positive
höfisch	positive
rangnieder	negative
offen	positive
existenzbedrohend	negative
unmässig	positive
wuchtig	negative
ozonschädigend	negative
plump	negative
ernst	negative
ozonschädlich	negative
mütterlich	positive
abgewirtschaftet	negative
abgegriffen	negative
heruntergewirtschaftet	negative
kopfballstark	positive
royal	positive
fürstlich	positive
kaiserlich	positive
erhaben	positive
winkeltreu	positive
muskelbepackt	positive
sündig	negative
sündhaft	negative
verrucht	negative
obskur	negative
eklatant	positive
unvermindert	positive
gewaltig	positive
trainiert	positive
kernig	positive
stabil	negative
konditionsstark	positive
fit	positive
athletisch	positive
sportiv	positive
hartherzig	negative
ererbt	positive
angestammt	positive
zustehend	positive
ungekocht	negative
streitig	negative
unbequem	negative
unbefriedigend	negative
einladend	positive
restringiert	negative
schimmernd	positive
changierend	positive
schillernd	positive
goldglänzend	positive
intensiv	positive
marktschreierisch	negative
hochglänzend	positive
kraftvoll	positive
abgehärtet	negative
kräftig	positive
zäh	positive
widerstandsfähig	positive
kaltherzig	negative
kalt	negative
tragikomisch	negative
flach	negative
abgrundtief	negative
unkomfortabel	negative
blind	negative
erdrückend	negative
bedrückend	negative
belastend	negative
mulmig	negative
abstossend	negative
unsympathisch	negative
unbehaglich	negative
ungemütlich	negative
beklemmend	negative
gewichtig	positive
gravierend	positive
regenerativ	positive
blank	positive
sorgfältig	positive
unelastisch	negative
spitz	negative
fix	negative
ungelenk	negative
ungelenkig	negative
gegeben	negative
feststehend	negative
hölzern	negative
holprig	negative
staksig	negative
unhaltbar	negative
untragbar	negative
haltbar	positive
abenteuerlustig	positive
peinlich	positive
humorlos	positive
befremdlich	negative
beängstigend	negative
schwer wiegend	positive
schwerwiegend	positive
wohnlich	positive
hochgradig	positive
obszön	negative
pharisäisch	negative
silbrig	positive
lebensbedrohend	negative
massstäblich	positive
zuständig	positive
federführend	positive
klar	positive
unflexibel	negative
unbeweglich	negative
starr	negative
preiswürdig	positive
regierungsfähig	positive
gebrauchsfähig	positive
messerscharf	positive
antideutsch	negative
deutschfeindlich	negative
letal	negative
verstärkt	positive
wertstabil	negative
richtungsstabil	negative
urig	positive
leistungsstark	positive
reinlich	positive
betretbar	positive
ungehindert	positive
passierbar	positive
begehbar	positive
befahrbar	positive
raffiniert	negative
ausgebufft	negative
standesherrlich	positive
massstabsgerecht	positive
lustfeindlich	negative
hochrein	positive
grobkörnig	negative
grob	negative
parteifeindlich	negative
vielerlei	positive
methodisch	positive
überstark	positive
unprätentiös	positive
erstrangig	positive
wirklichkeitsgetreu	positive
kaiserfeindlich	negative
männerfeindlich	negative
christenfeindlich	negative
demokratiefeindlich	negative
religionsfeindlich	negative
minderheitenfeindlich	negative
regimefeindlich	negative
unverantwortbar	negative
unbekümmert	positive
dynamisch	positive
reizend	positive
kitschig	positive
mundgerecht	positive
hochgefährlich	negative
behindertenfeindlich	negative
wissenschaftsfeindlich	negative
reformfeindlich	negative
islamfeindlich	negative
kulturfeindlich	negative
leibfeindlich	negative
körperfeindlich	negative
kunstfeindlich	negative
gesellschaftsfeindlich	negative
verpflichtend	positive
bindend	positive
feingeistig	positive
ehrsam	positive
lästig	negative
leistungsfähig	positive
scharfkantig	positive
strapaziös	negative
druckvoll	positive
risikobehaftet	negative
abgerissen	negative
gammelig	negative
gammlig	negative
lumpig	negative
souverän	positive
unumschränkt	positive
absolut	positive
machtvoll	positive
naturbedingt	positive
nervig	negative
spielfreudig	positive
vergnügungsorientiert	positive
freizeitorientiert	positive
arbeitsscheu	negative
antiklerikal	negative
republikfeindlich	negative
mancherlei	positive
schwulenfeindlich	negative
regierungsfeindlich	negative
verhärtet	negative
vergrätzt	negative
vergrämt	negative
selbstsicher	positive
selbstbewusst	positive
nominal	negative
unhandlich	negative
allein	negative
lebensmüde	negative
rüstig	positive
heil	positive
massgeschneidert	positive
glanzvoll	positive
einnehmend	positive
gewinnend	positive
konzertiert	positive
unbewacht	positive
väterlich	positive
einhellig	positive
kräftezehrend	negative
resistent	positive
quietschfidel	positive
immun	positive
blutverschmiert	negative
eigenständig	positive
durchsetzungsfähig	positive
konfliktfähig	positive
gedankenvoll	negative
regelbar	positive
krank	negative
massgerecht	positive
naturgetreu	positive
stimmig	positive
abgestimmt	positive
skalierbar	positive
unscharf	negative
unstrittig	positive
strähnig	negative
ölig	negative
fettig	negative
untrainiert	negative
beschämt	negative
flugfähig	positive
unschicklich	negative
anpassbar	positive
abgelaufen	negative
zierlich	positive
berufsunfähig	negative
volksfeindlich	negative
geistfeindlich	negative
unverkrampft	positive
unbenutzbar	negative
untröstlich	negative
handlungsfähig	positive
wohlerzogen	positive
homolog	positive
bildungsfeindlich	negative
fortschrittsfeindlich	negative
salopp	positive
spielerisch	positive
damenhaft	positive
fähig	positive
unbefriedigt	negative
zerlumpt	negative
allgemeinverbindlich	positive
allgemein verbindlich	positive
schmiedbar	positive
übrig	positive
vereinsamt	negative
verlassen	negative
gefahrvoll	negative
unbehindert	positive
imstande	positive
beschlussfähig	positive
mehrheitsfähig	positive
wandlungsfähig	positive
anpassungsfähig	positive
einsatzfähig	positive
arbeitsfähig	positive
rezeptiv	positive
verzagt	positive
zögerlich	positive
zauderhaft	positive
schwanzgesteuert	positive
sexgierig	positive
sexhungrig	positive
lüstern	positive
frigid	negative
fertig	negative
bedröppelt	negative
unerschwinglich	negative
israelfeindlich	negative
begossen	negative
gelackmeiert	negative
hochadlig	positive
unbegabt	negative
untalentiert	negative
aufgebraucht	negative
teuer	negative
übereinkommend	positive
verdient	positive
verdienstvoll	positive
lebensfähig	positive
geistesklar	positive
bearbeitbar	positive
genesen	positive
sortenrein	positive
elegisch	negative
druckfest	negative
benutzerfreundlich	positive
anwenderfreundlich	positive
zotig	negative
niederrangig	negative
zerlegbar	positive
akut	positive
vordringlich	positive
explosionsgefährlich	negative
brandgefährlich	negative
unachtsam	negative
unausgereift	negative
unausgegoren	negative
quietschvergnügt	positive
gemeinfrei	positive
muskulös	positive
schaltbar	positive
lupenrein	positive
unrein	negative
koscher	positive
steril	positive
keimfrei	positive
westpreussisch	positive
südpreussisch	positive
kreativ	positive
schöpferisch	positive
phantasievoll	positive
fantasievoll	positive
erfinderisch	positive
einfallsreich	positive
ideenreich	positive
kirchenfeindlich	negative
hieratisch	negative
dahinterstehend	positive
adaptiv	positive
rechtsfähig	positive
wiederaufladbar	positive
getragen	positive
xenophob	negative
serienreif	positive
beleidigend	negative
ausfallend	negative
sarkastisch	negative
ironisch	negative
gerichtsverwertbar	positive
verspielt	positive
einstellbar	positive
qualvoll	negative
recyclingfähig	positive
regenerationsfähig	positive
wiederverwertbar	positive
gehfähig	positive
montierbar	positive
schliessbar	positive
bravourös	positive
lauschig	positive
unkeusch	negative
handhabbar	positive
dubios	negative
rechtsverbindlich	positive
völkerrechtswidrig	negative
wolkig	negative
sommerlich-sonnig	positive
bewölkt	negative
pur	positive
familienfeindlich	negative
staatsfeindlich	negative
erlaubt	positive
mühevoll	negative
stressig	negative
anstrengend	negative
überhart	positive
unzurechnungsfähig	negative
nachrüstbar	positive
schmelzbar	positive
megascharf	positive
anerkennenswert	positive
unanfechtbar	positive
schmierig	negative
entbehrungsreich	negative
regulierbar	positive
massstabsgetreu	positive
kompostierbar	positive
ausländerfeindlich	negative
fremdenfeindlich	negative
frauenfeindlich	negative
rassistisch	negative
umweltfeindlich	negative
verfassungsfeindlich	negative
schweisstreibend	negative
schutzfähig	positive
kampfunfähig	negative
immobil	negative
unbestritten	positive
preisstabil	negative
weich	positive
tödlich	negative
lebensbedrohlich	negative
lebensgefährlich	negative
haftfähig	positive
kompromissfähig	positive
feindselig	negative
feindschaftlich	negative
zölibatär	positive
süsslich	positive
zuckersüss	positive
ortsfest	negative
hoch	positive
erfindungsreich	positive
genusssüchtig	negative
urwüchsig	positive
freiherrlich	positive
unbezähmbar	positive
technikfeindlich	negative
kaiserlich-königlich	positive
erwerbsunfähig	negative
dienstunfähig	negative
unzüchtig	negative
heimelig	positive
freiwillig	positive
unbefangen	positive
labil	negative
verloren	negative
instabil	negative
gefährdet	negative
hilflos	negative
los	positive
lose	positive
schlabbrig	positive
schlabberig	positive
demoralisierend	negative
entmutigend	negative
bedauerlich	negative
schade	negative
unerquicklich	negative
bedauernswert	negative
avantgardistisch	positive
züchtig	positive
mühelos	positive
beunruhigend	negative
alptraumhaft	negative
alptraumartig	negative
unheimlich	negative
alarmierend	negative
ungeheuer	negative
schauderhaft	negative
schaudervoll	negative
teamfähig	positive
aktionsfähig	positive
ausdrucksfähig	positive
einsichtsfähig	positive
urteilsfähig	positive
feuerflüssig	positive
leichtflüssig	positive
verschwommen	negative
steif	negative
eben	negative
furchteinflössend	negative
unpassierbar	negative
gross	positive
gebrauchsfertig	negative
deckenhoch	positive
wadenhoch	positive
brusthoch	positive
baureif	negative
zwanglos	positive
unabhängig	positive
metamorph	positive
leichtfertig	negative
übermütig	positive
unstreitig	positive
brüchig	positive
fluffig	positive
porös	positive
mehlig	positive
unselbstständig	negative
unselbständig	negative
heiter	positive
erquicklich	positive
niederschmetternd	negative
unordentlich	negative
rau	negative
säuberlich	positive
diesig-kalt	negative
geisterhaft	negative
gespenstig	negative
grauenerregend	negative
grauen erregend	negative
gruselig	negative
schaurig	negative
schauerhaft	negative
schauerlich	negative
gespensterhaft	negative
gespenstisch	negative
kritikfähig	positive
leidensfähig	positive
dialogfähig	positive
erreichbar	negative
trittsicher	positive
zittrig	negative
rosig	positive
hoch dosiert	positive
hochdosiert	positive
hochkonzentriert	positive
staatsbürgerlich	negative
visumfrei	positive
erbkrank	negative
befangen	negative
unversehrt	positive
unverletzt	positive
unbesetzt	positive
unbelegt	positive
leichtfüssig	positive
frohgemut	positive
launig	positive
gut aufgelegt	positive
gutgelaunt	positive
gut gelaunt	positive
überschwänglich	positive
nachdrücklich	positive
eindringlich	positive
dünnflüssig	positive
schrecken erregend	negative
schreckenerregend	negative
spukhaft	negative
angsterregend	negative
angst erregend	negative
ostpreussisch	positive
schüchtern	positive
aromatisch	positive
streng	positive
hochwüchsig	positive
druckfertig	negative
abgedroschen	positive
gutbürgerlich	negative
kleinbürgerlich	negative
spiessig	negative
spiesserhaft	negative
furios	positive
masslos	positive
freiheitlich	positive
tolerant	positive
uneinnehmbar	positive
übertrieben	positive
verkrampft	negative
oberflächlich	negative
lebendig	positive
beschwingt	positive
exzessiv	negative
schmalzig	negative
zartbitter	negative
wahnwitzig	negative
kuschlig	positive
kuschelig	positive
widerlich	negative
widerwärtig	negative
furcht erregend	negative
furchterregend	negative
wohlverdient	positive
unumstösslich	positive
raubeinig	negative
schutzwürdig	positive
weinerlich	negative
protzig	positive
unbändig	positive
unauffallend	negative
unauffällig	negative
warmherzig	positive
heftig	positive
dicht	negative
unstabil	positive
standfest	positive
mutterlos	negative
bruchfest	negative
mietfrei	positive
schmelzflüssig	positive
betriebsbereit	negative
majestätisch	positive
mächtig	positive
entschieden	positive
hold	positive
feuchtfröhlich	positive
gewaltsam	positive
offengelassen	positive
offen gelassen	positive
robust	negative
hoch verschuldet	positive
hochverschuldet	positive
anzüglich	negative
altersschwach	negative
halbfertig	negative
soft	positive
fahrbereit	negative
hochwürdig	positive
paarungswillig	negative
frostsicher	positive
bombensicher	positive
morbide	negative
geneigt	positive
unverblümt	positive
extrovertiert	positive
direkt	positive
freimütig	positive
aufgeschlossen	positive
empfänglich	positive
extravertiert	positive
offenherzig	positive
gangbar	positive
glühend	positive
tiefgreifend	positive
gründlich	positive
tiefgehend	positive
tiefschürfend	positive
unverwüstlich	positive
vital	positive
geöffnet	positive
geschlossen	negative
lächerlich	positive
tief	positive
steil	positive
erhöht	positive
wasserfest	negative
beschaulich	positive
blitzeblank	positive
blitzblank	positive
blankgeputzt	positive
gewienert	positive
rauchschwach	negative
willensschwach	negative
sehschwach	negative
ungeschliffen	negative
auffallend	positive
betont	positive
tiefreichend	positive
entlegen	negative
humorvoll	negative
humorig	positive
erwerbsfähig	positive
krüppelhaft	negative
krüppelig	negative
magersüchtig	negative
unheilvoll	negative
unheilschwanger	negative
unheil verheissend	negative
unheilverheissend	negative
besorgniserregend	negative
ungezügelt	negative
gestattet	positive
halboffen	positive
euphorisch	positive
überschäumend	positive
überbordend	positive
überlebensfähig	positive
unbeschwert	positive
gewogen	positive
entschlossen	positive
resolut	positive
kindgemäss	positive
kampffähig	positive
warm	positive
nervenschwach	negative
muskelschwach	negative
psychotisch	negative
feuerfest	negative
lustig	positive
sperrig	negative
hitzestabil	negative
formstabil	negative
thermostabil	negative
cremig	positive
gesperrt	negative
gewaltbereit	negative
gebührenlos	positive
gebührenfrei	positive
leuchtend	positive
auffällig	positive
lebhaft	positive
schneidig	positive
vertrauensvoll	positive
unkultiviert	negative
ruppig	negative
rüpelhaft	negative
schlampig	negative
gelenkig	positive
flexibel	positive
beweglich	positive
mobil	positive
elastisch	positive
natürlich	positive
charakterschwach	negative
druckreif	negative
grundsolide	positive
grundsolid	positive
bleich	negative
blass	negative
frevlerisch	negative
lästerlich	negative
unmusikalisch	negative
starrköpfig	negative
rigide	negative
rigid	negative
todkrank	negative
rigoros	negative
hochverdient	positive
unverzeihlich	negative
unentschuldbar	negative
verantwortungslos	negative
unverantwortlich	negative
sicher	positive
mittelhoch	positive
immunschwach	negative
konditionsschwach	negative
genant	positive
genierlich	positive
erkältet	negative
diabetisch	negative
delikat	negative
übrig geblieben	positive
übriggeblieben	positive
bezaubernd	positive
hinreissend	positive
zauberhaft	positive
entzückend	positive
bezückend	positive
orthodox	negative
betriebssicher	positive
ungeniert	positive
zusammen	positive
eingehend	positive
fantasielos	negative
phantasielos	negative
chronisch	negative
farbschwach	negative
entscheidungsschwach	negative
beitragsfrei	positive
anämisch	negative
kontaktierbar	negative
quick	positive
kostspielig	negative
mild	negative
zeremoniell	positive
bekannt	positive
publik	positive
einzig	negative
verwaist	negative
alleinig	negative
witterungsbeständig	negative
nasskalt	negative
verdriesslich	negative
leidig	negative
vertrauenerweckend	positive
vertrauen erweckend	positive
ungehemmt	negative
vakant	positive
unzerstörbar	negative
freisinnig	positive
überzählig	positive
mündelsicher	positive
siegesbewusst	positive
siegesgewiss	positive
siegessicher	positive
staatsmännisch	positive
vereinzelt	negative
einzeln	negative
winterhart	positive
durchschlagskräftig	positive
sympathisch	positive
sympathie erweckend	positive
sympathieerweckend	positive
kugelsicher	positive
winterlich	negative
herbstlich	negative
nervtötend	negative
hinfällig	negative
zart	negative
anfällig	negative
hochgelegen	positive
hoch gelegen	positive
strapazierfähig	negative
geheim	negative
unbeirrbar	positive
schlagkräftig	positive
streitbar	positive
konsequent	positive
thermodynamisch	positive
lenkbar	positive
verschliessbar	positive
kindgerecht	positive
artgemäss	positive
kindgetreu	positive
artgerecht	positive
selbstmörderisch	negative
alkoholkrank	negative
hochstämmig	positive
cäsarisch	positive
flächentreu	positive
gefangen	negative
lawinensicher	positive
froh gelaunt	positive
frohgelaunt	positive
kraftlos	negative
memmenhaft	negative
schlapp	negative
schwächlich	negative
mickerig	negative
schlaff	negative
gebrechlich	negative
kostenintensiv	negative
kränkelnd	negative
kränklich	negative
schicklich	positive
flugbereit	negative
verstrichen	negative
unverzagt	negative
raumhoch	positive
hüfthoch	positive
turmhoch	positive
aufwändig	negative
aufwendig	negative
generalstabsmässig	positive
statisch	negative
eisig	negative
salomonisch	positive
eisigkalt	negative
eiskalt	negative
heiser	negative
spiesserisch	negative
aidskrank	negative
lungenkrank	negative
krebskrank	negative
herzkrank	negative
zuckerkrank	negative
gallenkrank	negative
leberkrank	negative
nierenkrank	negative
drüsenkrank	negative
magenkrank	negative
gesittet	positive
prüde	positive
schamhaft	positive
kostenfrei	positive
unentgeltlich	positive
ausgesprochen	positive
einschichtig	negative
neckisch	positive
höflich	positive
sittsam	positive
startbereit	negative
fehlbar	negative
übermannshoch	positive
knöchelhoch	positive
halbhoch	positive
kniehoch	positive
meterhoch	positive
mannshoch	positive
ranghoch	positive
restlich	positive
vorrätig	positive
weltoffen	positive
frigide	negative
startklar	negative
startfertig	negative
bereit	negative
beziehbar	negative
schlüsselfertig	negative
bezugsfertig	negative
kostenlos	positive
tuberkulös	negative
lichtschwach	negative
adagio	positive
largo	positive
allegro	positive
unbezahlbar	negative
stachelig	negative
stachlig	negative
talentiert	positive
begabt	positive
befähigt	positive
lernfähig	positive
steuerbar	positive
wertvoll	negative
kostbar	negative
öffentlich	positive
selbstironisch	negative
trübe	negative
trüb	negative
eigen	positive
entfernt	negative
offenstehend	positive
offen stehend	positive
offen geblieben	positive
offengeblieben	positive
abgelegen	negative
homophob	negative
aerodynamisch	positive
hochgespannt	positive
schwerkrank	negative
unzivilisiert	negative
spiessbürgerlich	negative
sehnig	positive
drahtig	positive
abschliessbar	positive
altehrwürdig	positive
ehrwürdig	positive
erhaltenswert	positive
hochpreisig	negative
gestalterisch	positive
bildnerisch	positive
elaboriert	positive
keck	positive
schlagfertig	positive
gebirgig	positive
abgeschieden	negative
schiffbar	positive
isoliert	negative
solo	negative
verpanscht	negative
verschmutzt	negative
verunreinigt	negative
unhygienisch	negative
fügsam	positive
gefügig	positive
willfährig	positive
gehorsam	positive
bereitstehend	negative
zähflüssig	positive
zweithöchste	positive
dritthöchste	positive
allerhöchste	positive
kontaminiert	negative
gepanscht	negative
verseucht	negative
empfindungsfähig	positive
kampfbereit	negative
festgefügt	negative
sterbenskrank	negative
unzerbrechlich	negative
unbrennbar	negative
apodiktisch	positive
fidel	positive
zurechnungsfähig	positive
einsatzbereit	negative
dienstbereit	negative
teilrechtsfähig	positive
platt	negative
seicht	positive
dümmlich	positive
derb	negative
abriebfest	negative
durchstimmbar	positive
beherrschbar	positive
wechselwarm	negative
violent	positive
grossbürgerlich	negative
familienfreundlich	positive
kinderfeindlich	negative
ausländerfreundlich	positive
frauenfreundlich	positive
schuldfähig	positive
lichtbeständig	negative
gelinde	negative
masurisch	positive
ehrverletzend	negative
elektrodynamisch	positive
höchstmöglich	positive
technikfreundlich	positive
frostig	negative
judenfeindlich	negative
antisemitisch	negative
charaktervoll	positive
tragfähig	negative
blödsinnig	positive
spielfähig	positive
zahlungsfähig	positive
entwicklungsfähig	positive
streichfähig	positive
hydrodynamisch	positive
kontaktlos	negative
paarungsbereit	negative
unbestreitbar	positive
unumstritten	positive
unangefochten	positive
undurchlässig	negative
unverschlossen	positive
fahrbar	positive
gefährdend	negative
gewagt	negative
grossväterlich	positive
hemmungslos	negative
bindungsfähig	positive
denkfähig	positive
verkrüppelt	negative
gestört	negative
geistesgestört	negative
schwindsüchtig	negative
ungeschützt	negative
geschützt	positive
ungesichert	negative
haushoch	positive
schier	positive
umweltfreundlich	positive
dienstfähig	positive
unleugbar	positive
bildungsbürgerlich	negative
ruiniert	negative
unsanft	negative
spielstark	positive
abhängig	negative
krampfhaft	negative
krampfig	negative
beklommen	negative
betreten	negative
fiebrig	negative
unwiederbringlich	positive
unwiderrufbar	positive
ortsunabhängig	positive
zeitunabhängig	positive
unabänderbar	positive
zutraulich	positive
insolvent	positive
naturalistisch	positive
dienstbar	positive
mürbe	positive
morsch	positive
beeinflussbar	negative
lohnsteuerpflichtig	positive
pestverseucht	negative
darstellerisch	positive
makaber	negative
kabarettistisch	positive
liquide	positive
liquid	positive
leistungsschwach	negative
unklar	negative
nebulös	negative
schwammig	negative
grüblerisch	negative
seidig	negative
uneben	positive
glatt	negative
entgegenkommend	positive
unglückselig	negative
bemitleidenswert	negative
beklagenswert	negative
unrettbar	positive
gasdicht	negative
exorbitant	positive
krampfartig	negative
intolerant	negative
gasgekühlt	negative
autark	positive
bereitwillig	positive
unaufgefordert	positive
willig	positive
herstellerunabhängig	positive
parteiunabhängig	positive
inkonsequent	negative
suchtgefährdet	negative
unfallgefährdet	negative
verführbar	negative
rückfällig	negative
witzig	positive
unwirtlich	negative
lebensnah	positive
lang	positive
wolkenfrei	positive
dunstig	negative
diesig	negative
neblig	negative
nebligtrüb	negative
einträchtig	positive
reissend	positive
zusammengeschlossen	positive
solidarisch	positive
schmackhaft	negative
abschlägig	negative
gottgewollt	positive
üppig	positive
unfrei	negative
zwanghaft	negative
liberal	positive
besetzt	negative
belegt	negative
wacklig	positive
handtellergross	positive
normalgross	positive
millimetergross	positive
handgross	positive
frühlingshaft	negative
inständig	positive
kalifornisch	positive
föhnig	positive
undogmatisch	positive
mürb	positive
verdruckst	positive
verschämt	positive
bieder	negative
hausbacken	negative
überschuldet	positive
unruhig	positive
grundsteuerpflichtig	positive
erbschaftssteuerpflichtig	positive
körperschaftsteuerpflichtig	positive
körperschaftssteuerpflichtig	positive
ablehnend	negative
abweisend	negative
zugeknöpft	negative
stocksteif	negative
zurückweisend	negative
viel	positive
zweitgrösste	positive
wiedergeboren	positive
rauhaarig	negative
gehemmt	negative
verklemmt	negative
gezwungen	negative
verkniffen	negative
ersichtlich	positive
klischeehaft	negative
plakativ	negative
hintergründig	positive
tiefsinnig	positive
tiefgründig	positive
flaumig	positive
gestorben	negative
belebt	positive
lebend	positive
verstorben	negative
lebensecht	positive
verschieden	negative
verblichen	negative
relativ	negative
schwungvoll	positive
steilwandig	positive
durchlässig	positive
marode	positive
baufällig	positive
marod	positive
verrostet	positive
rostig	positive
wackelig	positive
verwittert	positive
faustgross	positive
fünftgrösste	positive
viertgrösste	positive
enorm	positive
hünenhaft	positive
gerade	negative
hell	positive
letztlich	positive
endgültig	positive
definitiv	positive
letztendlich	positive
unwiderruflich	positive
bündig	negative
glattwandig	negative
kursorisch	negative
desaströs	negative
tot	negative
mitreissend	positive
vehement	positive
desolat	positive
wasserdicht	negative
luft- und wasserdicht	negative
hermetisch	negative
undicht	positive
zehntgrösste	positive
neuntgrösste	positive
sechstgrösste	positive
flächengrösste	positive
siebtgrösste	positive
achtgrösste	positive
gotteslästerlich	negative
quicklebendig	positive
gekünstelt	negative
irreversibel	positive
irreparabel	positive
unabänderlich	positive
naseweis	positive
kess	positive
ohnmächtig	negative
einflussreich	positive
duktil	positive
ureigenst	positive
unversteckt	positive
unumwunden	positive
impulsiv	positive
unverdeckt	positive
unverhohlen	positive
denunziatorisch	negative
zeichnerisch	positive
fern	negative
flauschig	positive
kühl	negative
kältebeständig	negative
hitzebeständig	negative
wetterfest	negative
kochfest	negative
glasklar	positive
unfreiwillig	negative
strukturschwach	negative
einkommensschwach	negative
finanzschwach	negative
abschliessend	positive
straff	negative
immanent	positive
säurefest	negative
rot glühend	positive
rotglühend	positive
weitschweifig	negative
nichtoffiziell	positive
nicht offiziell	positive
extrem	positive
radikal	positive
belastbar	positive
verschlossen	negative
lachhaft	positive
scherzhaft	positive
spasshaft	positive
spassig	positive
rasend	positive
frenetisch	positive
inkarniert	positive
wankelmütig	negative
flügge	positive
drangvoll	negative
verkehrsschwach	negative
vernunftbegabt	positive
markant	positive
überzeugend	positive
glaubwürdig	positive
vertrauensfördernd	positive
vertrauensbildend	positive
demonstrativ	positive
provokant	positive
hervorgehoben	positive
emphatisch	positive
akzentuiert	positive
ausgeprägt	positive
ostentativ	positive
schikanös	negative
langgewachsen	positive
lang gewachsen	positive
hochgewachsen	positive
hoch gewachsen	positive
argwöhnisch	negative
vordergründig	negative
vorhanden	positive
lauwarm	positive
unheilig	negative
unselig	negative
familiengerecht	positive
leichtsinnig	negative
aufgeräumt	positive
farblos	negative
erklärt	positive
geradlinig	positive
gradlinig	positive
lotrecht	negative
verdächtig	positive
hervorstechend	positive
prägnant	positive
einprägsam	positive
kristallklar	positive
privat	negative
staatlich	positive
beruflich	positive
waagerecht	negative
waagrecht	negative
verantwortungsvoll	positive
suizidgefährdet	negative
festkochend	negative
schreiend	positive
wassergekühlt	negative
umständlich	negative
bedeckt	negative
introvertiert	negative
unzugänglich	negative
dehnbar	positive
ziemlich	positive
konspirativ	negative
verschwörerisch	negative
erheblich	positive
stillschweigend	negative
unausgesprochen	negative
schwunghaft	positive
solitär	negative
angestrengt	negative
versperrt	negative
wasserklar	positive
gebleicht	negative
ausgebleicht	negative
verblasst	negative
distal	negative
überhöht	positive
altbekannt	positive
übermässig	positive
überzogen	positive
umsatzsteuerpflichtig	positive
blutarm	negative
gutgläubig	positive
blauäugig	positive
leichtgläubig	positive
unbedarft	positive
treuherzig	positive
naiv	positive
riesenhaft	positive
riesig	positive
riesengross	positive
unglaublich	positive
stattlich	positive
offiziell	positive
amtlich	positive
biegsam	positive
rhythmisch	positive
wirtschaftsschwach	negative
allein stehend	negative
alleinstehend	negative
verschossen	negative
dezent	negative
blasphemisch	negative
umfangreich	positive
gehörig	positive
närrisch	positive
erklecklich	positive
beträchtlich	positive
lecker	negative
überzeugt	positive
felsenfest	positive
gemeinschaftlich	positive
gesamt	positive
kooperativ	positive
kollektiv	positive
gemeinsam	positive
scharenweise	positive
vereinigt	positive
vereint	positive
verkaufsschwach	negative
horizontal	negative
feurig	positive
temperamentvoll	positive
feierlich	positive
grösstmöglich	positive
grösste	positive
weltgross	positive
mittelgross	positive
neonfarben	positive
leuchtendrot	positive
ungeheissen	positive
farbecht	negative
künstlerisch	positive
fälschungssicher	positive
ungekünstelt	positive
kopiergeschützt	positive
gottgegeben	positive
klein	negative
schalldicht	negative
luftundurchlässig	negative
lichtundurchlässig	negative
aufgeschrieben	positive
dokumentiert	positive
bekanntlich	positive
registriert	positive
aktenkundig	positive
betreffend	positive
verrückt	negative
zuverlässig	positive
tänzerisch	positive
grauenvoll	negative
grauenhaft	negative
grausig	negative
verhängnisvoll	negative
fraglos	positive
horrend	positive
senkrecht	negative
diagonal	negative
verschleimt	negative
gewiss	positive
artig	positive
verschnupft	negative
okkult	negative
ruchlos	negative
berufsmässig	positive
sanft	negative
temperaturbeständig	negative
verkündet	positive
geoutet	positive
publiziert	positive
bekanntgegeben	positive
festlich	positive
veröffentlicht	positive
freistehend	negative
einzelstehend	negative
exklusiv	negative
ausschliesslich	negative
emanzipiert	positive
folgsam	positive
ungehorsam	negative
nasskühl	negative
aufgekratzt	positive
befestigt	positive
wehrhaft	positive
todsicher	positive
intim	negative
vertraulich	negative
verdeckt	negative
heimlich	negative
mysteriös	negative
kryptisch	negative
tabu	negative
gross gewachsen	positive
grossgewachsen	positive
misstrauisch	negative
heissblütig	positive
ungefragt	positive
blassrosa	negative
sommerlich	positive
unmissverständlich	positive
übergross	positive
notiert	positive
nichtöffentlich	negative
nicht öffentlich	negative
geheimgehalten	negative
viskos	positive
bergreich	positive
unsicher	negative
gemafrei	positive
abhörsicher	positive
leicht	negative
linear	negative
grade	negative
kerzengerade	negative
drittgrösste	positive
tonangebend	positive
flott	negative
unverdrossen	negative
sprachbegabt	positive
musikalisch	positive
nachdenklich	negative
reiflich	positive
theatralisch	positive
geburtenschwach	negative
portofrei	positive
selbstmordgefährdet	negative
verstohlen	negative
unbemerkt	negative
unbeobachtet	negative
unbeachtet	negative
beachtet	positive
suspekt	positive
unscheinbar	negative
unverdächtig	negative
festgehalten	positive
winterfest	negative
staatsgefährdend	negative
gräulich	negative
botmässig	positive
luftdicht	negative
lau	positive
heiss	positive
autokratisch	positive
vollkommen	positive
total	positive
gefangengenommen	negative
eingefangen	negative
gefangengehalten	negative
gänzlich	positive
geklärt	positive
unspektakulär	negative
hintersinnig	positive
larghetto	positive
flächengross	positive
besinnungslos	negative
salonfähig	positive
gesellschaftsfähig	positive
allmächtig	positive
omnipotent	positive
erkennbar	positive
unfertig	positive
ureigen	positive
gleichgross	positive
rege	positive
quirlig	positive
umtriebig	positive
verdammt	positive
arretiert	negative
letztinstanzlich	positive
pantomimisch	positive
wissenschaftsmethodisch	positive
allegretto	positive
unorthodox	positive
umsatzschwach	negative
irre	negative
irr	negative
reissfest	negative
zuvorkommend	positive
wassergefährdend	negative
fremdbestimmt	negative
musikbegabt	positive
hochbegabt	positive
hoch begabt	positive
kunstvoll	negative
lichtecht	negative
schwankend	negative
unentschlossen	negative
unschlüssig	negative
irregeleitet	negative
verunsichert	negative
irritiert	negative
zaghaft	negative
singulär	negative
zweifellos	positive
volkseigen	positive
körpereigen	positive
körperimmanent	positive
landeseigen	positive
staatseigen	positive
hauseigen	positive
bundeseigen	positive
strahlenverseucht	negative
deftig	negative
kalkulierbar	positive
markig	positive
spektakulär	positive
kapital	positive
vorhersagbar	positive
vorherbestimmt	positive
ertragssicher	positive
tiefgekühlt	negative
wirkungsmächtig	positive
mitgliederschwach	negative
naturbelassen	positive
künstlich	negative
erbsengross	positive
jäh	positive
überseeisch	negative
handwarm	positive
zimmerwarm	positive
wohlbehütet	positive
steuerpflichtig	positive
zweifelsfrei	positive
wasserundurchlässig	negative
gasundurchlässig	negative
bildhauerisch	positive
schriftstellerisch	positive
schauspielerisch	positive
dichterisch	positive
frech	negative
brav	positive
bergisch	positive
bergig	positive
korrosionsbeständig	negative
föderiert	positive
inhaftiert	negative
verkehrsarm	negative
feuchtwarm	positive
völlig	positive
gekidnapt	negative
bindig	positive
übermächtig	positive
finanzstark	positive
finanzkräftig	positive
galant	positive
wahnsinnig	negative
epikureisch	negative
irrsinnig	negative
stadtbekannt	positive
abschüssig	positive
ätherisch	negative
verwaschen	negative
windgeschützt	positive
deterministisch	positive
fatal	negative
schläfrig	positive
verzeihlich	positive
freizügig	positive
entschuldbar	positive
hochleistungsfähig	positive
manifest	positive
offenbar	positive
sichtlich	positive
offenkundig	positive
offensichtlich	positive
ehrrührig	negative
ehrenrührig	negative
nonkonformistisch	positive
arteigen	positive
werkeigen	positive
werkseigen	positive
verlagseigen	positive
unternehmenseigen	positive
konzerneigen	positive
betriebseigen	positive
leibeigen	positive
alterungsbeständig	negative
naturrein	positive
maxi	positive
wolkenlos	positive
belastungsfähig	positive
jugendgefährdend	negative
unverlangt	positive
vertikal	negative
schnurgerade	negative
lebensgross	positive
überlebensgross	positive
kinderfreundlich	positive
kenntlich	positive
kampfstark	positive
imperial	positive
wohlschmeckend	negative
köstlich	negative
gelind	negative
wirkmächtig	positive
gedackt	negative
einkommenssteuerpflichtig	positive
einkommensteuerpflichtig	positive
unpaarig	negative
morastig	positive
mannsgross	positive
eigenbrötlerisch	negative
frisch	negative
schlechtgelaunt	negative
schlecht gelaunt	negative
turbulent	positive
ungestüm	positive
lind	negative
lappig	negative
wirklichkeitsnah	positive
kultiviert	positive
zelleigen	positive
verhaftet	negative
lässig	positive
nonchalent	positive
uneitel	positive
ungezwungen	positive
untrüglich	positive
ungefährdet	positive
unzweifelhaft	positive
ungeöffnet	negative
unnahbar	negative
unkonventionell	positive
dortig	negative
dingfest	negative
unwegsam	negative
festgefangen	negative
kunstreich	negative
entführt	negative
gesundheitsgefährdend	negative
friedensgefährdend	negative
sicherheitsgefährdend	negative
menschengross	positive
bordeigen	positive
luftgekühlt	negative
definit	positive
unbewohnbar	negative
leiblich	positive
einschätzbar	positive
berechenbar	positive
voraussagbar	positive
rustikal	negative
verhaltensgestört	negative
dement	negative
durcheinander	negative
höher gelegen	positive
höhergelegen	positive
höchstgelegen	positive
schlammig	positive
dickflüssig	positive
festgenommen	negative
denkmalgeschützt	positive
abgeschirmt	positive
unignorierbar	positive
tennisballgross	positive
umweltschonend	positive
bibliophil	negative
stadteigen	positive
schuleigen	positive
vereinseigen	positive
gemeindeeigen	positive
firmeneigen	positive
ungemein	positive
umsatzstark	positive
spielend	positive
gefeit	positive
unbezweifelbar	positive
melodramatisch	positive
zahlungsunfähig	positive
bankrott	positive
abgebrannt	positive
ungezählt	positive
unzählig	positive
unermesslich	positive
immens	positive
autokephal	positive
kleinwüchsig	negative
bestimmt	positive
erfolgsabhängig	negative
kontextabhängig	negative
ortsabhängig	negative
leistungsabhängig	negative
unkurierbar	positive
vorwitzig	positive
wiedererkennbar	positive
energieintensiv	negative
forschungsintensiv	negative
lohnintensiv	negative
unantastbar	negative
endlos	positive
langatmig	positive
verhältnismässig	negative
kilometerlang	positive
meilenlang	positive
unentschieden	negative
vielgestaltig	negative
pastellfarben	positive
millionenschwer	positive
missverständlich	negative
runzelig	positive
runzlig	positive
diffus	negative
kompromissbereit	positive
unvollkommen	negative
verbohrt	negative
engstirnig	negative
gefüllt	positive
unverbesserlich	negative
borniert	negative
voll	positive
autonom	positive
anstellig	positive
gesprächsbereit	positive
geständig	positive
vorliegend	positive
temperaturabhängig	negative
zeitabhängig	negative
gnomenhaft	negative
gleitfähig	negative
begnadet	positive
grundverschieden	negative
halbherzig	negative
plastisch	positive
prominent	positive
einkommensabhängig	negative
umschrieben	positive
bestehend	positive
kleinkariert	negative
beredt	positive
nationalliberal	positive
betriebsfremd	negative
knapp	negative
hiesig	positive
identifizierbar	positive
spiegelglatt	negative
vollbusig	positive
prall	positive
verwirrt	negative
unüberhörbar	positive
inbrünstig	positive
ausdrücklich	positive
hochsommerlich	positive
grosswüchsig	positive
besessen	positive
altüberliefert	positive
geschwollen	positive
ungeschrieben	positive
allbekannt	positive
eindeutig	positive
uniert	positive
wartungsintensiv	negative
personalintensiv	negative
doktrinär	positive
systemimmanent	positive
mehrfach	positive
vielfach	positive
verlegt	negative
unwillig	negative
widerstrebend	negative
zähneknirschend	negative
widerwillig	negative
subtil	positive
abgründig	positive
sozialliberal	positive
lang gefasst	positive
langgefasst	positive
leck	positive
löchrig	positive
ideologisch	positive
dogmatisch	negative
gesamtstaatlich	positive
grell	positive
düster	negative
ungewiss	negative
aufgesetzt	negative
konfessionsverschieden	negative
andersgeartet	negative
naturidentisch	negative
pseudonym	negative
mehrmalig	positive
reichlich	positive
wenig	negative
einsturzgefährdet	negative
hochliegend	positive
pöbelhaft	negative
mausetot	negative
verdrossen	negative
mürrisch	negative
lichtstark	positive
lebenslang	positive
nächtelang	positive
minutenlang	positive
aquarellfarben	positive
weiss	positive
pastellig	positive
pastell	positive
unnatürlich	negative
mondän	positive
weltgewandt	positive
erleuchtet	positive
manieriert	negative
polymorph	negative
unheilbar	positive
loh	positive
kurz	negative
autobiografisch	negative
autobiographisch	negative
armlang	positive
kinnlang	positive
handlang	positive
baumlang	positive
dreiviertellang	positive
mickrig	negative
eingeschränkt	negative
begrenzt	negative
verbissen	negative
kahl	negative
komisch	positive
rechtsextrem	positive
rechtsextremistisch	positive
linksextremistisch	positive
rechtsradikal	positive
glibberig	negative
unterkühlt	negative
jahrelang	positive
jahrzehntelang	positive
kirchenamtlich	positive
lehramtlich	positive
bauamtlich	positive
blumig	positive
übermenschlich	positive
unumkehrbar	positive
reversibel	negative
reparabel	negative
faltig	positive
finit	positive
werkimmanent	positive
hochwassergefährdet	negative
grellfarbig	positive
grellfarben	positive
pastellfarbig	positive
rechtgläubig	negative
linksextrem	positive
linksradikal	positive
unverwechselbar	positive
diktatorisch	positive
totalitär	positive
different	negative
schroff	positive
urkomisch	positive
saukomisch	positive
langwierig	positive
leidenschaftlich	positive
mini	negative
determiniert	positive
launenhaft	negative
kapriziös	negative
unausgeglichen	negative
prothetisch	negative
ulkig	positive
lohnabhängig	negative
störrisch	negative
bockig	negative
übersät	negative
verbockt	negative
plattig	negative
knielang	positive
meterlang	positive
ungeschminkt	positive
ellenlang	positive
überlang	positive
seitenlang	positive
mittellang	positive
grimm	negative
zweifelnd	negative
zweiflerisch	negative
langgestielt	positive
grasig	negative
nebelverhangen	negative
vernebelt	negative
existent	positive
indirekt	negative
längerfristig	positive
spontan	positive
begeisterungsfähig	positive
ultralang	positive
hüftlang	positive
wadenlang	positive
bodenlang	positive
schulterlang	positive
halblang	positive
knöchellang	positive
fingerlang	positive
fusslang	positive
nicht staatlich	negative
nichtstaatlich	negative
persönlich	negative
rechtsstaatlich	positive
linksbündig	negative
pünktlich	positive
verschwiegen	positive
verantwortungsbewusst	positive
materialintensiv	negative
karg	negative
wohlbekannt	positive
rechtsbündig	negative
inhomogen	negative
sonderlich	negative
tropisch	positive
mordsmässig	positive
wasserdurchlässig	positive
klammheimlich	negative
versteckt	negative
angewiesen	negative
pflegebedürftig	negative
hilfsbedürftig	negative
hilfebedürftig	negative
hilfesuchend	negative
hilfe suchend	negative
anlehnungsbedürftig	negative
pflegeabhängig	negative
unübersehbar	positive
linksliberal	positive
bundesstaatlich	positive
gigantisch	positive
bombastisch	positive
überdimensional	positive
zurückhaltend	negative
lümmelhaft	negative
flegelhaft	negative
auflagenstark	positive
explizit	positive
inoffiziell	negative
formell	positive
unzuverlässig	negative
munter	positive
aufgedreht	positive
dickköpfig	negative
ungebunden	negative
liiert	positive
situativ	negative
situationsabhängig	negative
frequenzabhängig	negative
vornehmlich	positive
überwiegend	positive
vorwiegend	positive
monströs	positive
hochmusikalisch	positive
gestreng	positive
russisch-orthodox	negative
christlich-orthodox	negative
griechisch-orthodox	negative
lebensgeschichtlich	negative
biografisch	negative
biographisch	negative
freiberuflich	positive
freischaffend	positive
berufsbegleitend	positive
pathetisch	positive
schwülstig	positive
synchron	positive
milliardenschwer	positive
zollamtlich	positive
standesamtlich	positive
halbstaatlich	positive
krustig	negative
bärbeissig	negative
nichtselbstständig	positive
nicht selbstständig	positive
redebegabt	positive
kleinste	negative
jenseitig	negative
neongrün	positive
massenhaft	positive
beachtlich	positive
geringfügig	negative
winzig	negative
pygmäenhaft	negative
immediat	positive
dick	positive
repressiv	positive
unterdrückerisch	positive
drastisch	positive
drakonisch	positive
vertraut	positive
ausführlich	positive
launisch	negative
genannt	positive
erwähnt	positive
thematisiert	positive
sprunghaft	negative
bekloppt	negative
narrenhaft	negative
jeck	negative
wichtig	positive
aufmerksam	positive
rennend	positive
verlässlich	positive
geisteskrank	negative
grässlich	negative
unverschlüsselt	positive
kauzig	negative
verächtlich	negative
unmanierlich	negative
lichtdurchflutet	positive
kompositorisch	positive
totgeboren	negative
semipermeabel	positive
unmittelbar	positive
mitgliederstark	positive
liberaldemokratisch	positive
halb voll	positive
halbvoll	positive
stur	negative
unzählbar	positive
missgestimmt	negative
misslaunig	negative
missgelaunt	negative
verstimmt	negative
knatschig	negative
quengelig	negative
asynchron	negative
amüsant	positive
vergnüglich	positive
schalkhaft	positive
possenhaft	positive
albern	positive
schelmisch	positive
überzuckert	negative
nervenstark	positive
aufständisch	negative
kleinstmöglich	negative
angemeldet	positive
widerspenstig	negative
verzeihbar	positive
aufsässig	negative
wahnhaft	negative
selbstgesteckt	negative
nörglerisch	negative
nölig	negative
nörgelig	negative
überbelegt	negative
skeptisch	negative
fixiert	positive
indiskret	negative
taktvoll	positive
unverkennbar	positive
geschworen	positive
vorfrühlingshaft	negative
hochkarätig	negative
unbürokratisch	positive
parteiamtlich	positive
katasteramtlich	positive
postamtlich	positive
seeamtlich	positive
bahnamtlich	positive
geladen	negative
genervt	negative
disharmonisch	negative
gereizt	negative
verquer	negative
ratsuchend	negative
rat suchend	negative
verbucht	positive
gebucht	positive
unerheblich	negative
unzensiert	positive
zwergenhaft	negative
wirkungsreich	positive
schneebedeckt	negative
heiratswillig	positive
exhibitionistisch	positive
ständig	positive
nicht linear	positive
nichtlinear	positive
undurchsichtig	negative
bewohnbar	positive
kolossal	positive
regierungsamtlich	positive
luftdurchlässig	positive
redegewandt	positive
gestresst	negative
übelgelaunt	negative
übel gelaunt	negative
hygienisch	positive
strikt	positive
namentlich	positive
bewusstlos	negative
überbacken	negative
verstockt	negative
eigenmächtig	negative
gehaltvoll	positive
eigenwillig	negative
reichhaltig	positive
etlich	positive
christliberal	positive
kreideweiss	negative
schwarz-gelb	positive
ungeheuerlich	negative
ungehört	negative
ungesehen	negative
unerkannt	negative
potent	positive
komödiantisch	positive
bereinigt	positive
weitreichend	positive
weitgehend	positive
weitführend	positive
einstudiert	negative
begehrt	positive
gefragt	positive
komatös	negative
hochoffiziell	positive
inquisitorisch	positive
überproportional	positive
beständig	positive
fieberhaft	negative
mannigfach	positive
patzig	negative
unschlagbar	positive
machtlos	negative
unbesiegbar	positive
ungleich	negative
divers	negative
unähnlich	negative
andere	negative
verlorengegangen	negative
verloren gegangen	negative
schwer	positive
deduktiv	positive
änderbar	negative
taktlos	negative
sonnenbeschienen	positive
diskret	positive
arbeitsaufwendig	negative
arbeitsaufwändig	negative
arbeitsintensiv	negative
arbeitsreich	negative
zeitintensiv	negative
zeitaufwändig	negative
zeitaufwendig	negative
biedermeierlich	negative
verschroben	negative
bar	positive
saumässig	positive
synthetisch	negative
obrigkeitsstaatlich	positive
heterogen	negative
gleich	positive
merkbar	positive
begrünt	negative
paarig	positive
schwülheiss	positive
entseelt	negative
herzhaft	negative
unartig	negative
morbid	negative
unkalkulierbar	negative
strenggläubig	negative
langgezogen	positive
schleichend	positive
gestreckt	positive
ausgedehnt	positive
unbestimmt	negative
zeitraubend	negative
schicksalhaft	positive
verdreht	negative
eigensinnig	negative
leichtgängig	negative
hauptamtlich	positive
ehrenamtlich	positive
nebenamtlich	positive
hauptberuflich	positive
nebenberuflich	positive
pastos	positive
lichterloh	positive
trutzig	positive
erkundet	positive
artifiziell	negative
wach	negative
federleicht	negative
luftig	negative
gleichlang	positive
unaufhörlich	positive
ausgiebig	positive
allmählich	positive
schrittweise	positive
lichtdurchlässig	positive
erzählerisch	positive
unhöflich	negative
despektierlich	negative
ungebührlich	negative
erfasst	positive
eingetragen	positive
eingeschrieben	positive
ausgewiesen	positive
langgestreckt	positive
lang gestreckt	positive
anerkannt	positive
angekündigt	positive
nationalstaatlich	positive
umfänglich	positive
eitel	negative
unbotmässig	negative
langfristig	positive
ominös	negative
wartungsarm	negative
immerwährend	positive
zeitlos	positive
lithografisch	positive
litographisch	positive
fortdauernd	positive
schlüpfrig	negative
unerkennbar	negative
induktiv	positive
paranoid	negative
graduell	positive
unfolgsam	negative
klein gewachsen	negative
kleingewachsen	negative
kurzgewachsen	negative
kurz gewachsen	negative
wirtschaftsliberal	positive
spätsommerlich	positive
hermeneutisch	positive
profund	positive
unbefestigt	positive
unendlich	positive
unvergänglich	positive
empirisch	positive
populär	positive
unschwer	negative
banal	negative
ungeklärt	negative
konformistisch	negative
unbeachtlich	negative
veterinäramtlich	positive
patentamtlich	positive
flapsig	negative
splendid	negative
karmisch	positive
narrativ	positive
unproblematisch	negative
reibungslos	negative
problemlos	negative
problemfrei	negative
durchschlagend	positive
kontextsensitiv	negative
ewig	positive
kontrastiv	negative
breiig	positive
quer	negative
winzigklein	negative
krumm	positive
schuppig	negative
sozialstaatlich	positive
überstaatlich	positive
einzelstaatlich	positive
stoned	negative
bekifft	negative
trivial	negative
rebellisch	negative
verhangen	negative
aufmüpfig	negative
renitent	negative
sämig	positive
erfahrbar	positive
recherchierbar	positive
deutlich	positive
hirntot	negative
heteromorph	negative
verschiedenartig	negative
entscheidbar	positive
langstielig	positive
unveröffentlicht	negative
unvermittelt	positive
geläufig	positive
erforscht	positive
traut	positive
cash	positive
reichsunmittelbar	positive
fleischgeworden	positive
fleisch geworden	positive
matschig	positive
knusprig	negative
knackig	negative
übellaunig	negative
grimmig	negative
grantig	negative
disparat	negative
schrullig	negative
forciert	negative
polyrhythmisch	positive
kalkweiss	negative
zahlreich	positive
zahllos	positive
zig	positive
jahrtausendelang	positive
unbekannt	negative
jahrhundertelang	positive
stundenlang	positive
tagelang	positive
wochenlang	positive
monatelang	positive
geschrieben	positive
klümperig	positive
klümprig	positive
zugedeckt	negative
asphaltiert	negative
spleenig	negative
missmutig	negative
verborgen	negative
mehrheitlich	positive
maximal	positive
gering	negative
rutschig	negative
klumpig	positive
eingedickt	positive
schleimig	positive
geronnen	positive
bedroht	negative
konfrontativ	negative
kleinteilig	negative
beschuppt	negative
desorientiert	negative
glitschig	negative
flagrant	positive
beleuchtet	positive
unbeleuchtet	negative
vorrangig	positive
hauptsächlich	positive
bullerig	positive
feist	positive
bullig	positive
fett	positive
fettleibig	positive
vollschlank	positive
unmassgeblich	negative
barock	positive
gasreich	positive
ballaststoffreich	positive
gestaltbar	negative
hochheilig	negative
sakrosankt	negative
meilenweit	positive
durchschaubar	negative
primitiv	negative
simpel	negative
sinnfällig	negative
verständlich	negative
durchsichtig	negative
verschiedenfarbig	negative
schwarz	negative
weisslich	positive
ambivalent	negative
eineinhalbfach	positive
unvollständig	negative
notdürftig	negative
defizitär	negative
geringstmöglich	negative
randvoll	positive
leer	negative
allfällig	negative
sprichwörtlich	positive
dünn	negative
armdick	positive
marxistisch-leninistisch	positive
selten	positive
ausgebucht	positive
viel zitiert	positive
vielzitiert	positive
kündbar	negative
knetbar	positive
modellierbar	positive
formbar	positive
fingerdick	positive
zentral	positive
holografisch	positive
schlicht	negative
atmungsaktiv	positive
schnell	negative
füllig	positive
rasch	negative
übersehbar	positive
heterotroph	negative
sofortig	negative
kalorienreich	positive
sechsfach	positive
6-fach	positive
doppelt	positive
dreifach	positive
3-fach	positive
vierfach	positive
4-fach	positive
breit	positive
dickwanstig	positive
dickbäuchig	positive
massig	positive
entsprechend	positive
nämlich	positive
glatzköpfig	negative
kongruent	positive
eventuell	negative
vollbesetzt	positive
undeutlich	negative
manipulierbar	negative
zerstörbar	negative
ratlos	negative
seltsam	positive
rundlich	positive
fundamental	positive
elementar	positive
übertragen	negative
reserviert	negative
spröde	negative
spröd	negative
unerwähnt	negative
unvorstellbar	negative
muffig	negative
krummlinig	positive
vielgefragt	positive
viel gefragt	positive
signifikant	positive
staatstragend	positive
pflegeleicht	positive
feuchtheiss	positive
undefiniert	negative
deckungsgleich	positive
blühend	positive
gleichsinnig	positive
kilometerweit	positive
hochgesteckt	positive
bürokratisch	negative
fanatisch	positive
extremistisch	positive
fundamentalistisch	positive
technokratisch	positive
stichpunktartig	negative
weittragend	positive
angesagt	positive
gleichgeartet	positive
duster	negative
hochfliegend	positive
höhengleich	positive
indefinit	negative
medikamentenabhängig	negative
gleichrangig	positive
inflationär	positive
tausendfach	positive
1000-fach	positive
verschwendungssüchtig	negative
sechsmalig	positive
6-malig	positive
gasgefüllt	positive
punktgleich	positive
astronomisch	positive
lebenslänglich	positive
wasserreich	positive
unerlässlich	positive
gedämpft	negative
gebietsfremd	negative
schummrig	negative
schummerig	negative
essenziell	positive
essentiell	positive
grundsätzlich	positive
massgeblich	positive
kurierbar	negative
heilbar	negative
mehrschichtig	positive
schwierig	negative
schräg	positive
chauvinistisch	positive
sexistisch	positive
vermehrt	positive
rar	positive
wiederkehrend	positive
wiederholt	positive
obstinat	negative
unbelehrbar	negative
kurios	positive
gleichgesinnt	positive
7-fach	positive
siebenfach	positive
8-fach	positive
achtfach	positive
9-fach	positive
neunfach	positive
10-fach	positive
zehnfach	positive
hundertfach	positive
100-fach	positive
klitzeklein	negative
delimitiert	negative
limitiert	negative
unbegrenzt	positive
befristet	negative
kahlköpfig	negative
gleichgestellt	positive
gleichalt	positive
unberechenbar	negative
halbamtlich	negative
unkompliziert	positive
konventionell	negative
glaubhaft	positive
paritätisch	positive
frequent	positive
etherisch	negative
umkehrbar	negative
veränderbar	negative
korrigierbar	negative
verschrumpelt	positive
schrumplig	positive
schrumpelig	positive
farbig	positive
reduktionistisch	negative
geringschätzig	negative
modifizierbar	negative
prallvoll	positive
weit	positive
halb	negative
zwangsgestört	negative
lebensnotwendig	positive
lebenswichtig	positive
problemvoll	positive
flatterig	positive
faltenreich	positive
n-fach	positive
erwähnenswert	positive
mattweiss	positive
analog	positive
stutzig	negative
bewusst	positive
unidentifiziert	negative
vorherrschend	positive
herrschend	positive
entscheidend	positive
verschlüsselt	negative
digital	negative
starrsinnig	negative
hektisch	positive
kurzzeitig	negative
minimalistisch	negative
prompt	negative
unverzüglich	negative
postwendend	negative
vollsynthetisch	negative
arbeitssüchtig	negative
himmelweit	positive
lesbar	positive
gebunden	positive
traditionell	negative
basal	positive
wörtlich	positive
übersinnlich	negative
unbezwingbar	positive
paranormal	negative
opulent	positive
zweideutig	negative
aalglatt	negative
bedeutend	positive
gleichlautend	positive
zweitwichtigste	positive
subtropisch	positive
bauchig	positive
millionenfach	positive
meistgenannt	positive
skandalträchtig	positive
unterschwellig	negative
latent	negative
niveaugleich	positive
inhaltsgleich	positive
baugleich	positive
wesensgleich	positive
namensgleich	positive
brüsk	positive
höchstpersönlich	negative
wissenswert	positive
gleichgerichtet	positive
gleich gerichtet	positive
beachtenswert	positive
arm	negative
schütter	negative
spärlich	negative
unwägbar	negative
extensiv	positive
missfällig	negative
nervös	positive
manierlich	positive
unangekündigt	negative
unangemeldet	negative
informell	negative
unangesagt	negative
schwererziehbar	negative
schwer erziehbar	negative
unpünktlich	negative
säumig	negative
nachlässig	negative
unwichtig	negative
überspannt	positive
notwendig	positive
hellwach	negative
essenzial	positive
essential	positive
fremd	negative
einfach	negative
skandalös	positive
metaphysisch	negative
fahl	negative
unbelebt	negative
restaurativ	negative
ergebnisoffen	negative
wichtigst	positive
nennenswert	positive
unausschöpflich	positive
unschätzbar	positive
unerschöpflich	positive
weitestgehend	positive
unzureichend	negative
unzulänglich	negative
distanziert	negative
harzig	positive
überstürzt	negative
übernatürlich	negative
überhastet	negative
zigfach	positive
kurzfristig	negative
aufgelöst	positive
transzendent	negative
verschoben	negative
relevant	positive
beachtbar	positive
mikroskopisch	negative
übergewichtig	positive
schwergewichtig	positive
wohlbeleibt	positive
wohl beleibt	positive
kammermusikalisch	positive
einschneidend	positive
massiv	positive
detailliert	positive
detailgetreu	positive
transversal	negative
dezidiert	positive
fünffach	positive
5-fach	positive
unzertrennbar	positive
unzertrennlich	positive
lausbubenhaft	positive
lausbübisch	positive
evolutionistisch	positive
gedrängt	negative
sublim	positive
pfirsichfarben	positive
nachvollziehbar	negative
kompakt	positive
knorrig	negative
hyperaktiv	positive
freihändig	negative
anderthalbfach	positive
endlich	negative
umgelegt	negative
workoholic	negative
final	positive
teilweise	negative
partiell	negative
hysterisch	positive
gängig	positive
hypernervös	positive
heterolog	negative
zwölffach	positive
12-fach	positive
hochgestochen	positive
gleichberechtigt	positive
gleichaltrig	positive
ergänzungsbedürftig	negative
klärungsbedürftig	negative
unaufdringlich	negative
2-malig	positive
zweimalig	positive
dreimalig	positive
3-malig	positive
4-malig	positive
viermalig	positive
kaufsüchtig	negative
fünfmalig	positive
5-malig	positive
fernsehsüchtig	negative
spielsüchtig	negative
wesentlich	positive
buchstäblich	positive
hochrangig	negative
bemerkenswert	positive
konservativ	negative
kribbelig	positive
kribblig	positive
flatterhaft	positive
zickig	negative
kiebig	negative
unangreifbar	negative
berechnet	positive
gutgeschrieben	positive
wertgestellt	positive
rutschfest	positive
nachhaltig	positive
hochtrabend	positive
achtmalig	positive
8-malig	positive
7-malig	positive
siebenmalig	positive
zehnmalig	positive
10-malig	positive
9-malig	positive
neunmalig	positive
alkoholabhängig	negative
alkoholsüchtig	negative
trunksüchtig	negative
häufig	positive
süchtig	negative
drogenabhängig	negative
drogensüchtig	negative
rauschgiftsüchtig	negative
kirchenmusikalisch	positive
ausverkauft	positive
gehäuft	positive
einleitend	negative
kardinal	positive
grundlegend	positive
weltberühmt	positive
gleichnamig	positive
ebenbürtig	positive
gleichwertig	positive
grossangelegt	positive
behandelbar	negative
unvorhersehbar	negative
kontaktarm	negative
zurückgezogen	negative
unzweideutig	positive
menschenscheu	negative
lilienweiss	positive
gedrungen	negative
perlweiss	positive
grellweiss	positive
schlohweiss	positive
begreifbar	negative
wahrscheinlich	positive
tiefschwarz	negative
begreiflich	negative
periphrastisch	negative
unverletzlich	negative
leserlich	positive
zwergwüchsig	negative
graulich	negative
besondere	negative
kodiert	negative
überdreht	positive
symbolhaft	negative
mittelbar	negative
verstopft	positive
unverrückbar	positive
primär	positive
vieldeutig	negative
unerkundet	negative
folgenschwer	positive
folgenreich	positive
abendfüllend	positive
transzendental	negative
opak	negative
unpopulär	negative
unverbrüchlich	positive
unvergesslich	positive
unvergessen	positive
unsterblich	positive
burlesk	positive
verschmitzt	positive
ausgeglichen	positive
2-fach	positive
zweifach	positive
diffizil	positive
anderweitig	negative
unterschiedlich	negative
unterscheidbar	negative
problematisch	positive
stichprobenartig	negative
kriegswichtig	positive
schief	positive
windschief	positive
geistig behindert	negative
variabel	negative
implizit	negative
gespalten	negative
mittelschwer	positive
doppeldeutig	negative
adipös	positive
anonym	negative
artfremd	negative
körperfremd	negative
wildfremd	negative
ortsfremd	negative
hochstehend	negative
homogen	positive
identisch	positive
sonstig	negative
gleichartig	positive
erforderlich	positive
impotent	negative
isomorph	positive
respektabel	positive
putzmunter	positive
wattiert	positive
dicklagig	positive
spartanisch	negative
verknallt	negative
gemeingefährlich	negative
undurchdringlich	negative
mehrdeutig	negative
gleichbedeutend	positive
gleichgeschaltet	positive
rauchig	positive
nivelliert	positive
ähnlich	positive
putzsüchtig	negative
zwanzigfach	positive
variationsreich	positive
durchbrochen	negative
vollwertig	positive
fettreich	positive
formenreich	positive
sogenannt	positive
berühmt	positive
abfällig	negative
abschätzig	negative
notorisch	positive
informal	positive
dichtbebaut	positive
dicht bebaut	positive
detailreich	positive
nährstoffreich	positive
selbstgefällig	negative
zwiespältig	negative
unbestätigt	negative
ungeduldig	positive
viel genannt	positive
vielgenannt	positive
untengenannt	positive
unten genannt	positive
obgenannt	positive
obengenannt	positive
oben genannt	positive
erstgenannt	positive
vorgenannt	positive
letztgenannt	positive
haarsträubend	positive
thermoplastisch	positive
vergänglich	negative
unkenntlich	negative
lückenhaft	negative
permissiv	negative
fortbestehend	positive
summarisch	negative
hagiographisch	negative
hagiografisch	negative
zappenduster	negative
finster	negative
verformbar	positive
müde	positive
schlagwortartig	negative
lichtarm	negative
angebunden	positive
lakonisch	negative
kurzgefasst	negative
kurz gefasst	negative
hypothetisch	negative
spekulativ	negative
sexsüchtig	negative
abundant	positive
gewellt	positive
tablettensüchtig	negative
blumenreich	positive
cremeweiss	positive
überlebenswichtig	positive
bilderreich	positive
vitaminreich	positive
variierbar	negative
verraucht	positive
zyklopisch	positive
unlustig	negative
abgeschrägt	positive
widerständig	negative
x-fach	positive
eineindeutig	positive
internetsüchtig	negative
reinweiss	positive
grauweiss	positive
gelbweiss	positive
plausibel	positive
silberweiss	positive
luftgefüllt	positive
notbehelfsmässig	negative
milchweiss	positive
scheinbar	negative
blütenweiss	positive
verkürzt	negative
vermutlich	negative
milchig	negative
blickdicht	negative
etwaig	negative
skandalumwittert	positive
stichwortartig	negative
verwechselbar	negative
festgebunden	positive
weitgefächert	positive
fresssüchtig	negative
konzis	negative
differenzierbar	negative
esssüchtig	negative
widersprüchlich	negative
schneeweiss	positive
anteilig	negative
rudimentär	negative
fragmentarisch	negative
bruchstückhaft	negative
bruchstückartig	negative
wohlgenährt	positive
wohl genährt	positive
trotzig	negative
wellig	positive
kompliziert	negative
überdeutlich	positive
personal	negative
umkämpft	positive
personenbezogen	negative
janusköpfig	negative
unbar	negative
bargeldlos	negative
figurenreich	positive
eiweissreich	positive
rohstoffreich	positive
torreich	positive
variantenreich	positive
temporeich	negative
ungenannt	negative
familiär	positive
aufsehenerregend	positive
aufsehen erregend	positive
mühsam	positive
mühselig	positive
beschwerlich	positive
tiefdunkel	negative
gleichnishaft	negative
affig	negative
selbstgerecht	negative
selbstherrlich	negative
affektiert	negative
geziert	negative
dumpf	negative
symbolisch	negative
eigenhändig	negative
superwichtig	positive
hochwichtig	positive
unerforscht	negative
multiplikativ	positive
reichsfrei	positive
eisenreich	positive
oftmalig	positive
kniefrei	negative
geckenhaft	negative
breitgefächert	positive
kurzstielig	negative
minder	negative
minimal	negative
beleibt	positive
voluminös	positive
aufgedunsen	positive
korpulent	positive
aufgetrieben	positive
dicklich	positive
mollig	positive
brennend	positive
übervoll	positive
überfüllt	positive
immer während	positive
unbeträchtlich	negative
offiziös	negative
stockdunkel	negative
stockfinster	negative
sanitär	positive
halbdunkel	negative
dürftig	negative
irrelevant	negative
stämmig	positive
farbenreich	negative
ausreichend	positive
erwartbar	positive
überschaubar	positive
bleischwer	positive
neunzigprozentig	negative
unbegreifbar	positive
unbegreiflich	positive
unverständlich	positive
mafiaähnlich	positive
haarähnlich	positive
sirupähnlich	positive
unverzichtbar	positive
zwingend	positive
unbedingt	positive
nötig	positive
unkündbar	positive
geleert	negative
entleert	negative
trendig	positive
leichtgewichtig	negative
untergewichtig	negative
mager	negative
verstehbar	negative
bedeutsam	positive
bedeutungsvoll	positive
fassbar	negative
einleuchtend	negative
erfassbar	negative
abstrakt	positive
marginal	negative
existential	positive
existenzial	positive
kohlrabenschwarz	negative
pechschwarz	negative
geboten	positive
ernstzunehmend	positive
schnellstmöglich	negative
hochprozentig	negative
pigmentiert	positive
ultrakompakt	positive
untersetzt	positive
mutmasslich	positive
licht	negative
verkehrsberuhigt	negative
wägbar	positive
epoche machend	positive
epochemachend	positive
merklich	positive
bemerkbar	positive
feststellbar	positive
unaufmerksam	negative
braun	positive
entbehrlich	negative
verzichtbar	negative
unnötig	negative
undenkbar	negative
elfenbeinfarbig	positive
elfenbeinfarben	positive
aprikosenfarben	positive
kläglich	negative
kärglich	negative
erneut	positive
eheähnlich	positive
kriegsähnlich	positive
menschenähnlich	positive
gottähnlich	positive
hundeähnlich	positive
affenähnlich	positive
brisant	positive
grasartig	negative
fällig	positive
unvermeidbar	positive
weitverbreitet	positive
reaktionär	negative
widerruflich	negative
vierfarbig	positive
starkfarbig	positive
goldähnlich	positive
fischähnlich	positive
filzähnlich	positive
weisend	positive
obligatorisch	positive
rabenschwarz	negative
weitläufig	positive
deutschlandweit	positive
einschlägig	positive
unwesentlich	negative
unveränderbar	positive
aufdringlich	positive
distanzlos	positive
alternativ	negative
regelmässig	positive
anthropomorph	positive
namenhaft	positive
einsilbig	negative
naturfarben	positive
schludrig	negative
wortgetreu	positive
fleischarm	negative
wahlweise	negative
äquivalent	positive
weiträumig	positive
europaweit	positive
weltweit	positive
kunterbunt	negative
fünfprozentig	negative
deflationär	negative
knallig	negative
farbenfroh	negative
farbenprächtig	negative
bunt	negative
gleichfarbig	positive
buntfarbig	negative
unlimitiert	positive
kennzeichnend	positive
isotrop	positive
zwielichtig	negative
verwunderlich	negative
wunderlich	negative
existenziell	positive
existentiell	positive
knifflig	positive
knallbunt	negative
poppig	negative
gemustert	negative
drall	positive
unbewusst	negative
unwandelbar	positive
schwerpunktmässig	positive
ausschlaggebend	positive
ruhig	negative
obligat	positive
pummelig	positive
zweifarbig	positive
auslesbar	positive
unleserlich	negative
verworren	negative
vielschichtig	negative
ablesbar	positive
schwarzweiss	positive
schemenhaft	negative
wasserarm	negative
fettarm	negative
schwarz-weiss-rot	negative
illuster	positive
zweischichtig	positive
richtungsweisend	positive
richtungweisend	positive
programmatisch	positive
zielweisend	positive
massgebend	positive
unbedeutsam	negative
neuronal	positive
geheimnisumwittert	positive
hochgeschätzt	positive
repräsentativ	positive
aussagekräftig	positive
aussagefähig	positive
prägend	positive
epochal	positive
vielsagend	positive
ungenügend	negative
ärmlich	negative
heroinsüchtig	negative
bengalisch	negative
überbelastet	positive
rot	positive
durchscheinend	positive
schwarzrotgolden	negative
schwarz-rot-golden	negative
aschfahl	negative
abermalig	positive
erzkonservativ	negative
sekundär	negative
zweitrangig	negative
unbedeutend	negative
verderblich	negative
vertrackt	negative
gemäss	positive
kategorisch	positive
unglaubhaft	negative
apricot	positive
vorgezogen	positive
diskutabel	positive
ununterscheidbar	positive
nationalkonservativ	negative
geringelt	positive
dreilagig	positive
ternär	positive
wertkonservativ	negative
kryptographisch	negative
kryptografisch	negative
vergriffen	positive
unbefristet	positive
hellfarben	positive
einsehbar	negative
kultig	positive
in	positive
beschränkend	negative
kontrolliert	negative
beschränkt	negative
wundersam	negative
kursiv	positive
fristlos	negative
symbolhaltig	negative
unausdenkbar	negative
sinnverwandt	positive
dornenreich	positive
magisch	positive
geheimnisvoll	positive
sechzigprozentig	negative
raumgreifend	positive
siebzigprozentig	negative
blaugrün	positive
grau	positive
initial	negative
restriktiv	negative
progressiv	positive
verflixt	negative
dunkelfarbig	positive
totenähnlich	positive
angespannt	positive
metallfarben	positive
hautfarben	positive
kokainabhängig	negative
bestimmend	positive
charakteristisch	positive
gefasst	positive
breitgesichtig	positive
versunken	positive
kontemplativ	positive
undurchschaubar	negative
geknickt	positive
falb	negative
differentiell	negative
differenziell	negative
heroinabhängig	negative
augenscheinlich	positive
geduldig	negative
nervlich	positive
quaternär	positive
vorstellbar	positive
rund	positive
unentdeckt	negative
gelb	positive
vollständig	positive
grauschwarz	negative
unwahrscheinlich	negative
überpünktlich	positive
erklärlich	negative
unveränderlich	positive
erklärbar	negative
wertbeständig	positive
eingeladen	negative
ungehalten	positive
unwirsch	positive
übersichtlich	positive
gleichgelagert	positive
gleich gelagert	positive
schwärzlich	negative
unvergleichlich	negative
einmalig	negative
einzigartig	negative
abwechselnd	negative
unvergleichbar	negative
regenbogenfarben	negative
belastet	positive
überlastet	positive
überarbeitet	positive
höchstwahrscheinlich	positive
augenfällig	positive
widersinnig	negative
paradox	negative
erdenklich	positive
beschreibbar	negative
aprikosenfarbig	positive
gelassen	positive
vielfarbig	negative
anscheinend	positive
modrig	negative
moderig	negative
siderisch	positive
halbseiden	negative
dämmrig	negative
verwünscht	negative
grellbunt	negative
beispiellos	negative
wechselnd	negative
zweierlei	negative
meditativ	positive
habituell	positive
rätselhaft	positive
heikel	positive
prekär	positive
beziehungsreich	negative
innovativ	positive
fleischfarben	positive
türkis	positive
vergleichbar	positive
diskussionswürdig	positive
unbeschränkt	positive
unabdingbar	positive
unregelmässig	positive
begrifflich	positive
nochmalig	positive
haardünn	negative
hauchdünn	negative
invariant	positive
eiweissarm	negative
vitaminarm	negative
renommiert	positive
dreierlei	negative
gleichbleibend	positive
beherrscht	positive
geschätzt	positive
synonym	positive
vereinfacht	negative
allgemeinverständlich	negative
konstant	positive
gewohnheitsmässig	positive
beobachtbar	positive
hochkompliziert	negative
unverändert	positive
sterblich	negative
neuerlich	positive
denkbar	positive
kokainsüchtig	negative
tonnenschwer	positive
stilbildend	positive
opiumsüchtig	negative
breitschultrig	positive
breitkiefrig	positive
nebensächlich	negative
breithüftig	positive
astrophysikalisch	positive
unvermeidlich	positive
mehrfarbig	negative
todmüde	positive
verschlafen	positive
werterhaltend	positive
mindeste	negative
rohstoffarm	negative
kalorienarm	negative
luzid	negative
namhaft	positive
eloquent	positive
beredsam	positive
österreichweit	positive
blau	positive
therapierbar	negative
buchstabengetreu	positive
unauslöschlich	positive
polychrom	negative
maschinenlesbar	positive
winkelig	positive
dämmerig	negative
winklig	positive
monochromatisch	positive
flüchtig	negative
unbeständig	negative
morphiumsüchtig	negative
umgehend	negative
voraussichtlich	positive
erwartungsgemäss	positive
erwartungsgetreu	positive
potentiell	positive
potenziell	positive
transparent	positive
hellhörig	positive
reaktionsschnell	positive
geistesgegenwärtig	positive
wachsam	positive
dreifarbig	positive
weltbewegend	positive
akzidentiell	negative
akzidentell	negative
vorhersehbar	positive
fünfzigprozentig	negative
zwanzigprozentig	negative
dreissigprozentig	negative
zehnprozentig	negative
achtzigprozentig	negative
nährstoffarm	negative
schlank	negative
rank	negative
zentralnervös	positive
verwoben	negative
komplex	negative
vorbehaltlich	negative
neural	positive
normativ	positive
schuldbewusst	positive
russschwarz	negative
braunschwarz	negative
gemeinverständlich	negative
uni	positive
überschwer	positive
verzwickt	negative
verzwackt	negative
verflucht	negative
vermaledeit	negative
türkisfarben	positive
parkähnlich	positive
unlesbar	negative
versicherungsfremd	negative
einschränkend	negative
schützenswert	positive
konzentriert	positive
interpretationsfähig	negative
landläufig	positive
monochrom	positive
schallgedämpft	negative
andersfarbig	positive
wenigste	negative
einfarbig	positive
schlaftrunken	positive
miefig	negative
unausgeschlafen	positive
hundemüde	positive
weissgetüncht	positive
genug	positive
leer stehend	negative
leerstehend	negative
hinreichend	positive
vernunftgemäss	positive
genügend	positive
traditionsgemäss	positive
unabweisbar	positive
wechselhaft	negative
optional	negative
reich	positive
beigefarben	positive
dürr	negative
knochig	negative
hager	negative
schmächtig	negative
verfänglich	positive
grellgelb	positive
messinggelb	positive
orphisch	positive
unübersichtlich	negative
unüberschaubar	negative
zartgelb	positive
stahlgrau	positive
unerfindlich	positive
unergründlich	positive
messbar	negative
grün	positive
apfelgrün	positive
hechtgrau	positive
schiefergrau	positive
benennbar	negative
tiefrot	positive
safrangelb	positive
hinlänglich	positive
sattgelb	positive
bräunlichrot	positive
diskutierbar	positive
unmerklich	negative
kreisrund	positive
hellrot	positive
orange	positive
orangefarben	positive
vermeidbar	negative
nennbar	negative
eisblau	positive
smaragdgrün	positive
bronzefarbig	positive
sandfarbig	positive
bernsteinfarbig	positive
gertenschlank	negative
antizyklisch	positive
ephemerisch	negative
ephemer	negative
gebändert	negative
futuristisch	positive
hundertprozentig	positive
lauchgrün	positive
zartgrün	positive
strohgelb	positive
grüngelb	positive
facettenreich	negative
wortarm	negative
knöchern	negative
zwangsläufig	positive
notgedrungen	positive
unaufhaltsam	positive
unaufhaltbar	positive
impossibel	negative
orangefarbig	positive
cremefarbig	positive
rostfarbig	positive
bundesweit	positive
schwarzgrün	positive
meergrün	positive
tiefgrün	positive
lindgrün	positive
mattgrün	positive
sattgrün	positive
goldgrün	positive
türkisgrün	positive
moosgrün	positive
welk	positive
reformatorisch	positive
schriftgemäss	positive
beiderlei	negative
minütlich	positive
stündlich	positive
lehmgelb	positive
hochkomplex	negative
lanciert	negative
blitzeblau	positive
schieferblau	positive
zartblau	positive
taubenblau	positive
graugrün	positive
gelbgrün	positive
blassgrün	positive
jährlich	positive
alljährlich	positive
halbjährlich	positive
vierteljährlich	positive
wöchentlich	positive
allwöchentlich	positive
monatlich	positive
allmonatlich	positive
weltumspannend	positive
weltumfassend	positive
altersgemäss	positive
wesenhaft	positive
ganz	positive
gescheckt	negative
vereinbarungsgemäss	positive
sibyllinisch	positive
zweibahnig	positive
saisonal	positive
jahreszeitlich	positive
fluchtartig	negative
definitionsgemäss	positive
integrierend	positive
indiskutabel	negative
kobaltblau	positive
lichtblau	positive
rotblau	positive
indigoblau	positive
kornblumenblau	positive
nachtblau	positive
saphirblau	positive
königsblau	positive
veilchenblau	positive
pflaumenblau	positive
knallgelb	positive
gesundheitsgemäss	positive
schokoladenbraun	positive
wesensgemäss	positive
empfindungsgemäss	positive
häuslich	negative
unerklärbar	positive
unerklärlich	positive
perlgrau	positive
taubengrau	positive
nebelgrau	positive
eisgrau	positive
steingrau	positive
rauchgrau	positive
mausgrau	positive
grünblau	positive
normalspurig	positive
sonnengelb	positive
wunschgemäss	positive
kanariengelb	positive
gewürfelt	negative
verwickelt	negative
stoisch	negative
schweigsam	negative
wortkarg	negative
100%ig	positive
definierbar	negative
100-prozentig	positive
oligotroph	negative
vertragsgemäss	positive
gewinkelt	positive
zappelig	positive
kackbraun	positive
vollspurig	positive
nachrangig	negative
geistesabwesend	negative
vergesslich	negative
buttergelb	positive
auftragsgemäss	positive
elliptisch	positive
olivgrün	positive
schwefelgelb	positive
dornig	positive
blassgelb	positive
nussbraun	positive
gelbbraun	positive
goldbraun	positive
rehbraun	positive
tiefbraun	positive
lesenswert	positive
grasgrün	positive
zimtfarben	positive
voraussehbar	positive
beiläufig	negative
lapidar	negative
blutrot	positive
pfeilschnell	negative
subkutan	negative
inkonstant	negative
implausibel	negative
unglaubwürdig	negative
hanebüchen	negative
dunkelrot	positive
superschnell	negative
safranfarben	positive
kariert	negative
vorweggenommen	positive
konsensfähig	positive
gestreift	negative
brenzlig	positive
up to date	positive
rückwärtsgewandt	negative
zeitgemäss	positive
perkutan	negative
galoppierend	negative
rechtwinkelig	positive
rechtwinklig	positive
unsagbar	negative
unkontrolliert	positive
lückenlos	positive
mystisch	positive
feldgrau	positive
lichtgrau	positive
schwarzgrau	positive
weissgrau	positive
out	negative
anthrazitgrau	positive
kastanienrot	positive
verspätet	negative
fahlgelb	positive
modebewusst	positive
dottergelb	positive
honiggelb	positive
mattgelb	positive
anthrazitfarben	positive
silbergrau	positive
aschgrau	positive
einspurig	positive
global	positive
technikorientiert	positive
zivilisiert	positive
rauchfarben	positive
penetrant	positive
kalkig	negative
exoterisch	negative
grünlich	positive
deutbar	negative
metabolisch	negative
silberfarben	positive
kupferfarben	positive
goldfarben	positive
bronzefarben	positive
türkisblau	positive
blassblau	positive
graublau	positive
schwarzblau	positive
stahlblau	positive
kakaobraun	positive
bündnisgemäss	positive
graubraun	positive
symptomatisch	positive
kreisförmig	positive
bezeichnend	positive
fahlgrau	positive
wild	positive
unüberprüfbar	negative
gebrochen	positive
grüngrau	positive
überbreit	positive
eirund	positive
eiförmig	positive
veilchenfarben	positive
unbunt	positive
uneingeladen	positive
kakifarben	positive
khakifarben	positive
dunkelgrün	positive
umfassend	positive
vollzählig	positive
eilig	negative
hastig	negative
rapide	negative
rapid	negative
zügig	negative
kometenhaft	negative
unmöglich	negative
ausdauernd	negative
unnachgiebig	negative
beharrlich	negative
hartnäckig	negative
kaffeebraun	positive
rostbraun	positive
rostfarben	positive
unsäglich	negative
hellbraun	positive
absehbar	positive
zirkular	positive
zirkulär	positive
oval	positive
hellgrün	positive
nationalistisch	positive
nahtlos	negative
violett	positive
gelblich	positive
zitronengelb	positive
parallel	positive
komplett	positive
flink	negative
kabbalistisch	positive
verzögerungslos	negative
blitzschnell	negative
rasant	negative
schlafwandlerisch	negative
still	negative
überfordert	positive
unaufgeregt	negative
geschichtsträchtig	positive
dunkelgrau	positive
hellgrau	positive
dunkelgelb	positive
bläulich	positive
bräunlich	positive
oliv	positive
olivfarben	positive
reflexartig	negative
mosaikartig	negative
unbeschreiblich	negative
unbeschreibbar	negative
hurtig	negative
unstet	negative
autoritativ	positive
unbeherrscht	negative
schachbrettartig	negative
orthogonal	positive
unlöslich	negative
konkret	negative
prozyklisch	positive
langsam	positive
therapieresistent	positive
weissgelb	positive
lichtgrün	positive
zeitweilig	positive
orangegelb	positive
wandelbar	positive
blutleer	negative
khaki	positive
kaki	positive
luftleer	negative
bahnbrechend	positive
schleierhaft	positive
dunkel	positive
beige	positive
erneuernd	positive
geschwind	negative
metallicgrau	positive
erdfarben	positive
ungeteilt	positive
unzerteilt	positive
blitzartig	negative
sepiabraun	positive
erdbraun	positive
breitspurig	positive
mehrspurig	positive
streifig	negative
möglich	positive
erfahrungsgemäss	positive
orangen	positive
rötlichbraun	positive
schnellfüssig	negative
afro-amerikanisch	positive
cremefarben	positive
dunkelhäutig	positive
restlos	positive
ganzheitlich	positive
integral	positive
pythisch	positive
bürgerkriegsähnlich	positive
sandfarben	positive
sinnentleert	negative
bordeauxrot	positive
karmesinrot	positive
feuerrot	positive
karminrot	positive
ziegelrot	positive
braunrot	positive
weinrot	positive
gelbrot	positive
zureichend	positive
unumgänglich	positive
unausweichlich	positive
rubinrot	positive
unweigerlich	positive
saisonbedingt	positive
durchgehend	positive
durchgängig	positive
ununterbrochen	positive
cyclisch	positive
zyklisch	positive
turnunsgemäss	positive
turnusmässig	positive
periodisch	positive
peripher	negative
bettelarm	negative
hellblau	positive
olivgrau	positive
gelegentlich	positive
bitterarm	negative
sattrot	positive
orangerot	positive
rosarot	positive
purpurfarben	positive
blaugrau	positive
purpurfarbig	positive
rostrot	positive
versponnen	negative
sekundenschnell	negative
reflexhaft	negative
dunkelblau	positive
tiefblau	positive
halbstündlich	positive
wechselvoll	negative
unterbrochen	positive
veränderlich	positive
sporadisch	positive
zeitweise	positive
temporär	positive
rötlich	positive
knallrot	positive
purpurrot	positive
unkonzentriert	negative
akzessorisch	negative
reformerisch	positive
silberfarbig	positive
rosafarbig	positive
goldfarbig	positive
abschätzbar	positive
angebbar	negative
reformistisch	positive
delphisch	positive
rosafarben	positive
rosa	positive
bernsteinfarben	positive
magentafarben	positive
ockerbraun	positive
magenta	positive
giftgrün	positive
abnehmend	negative
zunehmend	negative
nachlassend	negative
verringernd	negative
degressiv	negative
goldgelb	positive
unentbehrlich	positive
hellgelb	positive
zerstreut	negative
zinnoberrot	positive
rosenrot	positive
kupferrot	positive
kirschrot	positive
hochrot	positive
zahlbar	positive
schnellwüchsig	negative
vernachlässigbar	negative
unfassbar	positive
scharlachrot	positive
zimtfarbig	positive
unbelastet	negative
explosionsartig	negative
gehalten	negative
imperativ	positive
kupferbraun	positive
anthrazit	positive
technikgläubig	positive
aufgeklärt	positive
fortschrittlich	positive
planbar	negative
olivbraun	positive
menschenleer	negative
halbleer	negative
alsbaldig	negative
verarmt	negative
pleite	negative
spitzwinklig	positive
spitzwinkelig	positive
stumpfwinklig	positive
ungekürzt	positive
stumpfwinkelig	positive
täglich	positive
sinnleer	negative
texturiert	negative
geblümt	negative
marmoriert	negative
gemasert	negative
gefleckt	negative
gepunktet	negative
gesprenkelt	negative
blaurot	positive
iterativ	positive
aufbrausend	negative
wohlhabend	positive
gutsituiert	positive
betucht	positive
vermögend	positive
gut betucht	positive
gutbetucht	positive
zahlungskräftig	positive
rappeldürr	negative
empört	positive
entrüstet	positive
zitierbar	negative
stet	positive
lauffähig	positive
altrosa	positive
schwerreich	positive
steinreich	positive
neureich	positive
anschaulich	negative
dunkelbraun	positive
unbeschadet	positive
funktionstüchtig	positive
lilafarbig	positive
unaussprechlich	negative
regionaltypisch	positive
bündnisgrün	positive
interpretierbar	negative
ockerfarbig	positive
klapperdürr	negative
spindeldürr	negative
abgezehrt	negative
unterernährt	negative
abgemergelt	negative
ausgemergelt	negative
archetypisch	positive
unabkömmlich	positive
floral	negative
träumerisch	negative
unbeschädigt	positive
notleidend	negative
not leidend	negative
kaputt	negative
funktionsfähig	positive
intakt	positive
entlarvend	positive
werktäglich	positive
alltäglich	positive
tagtäglich	positive
roséfarbig	positive
roséfarben	positive
fakultativ	negative
sonntäglich	positive
kapitalkräftig	positive
himmelblau	positive
rosé	positive
marine	positive
revolutionär	positive
vielspurig	positive
fünfspurig	positive
doppelspurig	positive
dreispurig	positive
gedankenverloren	negative
historisch	positive
unabsehbar	negative
hochverräterisch	positive
superreich	positive
situiert	positive
unabwendbar	positive
achtspurig	positive
zerteilt	negative
stinkreich	positive
unentwegt	negative
landestypisch	positive
zeittypisch	positive
rückständig	negative
fuchsig	positive
fuchsteufelswild	positive
weitgespannt	positive
lachsfarben	positive
nachmessbar	negative
anachronistisch	negative
pausenlos	positive
nachgiebig	positive
szenetypisch	positive
lilafarben	positive
lila	positive
allumfassend	positive
frauentypisch	positive
erzürnt	positive
lokal	negative
reguliert	negative
geregelt	positive
regelhaft	positive
typisch	positive
zornig	positive
wütend	positive
vollumfänglich	positive
urdeutsch	positive
flaschengrün	positive
tannengrün	positive
vorschnell	negative
voreilig	negative
unermüdlich	negative
überprüfbar	positive
magmarot	positive
glühendrot	positive
nichtständig	positive
nicht ständig	positive
pastellblau	positive
wieselflink	negative
bestimmbar	negative
längs gestreift	negative
längsgestreift	negative
unterfordert	negative
unterqualifiziert	positive
aufgeregt	positive
sinkend	negative
quer gestreift	negative
quergestreift	negative
kalkhaltig	negative
rückläufig	negative
azurblau	positive
schleppend	positive
ungebeten	positive
kaufkräftig	positive
travers	negative
bedürftig	negative
weitgreifend	positive
ruckartig	negative
andante	positive
gemächlich	positive
fliederfarben	positive
dunkelviolett	positive
indigniert	positive
ockergelb	positive
abwesend	negative
unzerstört	positive
verträumt	negative
altersgerecht	positive
ockerfarben	positive
männertypisch	positive
esoterisch	positive
betriebsfähig	positive
reizbar	negative
fleckig	negative
stockend	positive
marineblau	positive
pinkfarben	positive
pink	positive
altrosafarben	positive
zurückgehend	negative
abflauend	negative
rezessiv	negative
unkontrollierbar	negative
klapprig	negative
abgemagert	negative
involviert	negative
begütert	positive
gedankenversunken	negative
muschelkalkhaltig	negative
jähzornig	negative
datierbar	negative
überreich	positive
rückgängig	negative
unaufschiebbar	negative
sechsspurig	positive
vierspurig	positive
zweispurig	positive
rückzahlbar	positive
apriorisch	positive
ernstlich	negative
dringlich	negative
verräterisch	positive
stupid	negative
stupide	negative
dringend	negative
lax	positive
halbstündig	positive
andantino	positive
diachron	positive
naturhistorisch	positive
schwarzbraun	positive
geschnitten	negative
zuordenbar	positive
malvenfarben	positive
malvenfarbig	positive
letztmöglich	positive
zerrüttet	negative
zerlöchert	negative
perforiert	negative
naturgeschichtlich	positive
literaturgeschichtlich	positive
entwicklungsgeschichtlich	positive
musikgeschichtlich	positive
zurechenbar	positive
geharnischt	positive
zerstört	negative
korrosiv	negative
versonnen	negative
selbstvergessen	negative
zerissen	negative
beschädigt	negative
defekt	negative
allabendlich	positive
allmorgendlich	positive
konterrevolutionär	positive
fraktioniert	negative
schrottreif	negative
diachronisch	positive
lahm	positive
sozialgeschichtlich	positive
arbeitsteilig	negative
prototypisch	positive
untypisch	negative
machbar	positive
stereotypisch	positive
allseitig	positive
illustrativ	negative
nächstmöglich	positive
inkompatibel	negative
unvereinbar	negative
undurchführbar	negative
zeitgeschichtlich	positive
geschichtlich	positive
landesgeschichtlich	positive
nachprüfbar	positive
aufgeteilt	negative
militärhistorisch	positive
stammesgeschichtlich	positive
verfolgbar	positive
löslich	positive
erregbar	negative
zerfasert	negative
zerkleinert	negative
ausführbar	positive
auberginefarben	positive
zurückgeblieben	negative
erbittert	positive
absinkend	negative
schadhaft	negative
stetig	positive
dauernd	positive
fortwährend	positive
fortgesetzt	positive
kontinuierlich	positive
gegenrevolutionär	positive
schutzbedürftig	negative
reparaturbedürftig	negative
aufgebracht	positive
lasch	positive
leger	positive
wärmebedürftig	negative
literarhistorisch	positive
rückgebildet	negative
stereotyp	positive
musikhistorisch	positive
literaturhistorisch	positive
kontrollierbar	positive
ideengeschichtlich	positive
dogmengeschichtlich	positive
andauernd	positive
überkandidelt	positive
exaltiert	positive
idealtypisch	positive
fallend	negative
überqualifiziert	negative
permanent	positive
wasserunlöslich	negative
ungebrochen	positive
unablässig	positive
architekturhistorisch	positive
architekturgeschichtlich	positive
regionalgeschichtlich	positive
stadtgeschichtlich	positive
regressiv	negative
durchführbar	positive
erdgeschichtlich	positive
wirkungsgeschichtlich	positive
vernichtet	negative
eingefallen	negative
kirchengeschichtlich	positive
realisierbar	positive
umsetzbar	positive
urgeschichtlich	positive
weltgeschichtlich	positive
sprachgeschichtlich	positive
rückführbar	positive
zurückführbar	positive
verwirklichbar	positive
ramponiert	negative
theatergeschichtlich	positive
heilsgeschichtlich	positive
wissenschaftsgeschichtlich	positive
landeshistorisch	positive
transusig	positive
tranig	positive
träge	positive
träg	positive
kirchenhistorisch	positive
filmhistorisch	positive
kriegsgeschichtlich	positive
filmgeschichtlich	positive
wirtschaftsgeschichtlich	positive
rechtsgeschichtlich	positive
militärgeschichtlich	positive
religionsgeschichtlich	positive
zeithistorisch	positive
sprachhistorisch	positive
stadthistorisch	positive
welthistorisch	positive
wirtschaftshistorisch	positive
rechtshistorisch	positive
religionshistorisch	positive
universalgeschichtlich	positive
darstellbar	positive
abziehbar	positive
kleingeschnitten	negative
topisch	negative
unterentwickelt	negative
diskontinuierlich	negative
vereinbar	positive
überwindbar	positive
lösbar	positive
mangelnd	negative
anwesend	positive
kompatibel	positive
unbewältigbar	negative
abbildbar	positive
geschnetzelt	negative
rekonstruierbar	positive
aufführbar	positive
prüfbar	positive
unspielbar	negative
erfüllbar	positive
eingeschnitten	negative
unstetig	negative
steigend	positive
unrealisierbar	negative
renovierungsbedürftig	negative
schockiert	positive
geschockt	positive
retardiert	negative
durchsetzbar	positive
atypisch	negative
wiederholbar	positive
öllöslich	positive
alkohollöslich	positive
fettlöslich	positive
schwerlöslich	positive
schwer löslich	positive
wasserlöslich	positive
spielbar	positive
fehlend	negative
sequentiell	positive
sequenziell	positive
aufeinander folgend	positive
aufeinanderfolgend	positive
zerschnitten	negative
zersäbelt	negative
sukzessiv	positive
fortlaufend	positive
calvinistisch	positive
gehbehindert	positive
sanierungsbedürftig	negative
unlösbar	negative
methodistisch	positive
konstruierbar	positive
fortschreitend	positive
partizipierend	positive
konsekutiv	positive
unauflöslich	negative
aufhebbar	positive
behebbar	positive
auflöslich	positive
absetzbar	positive
auflösbar	positive
hoch entwickelt	positive
hochentwickelt	positive
schubweise	negative
stossweise	negative
unaufhebbar	negative
allgegenwärtig	positive
teilnehmend	positive
unüberwindbar	negative
unüberwindlich	negative
entsetzt	positive
entgeistert	positive
fassungslos	positive
hugenottisch	positive
gelähmt	positive
illusorisch	negative
utopisch	negative
reproduzierbar	positive
panisch	positive
panikartig	positive
ansteigend	positive
paralysiert	positive
vollstreckbar	positive
allzugegen	positive
unauflösbar	negative
überbrückbar	positive
omnipräsent	positive
einklagbar	positive
unüberbrückbar	negative
ubiquitär	positive
höchstentwickelt	positive
