ausgezeichnet	positive
effektiv	positive
unverständlich	negative
edel	positive
hervorragend	positive
froh	positive
hinterhältig	negative
gut	positive
glücklich	positive
fest	positive
hinterlistig	negative
übel	negative
gefährlich	negative
elegant	positive
arrogant	negative
verdorben	negative
unmoralisch	negative
angenehm	positive
verbrecherisch	negative
verrucht	negative
freundlich	positive
kaputt	negative
beschädigt	negative
defekt	negative
verlogen	negative
falsch	negative
unehrlich	negative
problematisch	negative
aufrichtig	positive
ehrlich	positive
irreführend	negative
lieb	positive
erstaunlich	positive
einwandfrei	positive
bezaubernd	positive
begeistert	positive
allerbeste	positive
attraktiv	positive
grossartig	positive
faszinierend	positive
empört	negative
hässlich	negative
verärgert	negative
wütend	negative
schrecklich	negative
schön	positive
begehrt	positive
höflich	positive
verdammt	negative
unbeliebt	negative
berühmt	positive
bequem	positive
qualitätvoll	positive
anständig	positive
brillant	positive
diskret	positive
kompliziert	negative
nachtragend	negative
mangelhaft	negative
listig	negative
aggressiv	negative
dumm	negative
fabelhaft	positive
beliebt	positive
feindlich	negative
nett	positive
gemein	negative
perfekt	positive
mustergültig	positive
vorbildlich	positive
beispielhaft	positive
exzellent	positive
exzeptionell	positive
aussergewöhnlich	positive
ausserordentlich	positive
prominent	positive
weltberühmt	positive
sinnreich	positive
verkehrt	negative
unecht	negative
unrecht	negative
flüssig	negative
solid	positive
solide	positive
hautfreundlich	positive
hart	positive
teilweise	negative
partiell	negative
unbegreifbar	negative
unbegreiflich	negative
verständlich	positive
notbehelfsmässig	negative
entgegenkommend	positive
vortrefflich	positive
bestechend	positive
herausragend	positive
vorzüglich	positive
fein	positive
frank	positive
ergebnisreich	positive
zweckmässig	positive
sinnvoll	positive
sinnig	positive
imageträchtig	positive
ehrenvoll	positive
prestigeträchtig	positive
optimal	positive
umgekehrt	negative
halbherzig	negative
wartungsfreundlich	positive
fröhlich	positive
erfreulich	positive
freudig	positive
hinterfotzig	negative
infam	negative
fies	negative
mies	negative
schadenfroh	negative
unerfindlich	negative
unergründlich	negative
unfassbar	negative
pikant	negative
frivol	negative
anstössig	negative
unglücklich	negative
blendend	positive
glimpflich	positive
besser	positive
glückreich	positive
sittlich	positive
moralisch	positive
ethisch	positive
stramm	positive
locker	negative
traurig	negative
schwärmerisch	positive
arglistig	negative
heimtückisch	negative
durchtrieben	negative
tückisch	negative
perfide	negative
risikoreich	negative
riskant	negative
ranzig	negative
obsessiv	positive
vielgefragt	positive
viel gefragt	positive
unkorrekt	negative
selbstverliebt	negative
lebensbejahend	positive
lebenslustig	positive
lebensfroh	positive
heilfroh	positive
erleichtert	positive
zerrüttet	negative
zerlöchert	negative
perforiert	negative
sagenhaft	positive
dünkelhaft	negative
blasiert	negative
aufgeblasen	negative
herablassend	negative
abgehoben	negative
überheblich	negative
tugendreich	positive
debil	negative
aristokratisch	positive
adlig	positive
adelig	positive
nobel	positive
vornehm	positive
blaublütig	positive
existenzbedrohend	negative
luderhaft	negative
verwerflich	negative
unanständig	negative
sittenlos	negative
verworfen	negative
unsittlich	negative
zerstört	negative
geruhsam	positive
behaglich	positive
gemütlich	positive
unschuldig	positive
schändlich	negative
hochnäsig	negative
korrosiv	negative
anzüglich	negative
zerissen	negative
eingefallen	negative
unbeschädigt	positive
intakt	positive
ganz	positive
irrig	negative
unbequem	negative
zufriedenstellend	positive
unangenehm	negative
wohlig	positive
befriedigend	positive
komfortabel	positive
wohltuend	positive
schrottreif	negative
lügnerisch	negative
unaufrichtig	negative
heuchlerisch	negative
bigott	negative
scheinheilig	negative
idealistisch	positive
enthusiastisch	positive
leidenschaftlich	positive
schwindlig	negative
schlecht	negative
bruchstückartig	negative
problemvoll	negative
druckfest	positive
liebevoll	positive
unverdorben	positive
aufrecht	positive
okay	positive
stilsicher	positive
unübertrefflich	positive
verschlagen	negative
link	negative
fix	positive
ungelenk	positive
ungelenkig	positive
gegeben	positive
feststehend	positive
strahlend	positive
glückstrahlend	positive
überglücklich	positive
seelig	positive
wundervoll	positive
ärgerlich	negative
unangemessen	negative
inadäquat	negative
verfehlt	negative
mau	negative
flau	negative
vertrauenswürdig	positive
lebensbedrohend	negative
unflexibel	positive
unbeweglich	positive
starr	positive
frohgestimmt	positive
froh gestimmt	positive
zufrieden	positive
ungetrübt	positive
angeblich	negative
fehlleitend	negative
antideutsch	negative
deutschfeindlich	negative
eifrig	positive
arbeitsam	positive
emsig	positive
fleissig	positive
tüchtig	positive
vernichtet	negative
hybrid	negative
letal	negative
intrigant	negative
irregulär	negative
irrtümlich	negative
unrichtig	negative
unzutreffend	negative
fälschlich	negative
unwahr	negative
gütig	positive
liebesfähig	positive
liebenswürdig	positive
unästhetisch	negative
geharnischt	negative
lustfeindlich	negative
parteifeindlich	negative
religionsfeindlich	negative
bildschön	positive
schwererziehbar	negative
schwer erziehbar	negative
ertragbar	positive
schmeichelhaft	positive
geistesschwach	negative
unerklärbar	negative
unerklärlich	negative
garstig	negative
tadellos	positive
überraschend	positive
preisgekrönt	positive
unförmig	negative
geschmackvoll	positive
pickelig	negative
entstellt	negative
israelfeindlich	negative
kaiserfeindlich	negative
männerfeindlich	negative
christenfeindlich	negative
demokratiefeindlich	negative
minderheitenfeindlich	negative
regimefeindlich	negative
sicher	positive
überzeugt	positive
felsenfest	positive
offensiv	negative
draufgängerisch	negative
angefressen	negative
zauberhaft	positive
hochgefährlich	negative
deformiert	negative
verformt	negative
behindertenfeindlich	negative
wissenschaftsfeindlich	negative
reformfeindlich	negative
islamfeindlich	negative
kulturfeindlich	negative
leibfeindlich	negative
körperfeindlich	negative
fuchsig	negative
fuchsteufelswild	negative
tugendhaft	positive
gerecht	positive
fair	positive
tugendlich	positive
bedrohlich	negative
charmant	positive
scharmant	positive
kokett	positive
stilgerecht	positive
risikobehaftet	negative
unattraktiv	negative
adrett	positive
gepflegt	positive
appetitlich	positive
unerbittlich	positive
unbarmherzig	positive
reparaturbedürftig	negative
aufgebracht	negative
unversöhnlich	negative
grandios	positive
berauschend	positive
hochklassig	positive
meisterlich	positive
hochwertig	positive
elefantös	positive
gelangweilt	negative
fesselnd	positive
begeisternd	positive
antiklerikal	negative
schmuck	positive
stilvoll	positive
ansprechend	positive
dekorativ	positive
schwulenfeindlich	negative
regierungsfeindlich	negative
verlebt	negative
potthässlich	negative
verbraucht	negative
schurkisch	negative
ergänzungsbedürftig	negative
böse	negative
bös	negative
erzürnt	negative
indigniert	negative
entrüstet	negative
günstig	positive
geeignet	positive
gehoben	positive
gefällig	positive
eingängig	positive
ideal	positive
verderbt	negative
leutselig	positive
fulminant	positive
vergnügt	positive
unansehnlich	negative
vorzeigbar	positive
ansehnlich	positive
erträglich	positive
wild	negative
zornig	negative
erfolg versprechend	positive
erfolgversprechend	positive
legendär	positive
herrlich	positive
prima	positive
wunderbar	positive
fintenreich	negative
himmlisch	positive
paradiesisch	positive
immobil	positive
fürsorglich	positive
erstklassig	positive
spitzenmässig	positive
spitze	positive
klasse	positive
endgeil	positive
hübsch	positive
wunderschön	positive
wohl geformt	positive
wohlgeformt	positive
volksfeindlich	negative
geistfeindlich	negative
streitlustig	negative
wünschenswert	positive
kunstfeindlich	negative
gesellschaftsfeindlich	negative
umkämpft	positive
gefragt	positive
anziehend	positive
sinnlich	positive
bildungsfeindlich	negative
fortschrittsfeindlich	negative
feingeschnitten	positive
fein geschnitten	positive
unzufrieden	negative
gefahrvoll	negative
geschmeidig	positive
indiskret	negative
leserfreundlich	positive
klug	positive
durchbrochen	negative
zuvorkommend	positive
verwünscht	negative
liebreich	positive
unelastisch	positive
kontrafaktisch	negative
schwierig	negative
liebreizend	positive
lieblich	positive
charismatisch	positive
verführerisch	positive
betörend	positive
unwiderstehlich	positive
gelungen	positive
geraten	positive
liebenswert	positive
torgefährlich	negative
explosionsgefährlich	negative
brandgefährlich	negative
missliebig	negative
unliebsam	negative
ungeliebt	negative
verhasst	negative
renommiert	positive
bewundert	positive
schadhaft	negative
frech	negative
paradigmatisch	positive
sinnhaft	positive
gutartig	positive
verträglich	positive
unschädlich	positive
zuträglich	positive
umschwärmt	positive
umworben	positive
geliebt	positive
gemocht	positive
vergöttert	positive
verehrt	positive
scharfsinnig	positive
kirchenfeindlich	negative
magenfreundlich	positive
bedienungsfreundlich	positive
kundenfreundlich	positive
taktvoll	positive
galant	positive
herausfordernd	negative
unkalkulierbar	negative
unberechenbar	negative
unkompliziert	positive
gemeingefährlich	negative
vermeintlich	negative
trickreich	negative
undurchschaubar	negative
xenophob	negative
provokativ	negative
hochherrschaftlich	positive
rassig	positive
apart	positive
akzeptabel	positive
genehm	positive
begrüssenswert	positive
meisterhaft	positive
halb	negative
unvollständig	negative
lückenhaft	negative
notdürftig	negative
defizitär	negative
unvollkommen	negative
verfallen	negative
verrottet	negative
schimmelig	negative
verschimmelt	negative
unproblematisch	positive
streitsüchtig	negative
gehässig	negative
bissig	negative
aufhetzend	negative
aufwiegelnd	negative
zänkisch	negative
zanksüchtig	negative
herzensgut	positive
grundfalsch	negative
qualitätsvoll	positive
unkeusch	negative
nutzbringend	positive
nützlich	positive
atemraubend	positive
atemberaubend	positive
anteilig	negative
rudimentär	negative
fragmentarisch	negative
bruchstückhaft	negative
begehrenswert	positive
investitionsfreundlich	positive
familienfeindlich	negative
staatsfeindlich	negative
menschenfeindlich	negative
bedenkenswert	positive
saublöd	negative
saudumm	negative
saudoof	negative
ignorant	negative
tumb	negative
töricht	negative
einfältig	negative
schwachsinnig	negative
strohdoof	negative
strohdumm	negative
verwoben	negative
verworren	negative
vielschichtig	negative
komplex	negative
passioniert	positive
hetzerisch	negative
demagogisch	negative
barmherzig	positive
angriffslustig	negative
kampflustig	negative
kampfeslustig	negative
kriegerisch	negative
forsch	negative
traumhaft	positive
idyllisch	positive
sensationell	positive
legendenhaft	positive
ruchbar	negative
faulig	negative
verfault	negative
famos	positive
technikfeindlich	negative
ausländerfeindlich	negative
fremdenfeindlich	negative
provozierend	negative
frauenfeindlich	negative
rassistisch	negative
umweltfeindlich	negative
verfassungsfeindlich	negative
unterbelichtet	negative
doof	negative
blöd	negative
dämlich	negative
dull	negative
verzwickt	negative
vertrackt	negative
verzwackt	negative
verflixt	negative
verflucht	negative
vermaledeit	negative
ramponiert	negative
glückselig	positive
grossherzig	positive
gutherzig	positive
gutmütig	positive
friedlich	positive
friedliebend	positive
edelmütig	positive
umgänglich	positive
dusselig	negative
dusslig	negative
ungefährdet	positive
prächtig	positive
märchenhaft	positive
prachtvoll	positive
unedel	negative
perfid	negative
beziehungsreich	negative
unfertig	negative
tödlich	negative
lebensbedrohlich	negative
lebensgefährlich	negative
geehrt	positive
geschätzt	positive
gelitten	positive
begriffsstutzig	negative
belämmert	negative
feindselig	negative
feindschaftlich	negative
unfreundlich	negative
altklug	negative
anmassend	negative
besserwisserisch	negative
eingebildet	negative
geckenhaft	negative
missvergnügt	negative
ortsfest	positive
hochkompliziert	negative
unfehlbar	positive
überragend	positive
stupid	negative
stupide	negative
chancenreich	positive
erfolgreich	positive
listenreich	negative
wohlgesonnen	positive
wohlgesinnt	positive
gesinnt	positive
freundschaftlich	positive
kameradschaftlich	positive
partnerschaftlich	positive
kumpelhaft	positive
republikfeindlich	negative
bescheuert	negative
behämmert	negative
trottelhaft	negative
trottelig	negative
idiotenhaft	negative
idiotisch	negative
vorbildhaft	positive
unzüchtig	negative
jovial	positive
kollegial	positive
menschenwürdig	positive
menschenfreundlich	positive
friedvoll	positive
hochadelig	positive
vielversprechend	positive
aussichtsreich	positive
lohnenswert	positive
lohnend	positive
gelegen	positive
tränenreich	negative
recht	positive
echt	positive
dünnflüssig	negative
zähflüssig	negative
los	negative
lose	negative
schlabbrig	negative
schlabberig	negative
lauter	positive
standhaft	positive
unbescholten	positive
integer	positive
charakterfest	positive
reputierlich	positive
unerfreulich	negative
schwermütig	negative
misslich	negative
neunzigprozentig	negative
sechzigprozentig	negative
kleinadelig	positive
kleinadlig	positive
züchtig	positive
entwürdigend	negative
durchschaubar	positive
anrechnungsfähig	positive
feuerflüssig	negative
schmelzflüssig	negative
leichtflüssig	negative
bestmöglich	positive
untadlig	positive
untadelig	positive
steif	positive
betulich	positive
kompromissbereit	positive
zärtlich	positive
herzig	positive
gesprächsbereit	positive
teilbar	positive
erstrebenswert	positive
regulär	positive
vorschriftsmässig	positive
ordnungsgemäss	positive
adäquat	positive
verstehbar	positive
kombinierbar	positive
brüchig	negative
fluffig	negative
porös	negative
mehlig	negative
geistvoll	positive
heiter	positive
erquicklich	positive
wehmütig	negative
schwarz	negative
feige	negative
feig	negative
fassbar	positive
einleuchtend	positive
erfassbar	positive
lötfähig	positive
steinhart	positive
treu sorgend	positive
treusorgend	positive
hochprozentig	negative
dankbar	positive
verteufelt	negative
verbessernd	positive
perspektivreich	positive
opportun	positive
angebracht	positive
passend	positive
inbrünstig	positive
unfair	negative
ungerecht	negative
nutzbar	positive
mythisch	positive
kabbalistisch	negative
bürgerlich	negative
uneinnehmbar	positive
siebzigprozentig	negative
lustbetont	positive
befreit	positive
lustvoll	positive
erlöst	positive
beruhigt	positive
trist	negative
enttäuscht	negative
trübselig	negative
betrübt	negative
freudlos	negative
tieftraurig	negative
trostlos	negative
melancholisch	negative
deprimierend	negative
brauchbar	positive
facettenreich	negative
hochintelligent	positive
ekel erregend	negative
ekelerregend	negative
ekelhaft	negative
kriminell	negative
gewinnend	positive
klobig	negative
raubeinig	negative
königlich	positive
feudalistisch	positive
feudal	positive
höfisch	positive
unautorisiert	negative
stahlhart	positive
wüst	negative
ungehobelt	negative
wuchtig	positive
anmutig	positive
graziös	positive
ernst	negative
schmachvoll	negative
schmählich	negative
fragwürdig	negative
standfest	positive
beihilfefähig	positive
ineffektiv	negative
heimelig	positive
schuldig	negative
unstandesgemäss	negative
menschlich	positive
royal	positive
fürstlich	positive
kaiserlich	positive
hochkomplex	negative
entschieden	positive
liederlich	negative
lasterhaft	negative
zügellos	negative
entartet	negative
dekadent	negative
heruntergekommen	negative
hochverehrt	positive
kernig	positive
stabil	positive
sinnentstellend	negative
hartherzig	positive
unbegründet	negative
grundlos	negative
funktionsfähig	positive
funktionstüchtig	positive
unbefriedigend	negative
unzerstört	positive
einladend	positive
fünfprozentig	negative
harsch	positive
gewalttätig	negative
matt	negative
kräftezehrend	positive
frostsicher	positive
bombensicher	positive
kleidsam	positive
glühend	positive
duftig	positive
abgehärtet	positive
kaltherzig	positive
kalt	positive
unverhältnismässig	negative
unberechtigt	negative
fleischlich	positive
fünfzigprozentig	negative
rasend	positive
frenetisch	positive
strömungsgünstig	positive
erdrückend	negative
bedrückend	negative
belastend	negative
mulmig	negative
abstossend	negative
unsympathisch	negative
unbehaglich	negative
ungemütlich	negative
beklemmend	negative
regelgerecht	positive
brisant	negative
beinhart	positive
eisenhart	positive
unsäglich	negative
unbeschreibbar	negative
geländegängig	positive
seelsorglich	positive
aushaltbar	positive
peinlich	negative
humorvoll	positive
humorig	positive
faul	negative
eilfertig	positive
betriebsam	positive
geschäftig	positive
beflissen	positive
übereifrig	positive
servil	positive
diensteifrig	positive
tatkräftig	positive
agil	positive
befremdlich	negative
beängstigend	negative
nahrhaft	positive
grobschlächtig	negative
ungeschlacht	negative
wohnlich	positive
frauenfreundlich	positive
verkehrsgünstig	positive
ausgelassen	positive
unkomfortabel	negative
reaktionsfähig	positive
gesundheitsfördernd	positive
unsachgemäss	negative
regelgemäss	positive
pharisäisch	negative
entschlossen	positive
resolut	positive
misslungen	negative
hochzufrieden	positive
stümperhaft	negative
beschwingt	positive
quietschvergnügt	positive
miserabel	negative
schäbig	negative
trügerisch	negative
täuschend	negative
nominell	negative
vorgeblich	negative
zukunftsfähig	positive
lagerfähig	positive
marktfähig	positive
lausig	negative
hochgeschätzt	positive
angemessen	positive
lebenstüchtig	positive
untüchtig	negative
geschäftstüchtig	positive
unvorteilhaft	negative
lustig	positive
gemeinverständlich	positive
phänomenal	positive
feingemahlen	positive
wertstabil	positive
preisstabil	positive
richtungsstabil	positive
cremig	negative
polemisch	negative
hündisch	negative
gelogen	negative
erlogen	negative
gefälscht	negative
vorgetäuscht	negative
ungerechtfertigt	negative
goldig	positive
putzig	positive
unbefugt	negative
gnädig	positive
niedlich	positive
verzeihend	positive
hartgesotten	positive
seelenruhig	positive
abgezockt	positive
kaltschnäuzig	positive
ausgekocht	positive
abgebrüht	positive
nichtsnutzig	negative
feinkörnig	positive
seelsorgerisch	positive
seelsorgerlich	positive
vierschrötig	negative
standesherrlich	positive
rein	positive
wichtigtuerisch	negative
lümmelhaft	negative
flegelhaft	negative
ruppig	negative
pöbelhaft	negative
grob	negative
rüpelhaft	negative
formell	positive
gelenkig	negative
flexibel	negative
beweglich	negative
mobil	negative
elastisch	negative
unangebracht	negative
unpassend	negative
unerhört	negative
ungehörig	negative
zugänglich	positive
unbeschreiblich	negative
menschenunwürdig	negative
kaltblütig	positive
grundsolide	positive
grundsolid	positive
unmenschlich	negative
inhuman	negative
vorschriftsgemäss	positive
bucklig	negative
buckelig	negative
verwachsen	negative
formschön	positive
formvollendet	positive
starrköpfig	positive
rigide	positive
rigid	positive
rigoros	positive
unflätig	negative
schlitzohrig	positive
zweckfrei	negative
unzweckmässig	negative
unverbindlich	negative
versöhnlich	positive
redlich	positive
genant	negative
genierlich	negative
erklärlich	positive
erklärbar	positive
reizend	positive
zerbeult	negative
orthodox	positive
betriebssicher	positive
knallhart	positive
erbittert	negative
phantastisch	positive
fantastisch	positive
verbindlich	positive
panzerbrechend	positive
ästhetisch	positive
süss	positive
knuffig	positive
possierlich	positive
rechtschaffen	positive
lästig	negative
prätentiös	negative
unsagbar	negative
fraglos	positive
ehrenhaft	positive
beschränkt	negative
begreifbar	positive
gewiss	positive
begreiflich	positive
strapaziös	positive
gelehrig	positive
verschwitzt	negative
verwahrlost	negative
deprimiert	negative
renovierungsbedürftig	negative
eingeschnappt	negative
unerreicht	positive
verletzt	negative
pikiert	negative
erbost	negative
schockiert	negative
geschockt	negative
unnachahmlich	positive
richtig	positive
virtuos	positive
kunstfertig	positive
hieratisch	positive
apathisch	negative
gediegen	positive
seriös	positive
unverträglich	negative
nervig	negative
strafwürdig	negative
arbeitsfreudig	positive
arbeitswillig	positive
todsicher	positive
schmuckvoll	positive
unübertroffen	positive
neuwertig	positive
human	positive
verleumderisch	negative
verbittert	negative
siegesbewusst	positive
siegesgewiss	positive
siegessicher	positive
staatsmännisch	positive
korrekturbedürftig	negative
sauer	negative
gekränkt	negative
beleidigt	negative
bitterböse	negative
waffenfähig	positive
tauglich	positive
lebensmüde	negative
unbeschadet	positive
einnehmend	positive
aktiv	positive
klotzig	negative
kugelsicher	positive
geil	positive
sexy	positive
unfein	negative
leidlich	positive
zumutbar	positive
unbeirrbar	positive
konsequent	positive
trübsinnig	negative
unsicher	negative
selbstmörderisch	negative
grottig	negative
verlottert	negative
verkommen	negative
unappetitlich	negative
ungepflegt	negative
schmuddelig	negative
vergammelt	negative
verlumpt	negative
wohlwollend	positive
gutgemeint	positive
behütend	positive
schützend	positive
wohlmeinend	positive
lawinensicher	positive
orgiastisch	negative
bekümmert	negative
lauffähig	positive
uneinholbar	positive
finessenreich	positive
marktbeherrschend	positive
marktführend	positive
tanzbar	positive
vollständig	positive
abgelaufen	negative
charakterlos	negative
entspannend	positive
aufmerksam	positive
erholsam	positive
gesundheitsförderlich	positive
gesundheitsdienlich	positive
förderlich	positive
kolloid	positive
kolloidal	positive
betroffen	negative
wettbewerbsfähig	positive
konkurrenzfähig	positive
statisch	positive
vollkommen	positive
geklärt	positive
griffig	positive
grauslich	negative
ungeahnt	positive
damenhaft	positive
unerahnt	positive
unbefriedigt	negative
amoralisch	negative
toll	positive
dornig	negative
sanierungsbedürftig	negative
todtraurig	negative
todunglücklich	negative
einsam	negative
bedrückt	negative
reumütig	negative
patzig	negative
diffizil	negative
leid	negative
originell	positive
defensiv	positive
unlöslich	negative
fertig	positive
leidtragend	negative
leid tragend	negative
allegro	positive
arkadisch	positive
intelligent	positive
schlau	positive
hilfsbereit	positive
hilfreich	positive
hochadlig	positive
betrüblich	negative
wertig	positive
erkoren	positive
huldreich	positive
erlernbar	positive
magnetisierbar	positive
bespielbar	positive
fragil	positive
niederträchtig	negative
unartig	negative
handstreichartig	positive
impertinent	negative
homophob	negative
elegisch	negative
grosskotzig	negative
gekonnt	positive
knifflig	negative
vorhersagbar	positive
vorherbestimmt	positive
heikel	negative
prekär	negative
rechthaberisch	negative
ertragssicher	positive
auserwählt	positive
prädestiniert	positive
auserkoren	positive
vorbestimmt	positive
erlebbar	positive
zerbrechlich	positive
filigran	positive
unhöflich	negative
despektierlich	negative
verächtlich	negative
unmanierlich	negative
ungebührlich	negative
erprobt	positive
bewährt	positive
probat	positive
eminent	positive
fördernd	positive
missraten	negative
anerkannt	positive
schlimm	negative
dilettantisch	negative
angeberisch	negative
grossspurig	negative
grossmäulig	negative
prahlerisch	negative
fehlerhaft	negative
allgemeinverständlich	positive
heilsam	positive
unbedenklich	positive
probiotisch	positive
heilend	positive
bösartig	negative
pejorativ	negative
gelobt	positive
gehuldigt	positive
einfallsreich	positive
ideenreich	positive
taktlos	negative
unverfroren	negative
kalkulierbar	positive
lautstark	negative
unverschämt	negative
vorlaut	negative
vollmundig	negative
ungezogen	negative
undankbar	negative
pflegeleicht	positive
sanftmütig	positive
gedeihlich	positive
gespielt	negative
deterministisch	positive
betriebsfähig	positive
geniessbar	positive
bekömmlich	positive
ungiftig	positive
essbar	positive
verdaulich	positive
umweltverträglich	positive
überfallartig	positive
luzid	positive
erstattungsfähig	positive
genialisch	positive
vergeistigt	positive
clever	positive
alert	positive
auf zack	positive
genial	positive
manifest	positive
unüberprüfbar	negative
sichtlich	positive
offenkundig	positive
offensichtlich	positive
schnippisch	negative
scharfzüngig	negative
zynisch	negative
höhnisch	negative
singbar	positive
bildhübsch	positive
unvermutet	positive
unschön	negative
laienhaft	negative
ungeeignet	negative
ungut	negative
unprofessionell	negative
nutzlos	negative
unerwartet	positive
flapsig	negative
annehmbar	positive
hinnehmbar	positive
unverhofft	positive
vertretbar	positive
stadtverträglich	positive
menschenverträglich	positive
gesellschaftsverträglich	positive
wirtschaftsverträglich	positive
sozialverträglich	positive
naturverträglich	positive
abzugsfähig	positive
gerissen	positive
geistreich	positive
weise	positive
pfiffig	positive
gescheit	positive
problemlos	positive
problemfrei	positive
spöttisch	negative
spitzfindig	negative
altadlig	positive
altadelig	positive
lauschig	positive
neunmalklug	negative
schnoddrig	negative
inakzeptabel	negative
unakzeptabel	negative
ungünstig	negative
dienlich	positive
passabel	positive
magenverträglich	positive
hautverträglich	positive
offenbar	positive
zwanzigprozentig	negative
dreissigprozentig	negative
zehnprozentig	negative
achtzigprozentig	negative
vielgeliebt	positive
gesetzt	positive
verwickelt	negative
familienfreundlich	positive
kinderfeindlich	negative
ausländerfreundlich	positive
mühevoll	positive
stressig	positive
anstrengend	positive
prunkvoll	positive
pompös	positive
malerisch	positive
sinnlos	negative
unsinnig	negative
ergebnislos	negative
zwecklos	negative
ritterlich	positive
schmierig	negative
entbehrungsreich	positive
unerträglich	negative
technikfreundlich	positive
schädlich	negative
sonnig	positive
schädigend	negative
abträglich	negative
unehrenhaft	negative
judenfeindlich	negative
antisemitisch	negative
ehrlos	negative
schweisstreibend	positive
druckfähig	positive
friedfertig	positive
barsch	negative
unziemlich	negative
untrüglich	positive
unzweifelhaft	positive
astrein	positive
knorke	positive
dufte	positive
prunkhaft	positive
glücklos	negative
chancenlos	negative
unnützlich	negative
erfolglos	negative
trinkbar	positive
bescheiden	negative
anrüchig	negative
scheiss	negative
beschissen	negative
weich	negative
gefährdend	negative
gewagt	negative
zweifellos	positive
maliziös	negative
boshaft	negative
hämisch	negative
süffisant	negative
griesgrämig	negative
lehrerhaft	negative
muffelig	negative
miesepetrig	negative
grottenschlecht	negative
definit	positive
einschätzbar	positive
berechenbar	positive
voraussagbar	positive
super	positive
top	positive
erfindungsreich	positive
erfolgsverwöhnt	positive
erfolgsgewöhnt	positive
siegreich	positive
fündig	positive
ätzend	negative
mistig	negative
beknackt	negative
oll	negative
widrig	negative
wahr	positive
mischbar	positive
freiherrlich	positive
ungeschützt	negative
geschützt	positive
ungesichert	negative
satanisch	negative
dämonisch	negative
diabolisch	negative
teuflisch	negative
hasserfüllt	negative
stiefmütterlich	negative
umweltfreundlich	positive
zweifelsfrei	positive
böswillig	negative
kaiserlich-königlich	positive
börsenfähig	positive
siebengescheit	negative
philanthropisch	positive
humanitär	positive
unbillig	negative
unbezweifelbar	positive
mündelsicher	positive
vielgerühmt	positive
viel gerühmt	positive
handlich	positive
förderungswürdig	positive
verlockend	positive
verheissungsvoll	positive
bestimmt	positive
frei	positive
phantasiereich	positive
fantasiereich	positive
stilecht	positive
wahrhaftig	positive
originalgetreu	positive
unverfälscht	positive
verantwortbar	positive
mürbe	negative
morsch	negative
mürb	negative
demoralisierend	negative
entmutigend	negative
bedauerlich	negative
schade	negative
unerquicklich	negative
bedauernswert	negative
hundertprozentig	positive
hinderlich	negative
schnöde	negative
zerstörerisch	negative
destruktiv	negative
mühelos	negative
durchsichtig	positive
bedenklich	negative
beunruhigend	negative
alptraumhaft	negative
alptraumartig	negative
unheimlich	negative
alarmierend	negative
ungeheuer	negative
schauderhaft	negative
schaudervoll	negative
hochseetüchtig	positive
furchteinflössend	negative
infernal	negative
mephistophelisch	negative
luziferisch	negative
gebrauchsfertig	positive
begünstigend	positive
mildernd	positive
begründbar	positive
baureif	positive
übermütig	positive
naturgemäss	positive
sachgemäss	positive
sachgerecht	positive
inkonsequent	negative
festkochend	positive
schöngeistig	positive
witzig	positive
niederschmetternd	negative
rau	negative
kleinkriminell	negative
messbar	positive
diesig-kalt	positive
geisterhaft	negative
gespenstig	negative
grauenerregend	negative
grauen erregend	negative
gruselig	negative
schaurig	negative
schauerhaft	negative
schauerlich	negative
gespensterhaft	negative
gespenstisch	negative
apokryph	negative
nennbar	positive
trittsicher	positive
kulinarisch	positive
benennbar	positive
staatsbürgerlich	negative
musterhaft	positive
schamlos	negative
obszön	negative
vulgär	negative
ordinär	negative
zutreffend	positive
unstimmig	negative
zukunftsweisend	positive
zukunftweisend	positive
wegweisend	positive
zukunftsträchtig	positive
moderat	positive
konform	positive
übereinstimmend	positive
deutbar	positive
verarbeitbar	positive
winterlich	positive
herbstlich	positive
unsportlich	negative
unbrauchbar	negative
abrufbar	positive
zugreifbar	positive
erschliessbar	positive
abbaubar	positive
angsterregend	negative
angst erregend	negative
unnütz	negative
ungeschrieben	positive
allbekannt	positive
eindeutig	positive
brenzlig	negative
scharf	positive
druckfertig	positive
gutbürgerlich	negative
kleinbürgerlich	negative
spiessig	negative
spiesserhaft	negative
spiesserisch	negative
geweckt	positive
zugeknöpft	positive
stocksteif	positive
unbefleckt	positive
unaussprechlich	negative
stark	positive
standesgemäss	positive
statthaft	positive
nachahmenswert	positive
hoffähig	positive
empfehlenswert	positive
ratsam	positive
gemässigt	positive
massvoll	positive
ausgewogen	positive
umsichtig	positive
alltagstauglich	positive
praxistauglich	positive
flugtauglich	positive
ausschweifend	negative
kriegstauglich	positive
diensttauglich	positive
fahrtauglich	positive
erweiterbar	positive
ausbaufähig	positive
erneuerbar	positive
renovierbar	positive
instandsetzbar	positive
verwertbar	positive
bitter	negative
kuschlig	positive
kuschelig	positive
hell	positive
widerlich	negative
widerwärtig	negative
furcht erregend	negative
furchterregend	negative
räuberisch	negative
voreingenommen	negative
subjektiv	negative
sympathisch	positive
strafbar	negative
betrügerisch	negative
ungewiss	negative
produktiv	positive
zeitgerecht	positive
offen	positive
umweltgerecht	positive
grobkörnig	negative
warmherzig	negative
plump	negative
heftig	positive
furios	positive
ernsthaft	negative
einvernehmlich	positive
differenziert	positive
begründet	positive
gütlich	positive
vorgeschoben	negative
fadenscheinig	negative
dicht	positive
unstabil	negative
unverdaulich	negative
fraglich	negative
zweifelhaft	negative
angreifbar	negative
anfechtbar	negative
umstritten	negative
strittig	negative
bruchfest	positive
abbauwürdig	positive
straffällig	negative
delinquent	negative
mitschuldig	negative
bestimmungsgemäss	positive
befehlsgemäss	positive
bärenstark	positive
sinngetreu	positive
majestätisch	positive
erhaben	positive
duktil	negative
feuchtfröhlich	positive
konkordant	positive
seetüchtig	positive
sündig	negative
sündhaft	negative
sportlich	positive
gerechtfertigt	positive
berechtigt	positive
befugt	positive
robust	positive
mannschaftstauglich	positive
halbfertig	positive
sachfremd	negative
dissozial	negative
militant	negative
tätlich	negative
entwicklungsgemäss	positive
fahrbereit	positive
normgemäss	positive
glänzend	positive
paarungswillig	positive
gesund	positive
brutal	negative
integrierend	positive
tragbar	positive
marktschreierisch	negative
unredlich	negative
geringschätzig	negative
zäh	negative
illegitim	negative
unrechtmässig	negative
drollig	positive
lächerlich	negative
scherzhaft	positive
spasshaft	positive
spassig	positive
steuergünstig	positive
krass	positive
wasserfest	positive
grausam	negative
barbarisch	negative
erbarmungslos	negative
mitleidslos	negative
gnadenlos	negative
schonungslos	negative
rüde	negative
wankelmütig	negative
stumpf	negative
abgeschlagen	negative
dahergelaufen	negative
toxisch	negative
spitz	negative
lethargisch	negative
zweifelnd	negative
haltbar	positive
humorlos	negative
behindertengerecht	positive
fachgerecht	positive
umweltschädigend	negative
wehrfähig	positive
irritierend	negative
geschäftsschädigend	negative
parteischädigend	negative
unheilvoll	negative
unheilschwanger	negative
unheil verheissend	negative
unheilverheissend	negative
besorgniserregend	negative
trübe	negative
kannibalisch	negative
familiengerecht	positive
fahrtüchtig	positive
poplig	negative
popelig	negative
euphorisch	positive
überschäumend	positive
überbordend	positive
unbeschwert	positive
100%ig	positive
definierbar	positive
100-prozentig	positive
satzungsgemäss	positive
erklärt	positive
markig	positive
wachstumsfördernd	positive
korrekt	positive
verwirrend	negative
lebensfeindlich	negative
warm	negative
frohgemut	positive
unproduktiv	negative
schuldhaft	negative
feuerfest	positive
schreiend	positive
sperrig	negative
unpraktisch	negative
wertlos	negative
oberlehrerhaft	negative
mildtätig	positive
charaktervoll	positive
caritativ	positive
karitativ	positive
fassungslos	negative
hitzestabil	positive
formstabil	positive
thermostabil	positive
dehnbar	negative
unbehindert	positive
betretbar	positive
ungehindert	positive
passierbar	positive
begehbar	positive
befahrbar	positive
gewaltbereit	positive
leistungsfördernd	positive
raffiniert	positive
ausgebufft	positive
rabiat	negative
leuchtend	positive
wahrheitsgetreu	positive
unkultiviert	negative
missfällig	negative
ehrbar	positive
manierlich	positive
informell	negative
biegsam	negative
rhythmisch	negative
ungelegen	negative
deplaziert	negative
deplatziert	negative
unverdient	negative
beschreibbar	positive
marktreif	positive
druckreif	positive
menschenverachtend	negative
martialisch	negative
brachial	negative
handgreiflich	negative
blutrünstig	negative
entgeistert	negative
unprätentiös	positive
wortgemäss	positive
wortlautgemäss	positive
fachgemäss	positive
zweckgemäss	positive
entsetzt	negative
ziemlich	positive
wählbar	positive
feinschmeckerisch	positive
unbekümmert	positive
dynamisch	negative
ehrenwert	positive
hehr	positive
achtbar	positive
verehrungswürdig	positive
ruhmvoll	positive
glorreich	positive
nachvollziehbar	positive
delikat	negative
hinreissend	positive
entzückend	positive
bezückend	positive
waschecht	positive
statutengemäss	positive
fälschungssicher	positive
soft	negative
kopiergeschützt	positive
unerreichbar	positive
registriert	positive
doll	positive
gelähmt	negative
paralysiert	negative
verpflichtend	positive
bindend	positive
zuverlässig	positive
feingeistig	positive
energisch	positive
energiegeladen	positive
einsehbar	positive
überprüfbar	positive
vaterlandslos	negative
feil	positive
lückenlos	positive
abgerissen	negative
gammelig	negative
lumpig	negative
verzerrungsfrei	positive
absolut	positive
vorwurfsvoll	negative
witterungsbeständig	positive
nasskalt	positive
distinguiert	positive
abgeklärt	positive
grossbürgerlich	negative
würdig	positive
würdevoll	positive
honorabel	positive
honett	positive
verdriesslich	negative
spielfreudig	negative
giftig	negative
findig	positive
experimentierfreudig	positive
unternehmungslustig	positive
launig	positive
gut aufgelegt	positive
initiativ	positive
gutgelaunt	positive
gut gelaunt	positive
befestigt	positive
wehrhaft	positive
unverrichtet	negative
unzerstörbar	positive
exoterisch	positive
verhärtet	negative
vergrätzt	negative
vergrämt	negative
verkehrssicher	positive
verkehrstauglich	positive
unhandlich	negative
allein	negative
ruhmreich	positive
löblich	positive
lobenswert	positive
rühmlich	positive
unrühmlich	negative
billig	positive
sympathie erweckend	positive
sympathieerweckend	positive
unbewacht	positive
väterlich	positive
mütterlich	positive
verkaufsfördernd	positive
nervtötend	negative
strapazierfähig	positive
viskos	negative
gedankenvoll	negative
werkgetreu	positive
abhörsicher	positive
cäsarisch	positive
ungefärbt	positive
flott	positive
strähnig	negative
ölig	negative
fettig	negative
konstruktiv	positive
behilflich	positive
beispielgebend	positive
froh gelaunt	positive
frohgelaunt	positive
schrecken erregend	negative
schreckenerregend	negative
spukhaft	negative
minderwertig	negative
fürchterlich	negative
furchtbar	negative
umweltschädlich	negative
beschämt	negative
unschicklich	negative
unseriös	negative
flugbereit	positive
komplett	positive
vollzählig	positive
verstrichen	negative
gesundheitsabträglich	negative
unverkrampft	negative
gelackmeiert	negative
staatsgefährdend	negative
danebengegangen	negative
viel gelobt	positive
vielgelobt	positive
fehlgeschlagen	negative
untröstlich	negative
begossen	negative
ausgesucht	positive
erlaucht	positive
eisig	positive
salomonisch	positive
eisigkalt	positive
eiskalt	positive
panisch	negative
panikartig	negative
entsagungsvoll	positive
total	positive
restlos	positive
ganzheitlich	positive
integral	positive
unteilbar	negative
völlig	positive
gänzlich	positive
bereinigt	positive
salopp	negative
verspielt	negative
spielerisch	negative
himmelschreiend	negative
unerprobt	negative
zerlumpt	negative
startbereit	positive
krisenerfahren	positive
unbewährt	negative
kampferprobt	positive
krisenerprobt	positive
tollwütig	positive
allgemeinverbindlich	positive
allgemein verbindlich	positive
übrig	positive
vereinsamt	negative
verlassen	negative
bindig	negative
schöpferisch	positive
verzagt	positive
zauderhaft	positive
phantasievoll	positive
fantasievoll	positive
katastrophal	negative
verheerend	negative
frigide	positive
frigid	positive
startklar	positive
startfertig	positive
bereit	positive
beziehbar	positive
schlüsselfertig	positive
bezugsfertig	positive
spottbillig	positive
bedröppelt	negative
allegretto	positive
unorthodox	negative
langsam	negative
unintelligent	negative
stachelig	negative
stachlig	negative
abstinent	positive
entsagend	positive
wassergefährdend	negative
wohlfeil	positive
erschwinglich	positive
verfänglich	negative
antiphlogistisch	positive
urtümlich	positive
aufgebraucht	negative
auserlesen	positive
ausersehen	positive
schwankend	negative
unentschlossen	negative
unschlüssig	negative
irregeleitet	negative
verunsichert	negative
irritiert	negative
zaghaft	negative
wehrdienstfähig	positive
wehrtauglich	positive
aufgeweckt	positive
gewinnbar	positive
trüb	negative
grazil	positive
benutzbar	positive
unbestimmt	negative
determiniert	positive
schicksalhaft	positive
karmisch	positive
sinngemäss	positive
aufrührerisch	positive
aufwieglerisch	positive
zotig	negative
aktionistisch	positive
unzivilisiert	negative
spiessbürgerlich	negative
kostengünstig	positive
vorteilhaft	positive
bedienbar	positive
gebührend	positive
phlegmatisch	negative
ungeteilt	positive
unzerteilt	positive
wohlbehütet	positive
geländetauglich	positive
finit	positive
entzündungshemmend	positive
umschrieben	positive
artig	positive
abfällig	negative
abschätzig	negative
altbewährt	positive
traditionsreich	positive
ausgereift	positive
asozial	negative
erfasst	positive
eingetragen	positive
eingeschrieben	positive
ausgewiesen	positive
gemeinfrei	positive
reichverziert	positive
reich verziert	positive
rufschädigend	negative
antibiotisch	positive
wohlerzogen	positive
hochgelobt	positive
hoch gelobt	positive
viel gepriesen	positive
vielgepriesen	positive
kreativ	positive
erfinderisch	positive
gammlig	negative
leichtfüssig	positive
bereitstehend	positive
preisgünstig	positive
preiswert	positive
finanzierbar	positive
bezahlbar	positive
gesundheitsschädlich	negative
gesundheitsschädigend	negative
honorig	positive
abgewrackt	negative
windgeschützt	positive
auswertbar	positive
ungeniessbar	negative
unbekömmlich	negative
wahrheitsgemäss	positive
praktikabel	positive
aufnahmefähig	positive
kongenial	positive
gewitzt	positive
gewieft	positive
unkontrollierbar	negative
kampfbereit	positive
eloquent	positive
beredsam	positive
wortgewandt	positive
wortgewaltig	positive
wortreich	positive
erpresserisch	negative
festgefügt	positive
wohlproportioniert	positive
beleidigend	negative
ausfallend	negative
sarkastisch	negative
ironisch	negative
unzuständig	negative
unzerbrechlich	positive
unbrennbar	positive
fidel	positive
cool	negative
enthaltsam	positive
untauglich	negative
empörend	negative
keusch	positive
lebensuntüchtig	negative
plebejisch	negative
konjunkturverträglich	positive
pflanzenverträglich	positive
klimaverträglich	positive
landschaftsverträglich	positive
kampferfahren	positive
richtiggehend	positive
regelrecht	positive
praxisgerecht	positive
einsatzbereit	positive
dienstbereit	positive
erweiterungsfähig	positive
jugendgefährdend	negative
abriebfest	positive
ungeschönt	positive
angebbar	positive
marktgerecht	positive
unannehmbar	negative
unvertretbar	negative
unterstützend	positive
subsidiär	positive
rechtsverbindlich	positive
mannschaftsdienlich	positive
ungeklärt	negative
wolkig	negative
sommerlich-sonnig	positive
bewölkt	negative
involviert	negative
kinderfreundlich	positive
internetfähig	positive
netzwerkfähig	positive
leidig	negative
lichtbeständig	positive
speicherbar	positive
unblutig	positive
amateurhaft	negative
absurd	negative
abstrus	negative
morastig	negative
unbesiegt	positive
entscheidbar	positive
eklig	negative
unzumutbar	negative
arg	negative
frostig	positive
kontraproduktiv	negative
wohltätig	positive
tragfähig	positive
streichfähig	negative
anbaufähig	positive
ungekürzt	positive
paarungsbereit	positive
schiefgelaufen	negative
undurchlässig	positive
exemplarisch	positive
schiefgegangen	negative
arbeitsunwillig	negative
zögerlich	positive
rüd	negative
planbar	positive
kontrovers	negative
traumatisierend	negative
vernichtend	negative
gesundheitsgefährdend	negative
friedensgefährdend	negative
sicherheitsgefährdend	negative
transusig	negative
tranig	negative
träge	negative
träg	negative
trocken-kalt	positive
zweitbeste	positive
zünftig	positive
anoxisch	negative
ungeschlagen	positive
genusssüchtig	negative
wahrhaft	positive
aufladbar	positive
bestreitbar	negative
schlammig	negative
dickflüssig	negative
vorbestraft	negative
denkmalgeschützt	positive
abgeschirmt	positive
umweltschonend	positive
situationsgerecht	positive
betriebsbereit	positive
gefeit	positive
flagrant	positive
bildungsbürgerlich	negative
unsanft	negative
freiwillig	positive
unbefangen	positive
viertklassig	negative
instabil	negative
selbständig	positive
selbstständig	positive
störend	negative
selbstzerstörerisch	negative
selbstschädigend	negative
bodenlos	negative
makaber	negative
aquarellfarben	positive
weiss	positive
janusköpfig	negative
unpassierbar	negative
löslich	positive
unglückselig	negative
bemitleidenswert	negative
beklagenswert	negative
gasdicht	positive
selbstsicher	positive
strafmildernd	positive
strafsenkend	positive
gasgekühlt	positive
allfällig	negative
zwanglos	positive
unabhängig	positive
leichtfertig	negative
zitierbar	positive
unwirtlich	negative
kleinkariert	negative
beredt	positive
flugunfähig	negative
klar	positive
dunstig	negative
flugfähig	positive
nebligtrüb	negative
läppisch	negative
nichtig	negative
schmackhaft	negative
wiederverwertbar	positive
übersehbar	positive
visumfrei	positive
üppig	positive
rüstig	positive
befangen	negative
undurchsichtig	negative
verheilt	positive
etwaig	negative
überschwänglich	positive
verfassungstreu	positive
verfassungsgemäss	positive
staatskonform	positive
verfassungskonform	positive
wacklig	negative
kalifornisch	negative
föhnig	negative
müssig	negative
überflüssig	negative
unvorhersehbar	negative
unzweideutig	positive
unvorstellbar	negative
gefestigt	positive
stechend	positive
beissend	positive
diesig	negative
niedrig	negative
bieder	negative
hausbacken	negative
unruhig	positive
freiheitlich	positive
allerlei	positive
viele	positive
undefiniert	negative
gesucht	positive
rauhaarig	negative
leberschädigend	negative
verkrampft	positive
nervenschädlich	negative
rechtmässig	positive
avantgardistisch	positive
montierbar	positive
relativ	negative
durchtrainiert	positive
schwungvoll	positive
schliessbar	positive
durchlässig	negative
marode	negative
baufällig	negative
marod	negative
verrostet	negative
rostig	negative
wackelig	negative
verwittert	negative
exzessiv	negative
zweckentsprechend	positive
schmalzig	negative
zartbitter	negative
lizenzkonform	positive
bravourös	positive
grell	positive
scheusslich	negative
abscheulich	negative
verabscheuungswürdig	negative
tendenziös	negative
parteiisch	negative
unverschuldet	positive
nervenschädigend	negative
nieder	negative
klimaschädigend	negative
masslos	positive
schwach	negative
mitreissend	positive
vehement	positive
unterlegt	positive
fundiert	positive
handfest	positive
stichhaltig	positive
desolat	negative
wasserdicht	positive
luft- und wasserdicht	positive
hermetisch	positive
undicht	negative
lichtstark	positive
mutterlos	negative
mietfrei	positive
abgewirtschaftet	negative
abgegriffen	negative
heruntergewirtschaftet	negative
wohl temperiert	positive
wohltemperiert	positive
beleuchtet	positive
erleuchtet	positive
bestechlich	negative
korrupt	negative
käuflich	negative
loh	positive
hirnrissig	negative
kopfballstark	positive
winkeltreu	positive
muskelbepackt	positive
hold	positive
komisch	positive
gewaltsam	positive
eklatant	positive
unvermindert	positive
gewaltig	positive
offen geblieben	positive
offengeblieben	positive
trainiert	positive
konditionsstark	positive
fit	positive
athletisch	positive
sportiv	positive
kühl	positive
legitim	positive
obskur	negative
zerteilt	negative
kältebeständig	positive
hitzebeständig	positive
wetterfest	positive
kochfest	positive
streitig	negative
unbelegt	positive
gemeinschaftsschädigend	negative
gesellschaftsunfähig	negative
schimmernd	positive
changierend	positive
schillernd	positive
goldglänzend	positive
grellfarbig	positive
grellfarben	positive
geneigt	positive
mörderisch	positive
höllisch	positive
intensiv	positive
hochgradig	positive
verstärkt	positive
direkt	positive
kerngesund	positive
aufgeschlossen	positive
empfänglich	positive
extravertiert	positive
offenherzig	positive
gangbar	positive
hochglänzend	positive
rechtgläubig	positive
kraftvoll	positive
kräftig	positive
widerstandsfähig	positive
geöffnet	positive
geschlossen	negative
roh	negative
lachhaft	positive
urkomisch	positive
saukomisch	positive
tragikomisch	positive
blind	negative
gewichtig	positive
gravierend	positive
launenhaft	negative
kapriziös	negative
regenerativ	positive
sprunghaft	negative
unausgeglichen	negative
beschaulich	positive
blank	positive
drangvoll	negative
ulkig	positive
eiternd	negative
verfassungswidrig	negative
eitrig	negative
vereitert	negative
aerodynamisch	negative
gesetzwidrig	negative
rechtswidrig	negative
ungeschliffen	negative
kriegsmüde	negative
klimaschädlich	negative
zweiflerisch	negative
entlegen	negative
massgeschneidert	positive
unhaltbar	negative
untragbar	negative
durchscheinend	positive
abenteuerlustig	positive
heiss	negative
lauwarm	negative
unheilig	negative
unselig	negative
schwer wiegend	positive
schwerwiegend	positive
ungezügelt	negative
widerrechtlich	negative
erledigt	negative
halboffen	positive
manövrierunfähig	negative
gewogen	positive
diebisch	negative
aufgeräumt	positive
unverblümt	positive
freimütig	positive
massstäblich	positive
unbezähmbar	positive
preussisch	positive
gewissenhaft	positive
pünktlich	positive
verschwiegen	positive
preiswürdig	positive
nierenschädlich	negative
nierenschädigend	negative
gebrauchsfähig	positive
erstrangig	positive
messerscharf	positive
wassergekühlt	positive
einstellbar	positive
nachprüfbar	positive
mordsmässig	positive
frevlerisch	negative
urig	positive
serienreif	positive
unfähig	negative
erheblich	positive
pedantisch	positive
penibel	positive
förmlich	positive
achtsam	positive
sorgsam	positive
sorgfältig	positive
ordnungsliebend	positive
gesperrt	negative
wolkenbruchartig	negative
weisungsbefugt	positive
gebührenlos	positive
gebührenfrei	positive
wahlberechtigt	positive
erziehungsberechtigt	positive
zweitklassig	negative
mancherlei	positive
traumatisch	negative
krude	negative
krud	negative
flaumig	negative
vertrauensvoll	positive
massstabsgerecht	positive
unwägbar	negative
hochrein	positive
vielerlei	positive
unzuverlässig	negative
verschorft	negative
entzündet	negative
blessiert	negative
überstark	positive
bestialisch	negative
offengelassen	positive
offen gelassen	positive
wund	negative
ergebnisoffen	negative
wirklichkeitsgetreu	positive
lästerlich	negative
gehörig	positive
lecker	negative
russisch-orthodox	positive
christlich-orthodox	positive
griechisch-orthodox	positive
unverantwortbar	negative
übrig geblieben	positive
übriggeblieben	positive
restlich	positive
kitschig	positive
mundgerecht	positive
farbecht	positive
vorrätig	positive
lädiert	negative
dick	negative
schalldicht	positive
ungeniert	positive
luftundurchlässig	positive
undifferenziert	negative
lichtundurchlässig	positive
launisch	negative
aktenkundig	positive
rennend	positive
zusammen	positive
verlässlich	positive
grauenvoll	negative
grauenhaft	negative
grausig	negative
verhängnisvoll	negative
nachmessbar	positive
beitragsfrei	positive
scharfkantig	positive
umweltbelastend	negative
matschig	negative
absolutistisch	positive
lichtdurchflutet	positive
fahrstuhlgerecht	positive
ruinös	negative
erbärmlich	negative
mild	negative
sanft	positive
temperaturbeständig	positive
zeremoniell	positive
bekannt	positive
souverän	positive
unumschränkt	positive
machtvoll	positive
einzig	negative
alleinig	negative
amüsant	positive
vergnüglich	positive
schalkhaft	positive
possenhaft	positive
albern	positive
schelmisch	positive
unbesetzt	positive
nasskühl	positive
hochgiftig	negative
sonnenbeschienen	positive
vertrauenerweckend	positive
vertrauen erweckend	positive
angeschlagen	negative
vergnügungsorientiert	positive
arbeitsscheu	negative
ungehemmt	negative
vakant	positive
schwerverletzt	negative
selbstbewusst	positive
klärungsbedürftig	negative
vereinzelt	negative
nominal	negative
einzeln	negative
treffend	positive
trefflich	positive
glanzvoll	positive
tadelnswert	negative
sträflich	negative
elendig	negative
indefinit	negative
geschworen	positive
sommerlich	negative
unbürokratisch	negative
geladen	negative
genervt	negative
disharmonisch	negative
gereizt	negative
verquer	negative
säurefest	positive
resistent	positive
quietschfidel	positive
immun	positive
geheim	negative
eigenständig	positive
durchsetzungsfähig	positive
konfliktfähig	positive
versunken	positive
kontemplativ	positive
meditativ	positive
thermodynamisch	negative
regelbar	positive
kontrollierbar	positive
nutzungsberechtigt	positive
krank	negative
massgerecht	positive
naturgetreu	positive
stimmig	positive
abgestimmt	positive
flauschig	negative
hydrodynamisch	negative
skalierbar	positive
unscharf	negative
gefangen	negative
unwürdig	negative
würdelos	negative
gestresst	negative
unverschlossen	positive
tragisch	negative
augenschädigend	negative
geringwertig	negative
elend	negative
augenschädlich	negative
rollstuhlgerecht	positive
treffsicher	positive
krankenhausreif	negative
schwerverwundet	negative
verwundet	negative
schicklich	positive
erholungsbedürftig	negative
groggy	negative
ausgepowert	negative
mitgenommen	negative
schüchtern	positive
zierlich	positive
bestimmbar	positive
veritabel	positive
winterfest	positive
unbenutzbar	negative
rosig	positive
lau	negative
unverzagt	negative
gesittet	positive
prüde	positive
vieldeutig	negative
kostenfrei	positive
unentgeltlich	positive
einschichtig	negative
getragen	negative
stockend	negative
schleppend	negative
neckisch	negative
sittsam	positive
schmiedbar	positive
weltoffen	positive
ausserstande	negative
arbeitsunfähig	negative
rezeptiv	positive
drittklassig	negative
wasserunlöslich	negative
schwanzgesteuert	positive
sexgierig	positive
sexhungrig	positive
lüstern	positive
fantasielos	negative
ehrsam	positive
kostenlos	positive
gehorsam	positive
andante	negative
eventuell	negative
unerschwinglich	negative
widersprüchlich	negative
mehrdeutig	negative
gespalten	negative
zweideutig	negative
zwiespältig	negative
ambivalent	negative
doppeldeutig	negative
reissfest	positive
zivil	positive
fatal	negative
saumässig	positive
armselig	negative
clean	positive
teuer	negative
öffentlich	positive
lichtecht	positive
heil	positive
selbstironisch	negative
bibeltreu	positive
gesundet	positive
interpretierbar	positive
wehruntauglich	negative
verkehrsuntauglich	negative
lebensunfähig	negative
geistesklar	positive
bearbeitbar	positive
genesen	positive
entfernt	negative
megascharf	positive
offenstehend	positive
offen stehend	positive
sintflutartig	negative
abgelegen	negative
sortenrein	positive
strenggläubig	positive
triftig	positive
benutzerfreundlich	positive
anwenderfreundlich	positive
intersubjektiv	negative
silbrig	positive
tiefgekühlt	positive
pastos	negative
nachteilig	negative
lichterloh	positive
trutzig	positive
desaströs	negative
zerlegbar	positive
jäh	positive
akut	positive
vordringlich	positive
handwarm	negative
zimmerwarm	negative
spekulativ	negative
wasserundurchlässig	positive
gasundurchlässig	positive
gestalterisch	positive
druckvoll	positive
brav	positive
unausgereift	negative
unausgegoren	negative
unausgewogen	negative
korrosionsbeständig	positive
abgeschieden	negative
muskulös	positive
regelkonform	positive
schiffbar	positive
isoliert	negative
solo	negative
schaltbar	positive
erbberechtigt	positive
stimmberechtigt	positive
angepasst	positive
entkräftet	negative
abgespannt	negative
notorisch	positive
lupenrein	positive
unrein	negative
koscher	positive
steril	positive
keimfrei	positive
feuchtwarm	negative
schamhaft	positive
fügsam	positive
gefügig	positive
willfährig	positive
dahinterstehend	positive
entsetzlich	negative
leberschädlich	negative
ausgelaugt	negative
wiederaufladbar	positive
scheinbar	negative
ausgebrannt	negative
erschöpft	negative
gemächlich	negative
unbefestigt	negative
publik	positive
hypothetisch	negative
extrovertiert	positive
gerichtsverwertbar	positive
alterungsbeständig	positive
eineindeutig	positive
bildnerisch	positive
handlungsunfähig	negative
recyclingfähig	positive
vermutlich	negative
derb	negative
verwaist	negative
unaufmerksam	negative
hellhörig	positive
reaktionsschnell	positive
geistesgegenwärtig	positive
wachsam	positive
urlaubsreif	negative
handhabbar	positive
breiig	negative
dubios	negative
weisungsberechtigt	positive
wohnberechtigt	positive
sorgeberechtigt	positive
anspruchsberechtigt	positive
teilnahmeberechtigt	positive
vertretungsberechtigt	positive
heimatberechtigt	positive
vollberechtigt	positive
spielberechtigt	positive
wechselwarm	positive
violent	positive
bewegungsunfähig	negative
pur	positive
blutig	negative
überhart	positive
nachrüstbar	positive
schmelzbar	positive
angezeigt	positive
wohlschmeckend	negative
köstlich	negative
zytotoxisch	negative
anerkennenswert	positive
ehrverletzend	negative
unanfechtbar	positive
datierbar	positive
aberwitzig	negative
irrwitzig	negative
elektrodynamisch	negative
regulierbar	positive
frisch	positive
massstabsgetreu	positive
schlechtgelaunt	negative
schlecht gelaunt	negative
turbulent	positive
ungestüm	positive
kompostierbar	positive
minderbemittelt	negative
minderbegabt	negative
kultiviert	positive
freizeitorientiert	positive
kontaktlos	negative
polyrhythmisch	negative
wohlbegründet	positive
unbestritten	positive
unstrittig	positive
luftdicht	positive
tolerant	positive
fahrbar	positive
umweltgefährdend	negative
klümperig	negative
klümprig	negative
grossväterlich	positive
stimmfähig	positive
konzentriert	positive
hemmungslos	negative
zölibatär	positive
säuerlich	negative
unbestätigt	negative
luftgekühlt	positive
süsslich	positive
zuckersüss	positive
unbewohnbar	negative
systemkonform	positive
ausgepumpt	negative
klumpig	negative
eingedickt	negative
schleimig	negative
geronnen	negative
sämig	negative
urwüchsig	positive
freisinnig	positive
überzählig	positive
spielend	negative
bullerig	negative
feist	negative
bullig	negative
fett	negative
fettleibig	negative
vollschlank	negative
füllig	negative
barock	negative
nörglerisch	negative
abhängig	negative
krampfhaft	positive
krampfig	positive
beklommen	negative
betreten	negative
ortsunabhängig	positive
zeitunabhängig	positive
zutraulich	positive
dienstbar	positive
labil	negative
verloren	negative
gefährdet	negative
andantino	negative
ordentlich	positive
überschaubar	positive
übersichtlich	positive
heillos	negative
kopflos	negative
uferlos	negative
darstellerisch	positive
beziehungsunfähig	negative
weisslich	positive
gedämpft	negative
kabarettistisch	positive
verschwommen	negative
krampfartig	positive
intolerant	negative
dünn	positive
armdick	negative
autark	positive
bereitwillig	positive
unaufgefordert	positive
willig	positive
parteiunabhängig	positive
adipös	negative
untalentiert	negative
suchtgefährdet	negative
unfallgefährdet	negative
verführbar	negative
rückfällig	negative
tropisch	negative
bedeutsam	positive
bedeutungsvoll	positive
haftunfähig	negative
neblig	negative
altpreussisch	positive
einträchtig	positive
zusammengeschlossen	positive
solidarisch	positive
erreichbar	negative
abschlägig	negative
zittrig	negative
regenerationsfähig	positive
gehfähig	positive
erbkrank	negative
belastungsfähig	positive
breit	negative
dickwanstig	negative
dickbäuchig	negative
vollbusig	positive
prall	positive
unfrei	negative
zwanghaft	negative
unversehrt	positive
liberal	positive
unverletzt	positive
wägbar	positive
grüblerisch	negative
seltsam	positive
frühlingshaft	negative
spätsommerlich	negative
undogmatisch	positive
beeinflussbar	negative
wertvoll	negative
verdruckst	positive
verschämt	positive
undenkbar	negative
aromatisch	positive
abgedroschen	positive
ablehnend	negative
abweisend	negative
zurückweisend	negative
unmässig	positive
übertrieben	positive
übereinkommend	positive
naturgegeben	positive
gehemmt	negative
verklemmt	negative
gezwungen	negative
verkniffen	positive
oberflächlich	negative
lebendig	positive
gestorben	negative
verstorben	negative
verschieden	negative
verhältnismässig	negative
durchstimmbar	positive
leck	negative
löchrig	negative
bürokratisch	positive
ererbt	positive
angestammt	positive
unverlangt	positive
duster	negative
düster	negative
wohlverdient	positive
linkslastig	negative
reissend	positive
unumstösslich	positive
schutzwürdig	positive
rangnieder	negative
weinerlich	negative
protzig	positive
unbändig	positive
unauffallend	negative
unauffällig	negative
ozonschädigend	negative
verdrossen	negative
mürrisch	negative
gotteslästerlich	negative
schummerig	negative
unbeleuchtet	negative
mehrschichtig	negative
mächtig	positive
amtlich	positive
kurios	positive
fingerdick	negative
unversteckt	positive
unumwunden	positive
impulsiv	positive
unverdeckt	positive
unverhohlen	positive
denunziatorisch	negative
kahl	negative
zeichnerisch	positive
fern	negative
unterkühlt	positive
zustehend	positive
aufgeteilt	negative
schnellfüssig	positive
altersschwach	negative
unfreiwillig	negative
hochwürdig	positive
restringiert	negative
morbide	negative
zart	negative
fluchtartig	positive
fraktioniert	negative
weitschweifig	negative
nichtoffiziell	positive
nicht offiziell	positive
tiefgreifend	positive
gründlich	positive
tiefgehend	positive
tiefschürfend	positive
belastbar	positive
unverwüstlich	positive
vital	positive
verschlossen	negative
flach	positive
abgrundtief	negative
verwunderlich	negative
wunderlich	negative
todkrank	negative
lahm	negative
blitzeblank	positive
blitzblank	positive
blankgeputzt	positive
rauchschwach	negative
willensschwach	negative
federführend	positive
mattweiss	positive
überzeugend	positive
glaubwürdig	positive
vertrauensfördernd	positive
vertrauensbildend	positive
auffallend	positive
betont	positive
grimm	negative
schikanös	negative
tiefreichend	positive
misstrauisch	negative
argwöhnisch	negative
arbeitsteilig	negative
hochgespannt	positive
kindgerecht	positive
auffällig	positive
phantasielos	negative
krüppelhaft	negative
krüppelig	negative
vorhanden	positive
flügge	positive
schuldunfähig	negative
leichtsinnig	negative
geradlinig	positive
gradlinig	positive
kindgemäss	positive
kristallklar	positive
privat	negative
staatlich	positive
beruflich	positive
suizidgefährdet	negative
unselbstständig	negative
unselbständig	negative
nervenschwach	negative
muskelschwach	negative
geistesabwesend	negative
psychotisch	negative
umständlich	negative
bedeckt	negative
introvertiert	negative
unzugänglich	negative
bauchig	negative
wasserdurchlässig	negative
leistungsstark	positive
konspirativ	negative
verschwörerisch	negative
wasserklar	positive
stillschweigend	negative
unausgesprochen	negative
reinlich	positive
kreideweiss	positive
solitär	negative
wolkenfrei	positive
angestrengt	negative
versperrt	negative
schnellwüchsig	positive
lebhaft	positive
verblichen	negative
distal	negative
schneidig	positive
altbekannt	positive
vielsagend	positive
gutgläubig	positive
blauäugig	positive
leichtgläubig	positive
unbedarft	positive
treuherzig	positive
naiv	positive
offiziell	positive
methodisch	positive
unpünktlich	negative
säumig	negative
nachlässig	negative
multitaskingfähig	positive
charakterschwach	negative
pfeilschnell	positive
allein stehend	negative
alleinstehend	negative
bleich	negative
blass	negative
blasphemisch	negative
hochverdient	positive
zerkleinert	negative
unverzeihlich	negative
unentschuldbar	negative
verantwortungslos	negative
unverantwortlich	negative
gemeinschaftlich	positive
gesamt	positive
kooperativ	positive
kollektiv	positive
gemeinsam	positive
scharenweise	positive
vereinigt	positive
vereint	positive
diabetisch	negative
bärbeissig	negative
feierlich	positive
redebegabt	positive
superschnell	positive
ungeheissen	positive
künstlerisch	positive
untrainiert	negative
kraftlos	negative
unerheblich	negative
mickerig	negative
übergewichtig	negative
schwergewichtig	negative
wohlbeleibt	negative
wohl beleibt	negative
aufgeschrieben	positive
dokumentiert	positive
bekanntlich	positive
festgehalten	positive
betreffend	positive
gewienert	positive
unzertrennbar	negative
unzertrennlich	negative
verschmitzt	positive
lausbubenhaft	positive
lausbübisch	positive
bildhauerisch	positive
galoppierend	positive
tänzerisch	positive
chronisch	negative
schnell	positive
immunschwach	negative
entscheidungsschwach	negative
wundersam	negative
okkult	negative
kompakt	negative
ruchlos	negative
kümmerlich	negative
semipermeabel	negative
kontaktierbar	negative
quick	positive
kostspielig	negative
berufsmässig	positive
missgestimmt	negative
misslaunig	negative
missgelaunt	negative
verstimmt	negative
knatschig	negative
quengelig	negative
verkündet	positive
geoutet	positive
publiziert	positive
bekanntgegeben	positive
festlich	positive
veröffentlicht	positive
freistehend	negative
einzelstehend	negative
exklusiv	negative
ausschliesslich	negative
emanzipiert	positive
folgsam	positive
naturbedingt	positive
ungehorsam	negative
besetzt	negative
belegt	negative
unkonventionell	positive
nölig	negative
nörgelig	negative
intim	negative
vertraulich	negative
verdeckt	negative
heimlich	negative
mysteriös	negative
kryptisch	negative
kränklich	negative
tabu	negative
winterhart	positive
durchschlagskräftig	positive
ungefragt	positive
konzertiert	positive
hochsommerlich	negative
nachdrücklich	positive
eindringlich	positive
einhellig	positive
zickig	negative
kiebig	negative
hinfällig	negative
anfällig	negative
blutverschmiert	negative
notiert	positive
nichtöffentlich	negative
nicht öffentlich	negative
geheimgehalten	negative
schlagkräftig	positive
streitbar	positive
lenkbar	positive
verschliessbar	positive
sehschwach	negative
artgemäss	positive
kindgetreu	positive
artgerecht	positive
gemafrei	positive
alkoholkrank	negative
regierungsfähig	positive
flächentreu	positive
unachtsam	negative
eilig	positive
hastig	positive
rapide	positive
rapid	positive
zügig	positive
kometenhaft	positive
bewohnbar	positive
luftdurchlässig	negative
unverdrossen	negative
redegewandt	positive
übelgelaunt	negative
übel gelaunt	negative
memmenhaft	negative
schlapp	negative
schwächlich	negative
schlaff	negative
gebrechlich	negative
jämmerlich	negative
kostenintensiv	negative
nachdenklich	negative
kränkelnd	negative
vorhersehbar	positive
vorstellbar	positive
anpassbar	positive
nierenkrank	negative
kalkweiss	positive
perlweiss	positive
grellweiss	positive
ungeheuerlich	negative
explosionsartig	positive
flink	positive
selbstmordgefährdet	negative
nahtlos	positive
verzögerungslos	positive
blitzschnell	positive
berufsunfähig	negative
rasant	positive
botmässig	positive
handlungsfähig	positive
magersüchtig	negative
heiser	negative
aidskrank	negative
lungenkrank	negative
krebskrank	negative
herzkrank	negative
zuckerkrank	negative
gallenkrank	negative
drüsenkrank	negative
magenkrank	negative
autokratisch	positive
widersinnig	negative
paradox	negative
blickdicht	negative
ausgesprochen	positive
hurtig	positive
reflexhaft	positive
salonfähig	positive
fähig	positive
burlesk	positive
ausgeglichen	positive
imstande	positive
beschlussfähig	positive
mehrheitsfähig	positive
wandlungsfähig	positive
anpassungsfähig	positive
einsatzfähig	positive
arbeitsfähig	positive
schlüpfrig	negative
unwegsam	negative
öllöslich	positive
alkohollöslich	positive
fettlöslich	positive
schwerlöslich	positive
schwer löslich	positive
wasserlöslich	positive
portofrei	positive
tuberkulös	negative
pantomimisch	positive
farbschwach	negative
lichtschwach	negative
adagio	negative
largo	negative
unbezahlbar	negative
halbseiden	negative
zwielichtig	negative
leistungsfähig	positive
biedermeierlich	negative
fremdbestimmt	negative
unbegabt	negative
unstreitig	positive
konditionsschwach	negative
steuerbar	positive
kostbar	negative
ozonschädlich	negative
verdient	positive
verdienstvoll	positive
lebensfähig	positive
singulär	negative
wattiert	negative
dicklagig	negative
eigen	negative
karg	negative
deftig	negative
zuständig	positive
habituell	positive
blütenweiss	positive
geschwind	positive
verpanscht	negative
leberkrank	negative
schwerkrank	negative
niederrangig	negative
sehnig	positive
drahtig	positive
abschliessbar	positive
altehrwürdig	positive
ehrwürdig	positive
erhaltenswert	positive
aufgekratzt	positive
aufgedreht	positive
wach	positive
geschnitten	negative
überseeisch	negative
zerfasert	negative
blitzartig	positive
hochpreisig	negative
lichtdurchlässig	negative
schriftstellerisch	positive
dichterisch	positive
keck	positive
schlagfertig	positive
ominös	negative
gewohnheitsmässig	positive
verschmutzt	negative
verunreinigt	negative
unhygienisch	negative
föderiert	positive
inhaftiert	negative
verhaftet	negative
gefangengenommen	negative
eingefangen	negative
gefangengehalten	negative
gekidnapt	negative
westpreussisch	positive
südpreussisch	positive
stadtbekannt	positive
finster	negative
rechtslastig	negative
adaptiv	positive
rechtsfähig	positive
schläfrig	positive
kontaminiert	negative
gepanscht	negative
verseucht	negative
lichtarm	negative
homolog	positive
angebunden	positive
ehrrührig	negative
ehrenrührig	negative
nonkonformistisch	positive
sterbenskrank	negative
cremeweiss	positive
tiefdunkel	negative
reflexartig	positive
sekundenschnell	positive
apodiktisch	positive
reinweiss	positive
gesellschaftsfähig	positive
grauweiss	positive
gelbweiss	positive
schauspielerisch	positive
silberweiss	positive
milchweiss	positive
qualvoll	negative
wolkenlos	positive
unausdenkbar	negative
anämisch	negative
milchig	negative
opak	negative
platt	positive
erkältet	negative
seicht	positive
dümmlich	positive
unkonzentriert	negative
beherrschbar	positive
festgebunden	positive
fehlbar	negative
völkerrechtswidrig	negative
stoned	positive
bekifft	positive
schneeweiss	positive
ungekocht	negative
wohlgenährt	negative
wohl genährt	negative
unzurechnungsfähig	negative
zerstreut	negative
vergesslich	negative
gedackt	negative
unpaarig	negative
arretiert	negative
eigenbrötlerisch	negative
knusprig	positive
knackig	positive
übellaunig	negative
grimmig	negative
grantig	negative
lind	negative
blödsinnig	positive
schutzfähig	positive
kampfunfähig	negative
dumpf	negative
unbestreitbar	positive
unumstritten	positive
unangefochten	positive
ungeöffnet	negative
unnahbar	negative
lilienweiss	positive
schlohweiss	positive
dortig	negative
dingfest	negative
festgefangen	negative
entführt	negative
schwülheiss	negative
interpretationsfähig	negative
haftfähig	positive
kompromissfähig	positive
missmutig	negative
rustikal	negative
hoch	positive
beleibt	negative
voluminös	negative
rundlich	negative
aufgedunsen	negative
korpulent	negative
aufgetrieben	negative
dicklich	negative
mollig	negative
verkrüppelt	negative
gestört	negative
geistesgestört	negative
schwindsüchtig	negative
festgenommen	negative
schier	positive
erwerbsunfähig	negative
dienstunfähig	negative
unleugbar	positive
schummrig	negative
halbdunkel	negative
ruiniert	positive
spielstark	positive
autokephal	positive
stämmig	negative
kampffähig	positive
fiebrig	negative
irreparabel	positive
erfolgsabhängig	negative
kontextabhängig	negative
leistungsabhängig	negative
unabänderbar	positive
insolvent	positive
naturalistisch	positive
lohnsteuerpflichtig	positive
umsatzschwach	negative
teamfähig	positive
leistungsschwach	negative
aufwändig	negative
aufwendig	negative
nebulös	negative
schwammig	negative
träumerisch	negative
umsatzsteuerpflichtig	positive
unrettbar	positive
gross	positive
verbohrt	negative
überlebensfähig	positive
unverbesserlich	negative
massig	negative
wadenhoch	positive
brusthoch	positive
schmal	positive
leichtgewichtig	positive
untergewichtig	positive
mager	positive
autonom	positive
anstellig	positive
geständig	positive
vorliegend	positive
metamorph	positive
herstellerunabhängig	positive
temperaturabhängig	negative
zeitabhängig	negative
grundverschieden	negative
verwaschen	negative
plastisch	positive
unordentlich	negative
namentlich	positive
säuberlich	positive
unübersichtlich	negative
unüberschaubar	negative
ortsabhängig	negative
lebensnah	positive
einkommensabhängig	negative
bestehend	positive
kleingeschnitten	negative
nationalliberal	positive
atmungsaktiv	negative
gottgewollt	positive
hoch dosiert	positive
hochdosiert	positive
hochkonzentriert	positive
hiesig	positive
irre	negative
irr	negative
ultrakompakt	negative
untersetzt	negative
verbissen	positive
überstaatlich	positive
teilrechtsfähig	positive
hilflos	negative
inständig	positive
altüberliefert	positive
ostpreussisch	positive
geschwollen	positive
absehbar	positive
uniert	positive
muffig	negative
beachtenswert	positive
feuchtheiss	negative
elfenbeinfarbig	positive
elfenbeinfarben	positive
erbschaftssteuerpflichtig	positive
körperschaftsteuerpflichtig	positive
körperschaftssteuerpflichtig	positive
wiedergeboren	positive
unwillig	negative
widerstrebend	negative
zähneknirschend	negative
widerwillig	negative
klischeehaft	negative
plakativ	negative
hintergründig	positive
tiefsinnig	positive
sozialliberal	positive
belebt	positive
lebensecht	positive
dogmatisch	negative
werkeigen	negative
werkseigen	negative
wahnwitzig	negative
epoche machend	positive
epochemachend	positive
gesamtstaatlich	positive
letztlich	positive
endgültig	positive
konfessionsverschieden	negative
andersgeartet	negative
abschätzbar	positive
pseudonym	negative
eingehend	positive
gehbehindert	negative
kursorisch	negative
einsturzgefährdet	negative
hochoffiziell	positive
tot	negative
weisend	positive
quicklebendig	positive
aktionsfähig	positive
ausdrucksfähig	positive
einsichtsfähig	positive
urteilsfähig	positive
irreversibel	positive
polymorph	negative
unabänderlich	positive
naseweis	positive
kess	positive
ohnmächtig	negative
einflussreich	positive
autobiografisch	negative
autobiographisch	negative
ureigenst	negative
namenhaft	positive
übersät	negative
glatzköpfig	negative
kahlköpfig	negative
schludrig	negative
eben	positive
hoch verschuldet	positive
hochverschuldet	positive
kirchenamtlich	positive
finanzschwach	negative
lehramtlich	positive
glasklar	positive
bauamtlich	positive
strukturschwach	negative
einkommensschwach	negative
wirklichkeitsnah	positive
abschliessend	positive
hochwassergefährdet	negative
extrem	positive
radikal	positive
different	negative
tief	negative
steil	positive
erhöht	positive
dreilagig	negative
inkarniert	positive
flatterig	positive
verkehrsschwach	negative
vorfrühlingshaft	negative
ungeschminkt	positive
demonstrativ	positive
provokant	positive
hervorgehoben	positive
emphatisch	positive
akzentuiert	positive
ausgeprägt	positive
ostentativ	positive
drall	negative
spektakulär	positive
skeptisch	negative
erwerbsfähig	positive
immanent	negative
grasig	negative
nebelverhangen	negative
vernebelt	negative
existent	positive
indirekt	negative
pummelig	negative
schuldfähig	positive
spontan	positive
begeisterungsfähig	positive
verdächtig	positive
hervorstechend	positive
prägnant	positive
einprägsam	positive
durcheinander	negative
nicht staatlich	negative
nichtstaatlich	negative
persönlich	negative
rechtsstaatlich	positive
heiratswillig	positive
verantwortungsvoll	positive
wohlbekannt	positive
inhomogen	negative
illuster	positive
zweischichtig	negative
bedeutend	positive
verschroben	negative
sonderlich	negative
unbedeutsam	negative
subtropisch	negative
talentiert	positive
grundsteuerpflichtig	positive
versteckt	negative
schwunghaft	positive
geheimnisumwittert	positive
freizügig	positive
vielgestaltig	negative
masurisch	positive
gebleicht	negative
ausgebleicht	negative
verblasst	negative
bundesstaatlich	positive
signifikant	positive
überhöht	positive
repräsentativ	positive
aussagekräftig	positive
aussagefähig	positive
prägend	positive
epochal	positive
übermässig	positive
überzogen	positive
schütter	positive
blutarm	negative
licht	positive
spärlich	positive
nervös	positive
explizit	positive
inoffiziell	negative
schlampig	negative
natürlich	positive
kritikfähig	positive
munter	positive
überspannt	positive
wirtschaftsschwach	negative
dialogfähig	positive
hellwach	positive
dickköpfig	negative
ungebunden	negative
liiert	positive
verschossen	negative
dezent	negative
situativ	negative
situationsabhängig	negative
frequenzabhängig	negative
unmusikalisch	negative
streng	positive
diesseitig	positive
geschnetzelt	negative
lebensgeschichtlich	negative
biografisch	negative
biographisch	negative
freiberuflich	positive
freischaffend	positive
berufsbegleitend	positive
pathetisch	positive
schwülstig	positive
synchron	positive
mittelhoch	positive
standesamtlich	positive
halbstaatlich	positive
feurig	positive
temperamentvoll	positive
krustig	negative
nichtselbstständig	positive
nicht selbstständig	positive
jenseitig	negative
beachtbar	positive
gottgegeben	positive
geringfügig	negative
immediat	positive
vertraut	positive
genannt	positive
erwähnt	positive
thematisiert	positive
eingeschnitten	negative
verrückt	negative
vordergründig	negative
unantastbar	negative
unverschlüsselt	positive
horrend	positive
kauzig	negative
verkaufsschwach	negative
verschnupft	negative
hyperaktiv	positive
kompositorisch	positive
unmittelbar	positive
liberaldemokratisch	positive
stur	negative
unklar	negative
asynchron	negative
überzuckert	negative
magisch	positive
geheimnisvoll	positive
nervenstark	positive
rebellisch	negative
pestverseucht	negative
aufständisch	negative
widerspenstig	negative
klammheimlich	negative
hysterisch	positive
selbstgesteckt	negative
überbelegt	negative
sehnsuchtsvoll	negative
heissblütig	positive
fixiert	positive
leidensfähig	positive
engstirnig	negative
wörtlich	positive
ausdrücklich	positive
bemerkenswert	positive
unmissverständlich	positive
gefasst	positive
parteiamtlich	positive
katasteramtlich	positive
postamtlich	positive
seeamtlich	positive
bahnamtlich	positive
kribbelig	positive
kribblig	positive
flatterhaft	positive
breitgesichtig	negative
hochgelegen	positive
hoch gelegen	positive
verbucht	positive
gebucht	positive
unmassgeblich	negative
unzensiert	positive
gegnerisch	negative
begrünt	negative
schneebedeckt	negative
christliberal	positive
leicht	negative
exhibitionistisch	positive
schwarz-gelb	positive
hochstämmig	positive
störrisch	negative
tonangebend	positive
aufsässig	negative
vorschnell	positive
voreilig	positive
zollamtlich	positive
regierungsamtlich	positive
aufmüpfig	negative
reiflich	positive
überbacken	negative
theatralisch	positive
verstockt	negative
eigenmächtig	negative
rund	negative
geburtenschwach	negative
eigenwillig	negative
unverdächtig	negative
überpünktlich	positive
wieselflink	positive
verstohlen	negative
unbemerkt	negative
unbeobachtet	negative
unbeachtet	negative
beachtet	positive
suspekt	positive
unscheinbar	negative
eingeladen	negative
hochwüchsig	positive
verkehrsarm	negative
raumhoch	positive
hüfthoch	positive
turmhoch	positive
generalstabsmässig	positive
ungeduldig	positive
überdreht	positive
komödiantisch	positive
borniert	negative
denkbar	positive
unspektakulär	negative
hintersinnig	positive
larghetto	negative
besinnungslos	negative
unvermittelt	positive
aufgelöst	positive
fieberhaft	positive
gelassen	positive
übermannshoch	positive
halbhoch	positive
kniehoch	positive
meterhoch	positive
mannshoch	positive
ranghoch	positive
imperial	positive
allmächtig	positive
omnipotent	positive
ungleich	negative
divers	negative
unähnlich	negative
andere	negative
ruckartig	positive
ureigen	negative
rege	positive
umtriebig	positive
letztinstanzlich	positive
morbid	negative
begabt	positive
befähigt	positive
lernfähig	positive
dämmrig	negative
tiefgründig	positive
bar	positive
kunstvoll	negative
obrigkeitsstaatlich	positive
heterogen	negative
gleich	positive
dringend	positive
lebend	positive
paarig	positive
zugedeckt	negative
herzhaft	negative
volkseigen	negative
körpereigen	negative
körperimmanent	negative
landeseigen	negative
staatseigen	negative
hauseigen	negative
bundeseigen	negative
strahlenverseucht	negative
spartanisch	negative
rätselhaft	positive
undurchdringlich	positive
hauptamtlich	positive
ehrenamtlich	positive
nebenamtlich	positive
hauptberuflich	positive
nebenberuflich	positive
ätherisch	negative
wirkungsmächtig	positive
mitgliederschwach	negative
narrativ	positive
haardünn	positive
hauchdünn	positive
zerschnitten	negative
zersäbelt	negative
steuerpflichtig	positive
erzählerisch	positive
elaboriert	positive
angemeldet	positive
angekündigt	positive
nationalstaatlich	positive
hypernervös	positive
gebirgig	negative
unbotmässig	negative
beherrscht	positive
gedrungen	negative
abwesend	negative
lithografisch	positive
litographisch	positive
übermächtig	positive
finanzstark	positive
finanzkräftig	positive
verträumt	negative
wahnsinnig	negative
irrsinnig	negative
stilbildend	positive
zappenduster	negative
unfolgsam	negative
breitschultrig	negative
breitkiefrig	negative
breithüftig	negative
allerhöchste	positive
wirtschaftsliberal	positive
leiblich	negative
zweithöchste	positive
definitiv	positive
unwiederbringlich	positive
dritthöchste	positive
müde	negative
unwiderrufbar	positive
verzeihlich	positive
letztendlich	positive
unwiderruflich	positive
unternehmenseigen	negative
rührselig	negative
sentimental	negative
entschuldbar	positive
empfindungsfähig	positive
namhaft	positive
populär	positive
konformistisch	negative
arteigen	negative
verlagseigen	negative
betriebseigen	negative
leibeigen	negative
unlustig	negative
versponnen	negative
dämmerig	negative
veterinäramtlich	positive
patentamtlich	positive
zurechnungsfähig	positive
verschleimt	negative
transparent	positive
kontextsensitiv	negative
bockig	negative
kontrastiv	negative
weltbewegend	positive
schuppig	negative
sozialstaatlich	positive
einzelstaatlich	positive
verbockt	negative
schlank	positive
rank	positive
knöchelhoch	positive
verhangen	negative
renitent	negative
gedankenverloren	negative
gedankenversunken	negative
rasch	positive
kampfstark	positive
heteromorph	negative
wirkmächtig	positive
einkommenssteuerpflichtig	positive
einkommensteuerpflichtig	positive
bedroht	negative
verschiedenartig	negative
temporeich	positive
voraussehbar	positive
unveröffentlicht	negative
höchstmöglich	positive
erkundet	positive
geläufig	positive
erforscht	positive
traut	positive
cash	positive
reichsunmittelbar	positive
konzerneigen	negative
lappig	negative
eigensinnig	negative
disparat	negative
schrullig	negative
unaufschiebbar	positive
zelleigen	negative
spielfähig	positive
zahlungsfähig	positive
entwicklungsfähig	positive
deckenhoch	positive
unbekannt	negative
geschrieben	positive
kunstreich	negative
ernstlich	positive
dringlich	positive
asphaltiert	negative
bordeigen	negative
bindungsfähig	positive
denkfähig	positive
schützenswert	positive
schallgedämpft	negative
umsatzstark	positive
verborgen	negative
sehnsüchtig	negative
verhaltensgestört	negative
dement	negative
quirlig	positive
unignorierbar	positive
haushoch	positive
bibliophil	negative
dienstfähig	positive
stadteigen	negative
konfrontativ	negative
schuleigen	negative
vereinseigen	negative
gemeindeeigen	negative
firmeneigen	negative
markant	positive
beschuppt	negative
stockdunkel	negative
stockfinster	negative
melodramatisch	positive
zahlungsunfähig	positive
bankrott	positive
abgebrannt	positive
marxistisch-leninistisch	negative
irrelevant	negative
unkurierbar	positive
vorwitzig	positive
energieintensiv	negative
forschungsintensiv	negative
lohnintensiv	negative
hochheilig	negative
sakrosankt	negative
arbeitsintensiv	negative
millionenschwer	positive
liquide	positive
liquid	positive
missverständlich	negative
splendid	negative
umfassend	negative
versonnen	negative
selbstvergessen	negative
exorbitant	positive
voll	negative
dürr	positive
knochig	positive
hager	positive
schmächtig	positive
orphisch	positive
viel zitiert	positive
vielzitiert	positive
knetbar	positive
modellierbar	positive
formbar	positive
fremd	negative
betriebsfremd	positive
gleichrangig	positive
nämlich	positive
kongruent	positive
handtellergross	positive
normalgross	positive
millimetergross	positive
handgross	positive
verwirrt	negative
unüberhörbar	positive
besessen	positive
kreisrund	negative
unerwähnt	negative
wartungsintensiv	negative
personalintensiv	negative
doktrinär	positive
überschuldet	positive
systemimmanent	negative
viel	positive
deckungsgleich	positive
subtil	positive
abgründig	positive
gleichsinnig	positive
sehnlich	negative
steilwandig	positive
fanatisch	negative
extremistisch	negative
ideologisch	positive
fundamentalistisch	negative
technokratisch	negative
fünftgrösste	positive
viertgrösste	positive
enorm	positive
hünenhaft	positive
angesagt	positive
gerade	positive
bündig	positive
glattwandig	positive
höhengleich	positive
sexsüchtig	negative
tablettensüchtig	negative
punktgleich	positive
unentschieden	positive
mausetot	negative
zehntgrösste	positive
neuntgrösste	positive
sechstgrösste	positive
flächengrösste	positive
siebtgrösste	positive
achtgrösste	positive
freihändig	negative
gebietsfremd	negative
unbelebt	negative
unwesentlich	negative
massgeblich	positive
unheilbar	positive
vernunftbegabt	positive
chauvinistisch	negative
sexistisch	negative
hochkarätig	negative
obstinat	negative
unbelehrbar	negative
vollwertig	positive
gleichgestellt	positive
gleichgesinnt	positive
gleichberechtigt	positive
rechtsextremistisch	positive
linksextremistisch	positive
rechtsradikal	positive
gleichalt	positive
seidig	positive
uneben	negative
glatt	positive
gleichaltrig	positive
gleichnamig	positive
halbamtlich	negative
konventionell	negative
blumig	positive
paritätisch	positive
gleichgeartet	positive
indiskutabel	negative
reversibel	negative
reparabel	negative
sibyllinisch	positive
zweibahnig	negative
straff	positive
werkimmanent	negative
linksextrem	positive
linksradikal	positive
diktatorisch	positive
totalitär	positive
zwangsgestört	negative
zeitraubend	negative
lohnabhängig	negative
langgewachsen	positive
lang gewachsen	positive
hochgewachsen	positive
hoch gewachsen	positive
stutzig	negative
normalspurig	negative
bewusst	positive
unidentifiziert	negative
unumkehrbar	positive
diffus	negative
verschlüsselt	negative
rechtsextrem	positive
starrsinnig	negative
ruhig	negative
lotrecht	positive
arbeitssüchtig	negative
hektisch	positive
vollspurig	negative
waagerecht	positive
waagrecht	positive
gebunden	positive
metaphysisch	negative
verantwortungsbewusst	positive
materialintensiv	negative
geschichtsträchtig	positive
paranormal	negative
gleichlautend	positive
unabsehbar	negative
lang	positive
meistgenannt	positive
elliptisch	negative
neuronal	positive
unterschwellig	negative
latent	negative
niveaugleich	positive
beträchtlich	positive
inhaltsgleich	positive
baugleich	positive
wesensgleich	positive
namensgleich	positive
pflegebedürftig	negative
hilfsbedürftig	negative
hilfebedürftig	negative
hilfesuchend	negative
hilfe suchend	negative
anlehnungsbedürftig	negative
pflegeabhängig	negative
gleichgerichtet	positive
gleich gerichtet	positive
unübersehbar	positive
riesenhaft	positive
riesig	positive
riesengross	positive
unglaublich	positive
stattlich	positive
trunksüchtig	negative
zurückhaltend	negative
unangekündigt	negative
unangemeldet	negative
unangesagt	negative
buchstäblich	positive
überbelastet	positive
anderweitig	negative
übernatürlich	negative
restaurativ	negative
unbedeutend	negative
umfangreich	positive
närrisch	positive
erklecklich	positive
nostalgisch	negative
gestreng	positive
milliardenschwer	positive
grösstmöglich	positive
grösste	positive
weltgross	positive
mittelgross	positive
farblos	negative
transzendent	negative
massenhaft	negative
verlegt	negative
ungekünstelt	positive
beachtlich	positive
klein	negative
repressiv	positive
unterdrückerisch	positive
drastisch	positive
drakonisch	positive
dezidiert	positive
profund	positive
bekloppt	negative
narrenhaft	negative
jeck	negative
wichtig	positive
evolutionistisch	negative
geisteskrank	negative
mystisch	positive
knorrig	negative
totgeboren	negative
dissident	negative
verspätet	negative
gleichgross	positive
verzeihbar	positive
einspurig	negative
workoholic	negative
reichsfrei	positive
zweitgrösste	positive
kompetitiv	negative
gängig	positive
wahnhaft	negative
heterolog	negative
ebenbürtig	positive
gross gewachsen	positive
grossgewachsen	positive
angespannt	positive
bergig	negative
gleichnishaft	negative
medikamentenabhängig	negative
verschwendungssüchtig	negative
kaufsüchtig	negative
internetsüchtig	negative
fernsehsüchtig	negative
spielsüchtig	negative
flächengross	positive
sprichwörtlich	positive
traditionell	negative
konservativ	negative
kreisförmig	negative
ratsuchend	negative
rat suchend	negative
unangreifbar	negative
berechnet	positive
gutgeschrieben	positive
wertgestellt	positive
bergreich	negative
wirkungsreich	positive
konträr	negative
oppositionell	negative
umstürzlerisch	negative
subversiv	negative
umstürzend	negative
überbreit	negative
linear	positive
grade	positive
eirund	negative
eiförmig	negative
kerzengerade	positive
drittgrösste	positive
alkoholabhängig	negative
alkoholsüchtig	negative
süchtig	negative
drogenabhängig	negative
drogensüchtig	negative
rauschgiftsüchtig	negative
sprachbegabt	positive
musikalisch	positive
geduldig	negative
hygienisch	positive
nervlich	positive
strikt	positive
bewusstlos	negative
gleichwertig	positive
angewiesen	negative
zirkular	negative
zirkulär	negative
oval	negative
ungehört	negative
ungesehen	negative
ungehalten	positive
unwirsch	positive
periphrastisch	negative
unverletzlich	negative
unerkannt	negative
besondere	negative
symbolisch	negative
potent	positive
belastet	positive
überlastet	positive
überarbeitet	positive
symbolhaft	negative
mittelbar	negative
arbeitsreich	negative
unverrückbar	positive
erdenklich	positive
transzendental	negative
uneingeladen	positive
unpopulär	negative
anonym	negative
inquisitorisch	positive
übersinnlich	negative
gekünstelt	negative
komatös	negative
unschlagbar	positive
machtlos	negative
unbesiegbar	positive
unterschiedlich	negative
unterscheidbar	negative
unbeherrscht	negative
verlorengegangen	negative
verloren gegangen	negative
schwer	positive
übertragen	negative
modrig	negative
moderig	negative
gertenschlank	positive
änderbar	negative
implizit	negative
zeitintensiv	negative
zeitaufwändig	negative
zeitaufwendig	negative
musikbegabt	positive
hochbegabt	positive
hoch begabt	positive
artfremd	negative
körperfremd	negative
wildfremd	negative
ortsfremd	negative
arbeitsaufwendig	negative
arbeitsaufwändig	negative
homogen	positive
identisch	positive
sonstig	negative
gleichartig	positive
merkbar	positive
isomorph	positive
respektabel	positive
entseelt	negative
putzmunter	positive
abschüssig	positive
kapital	positive
schleierhaft	positive
dunkel	positive
verdreht	negative
leichtgängig	negative
gleichbedeutend	positive
gleichgeschaltet	positive
nivelliert	positive
ähnlich	positive
mannsgross	positive
putzsüchtig	negative
naturbelassen	positive
künstlich	negative
federleicht	negative
luftig	negative
sogenannt	positive
faustgross	positive
breitspurig	negative
mehrspurig	negative
informal	positive
bergisch	negative
schmalschultrig	positive
schmalbrüstig	positive
schmalhüftig	positive
wahrscheinlich	positive
viel genannt	positive
vielgenannt	positive
untengenannt	positive
unten genannt	positive
obgenannt	positive
obengenannt	positive
oben genannt	positive
erstgenannt	positive
vorgenannt	positive
letztgenannt	positive
wartungsarm	negative
thermoplastisch	positive
pythisch	positive
unerkennbar	negative
paranoid	negative
fortbestehend	positive
hagiographisch	negative
hagiografisch	negative
verformbar	positive
todmüde	negative
verschlafen	negative
wissenschaftsmethodisch	positive
hochleistungsfähig	positive
unschwer	negative
banal	negative
erbsengross	positive
blumenreich	positive
naturrein	positive
maxi	positive
widerständig	negative
plausibel	positive
glaubhaft	positive
höchstpersönlich	negative
reibungslos	negative
delphisch	positive
vertikal	positive
senkrecht	positive
fresssüchtig	negative
diagonal	positive
differenzierbar	negative
schnurgerade	positive
lebensgross	positive
übergross	positive
überlebensgross	positive
trivial	negative
trotzig	negative
zentralnervös	positive
horizontal	positive
neural	positive
hirntot	negative
personal	negative
personenbezogen	negative
vernachlässigbar	negative
unbar	negative
bargeldlos	negative
tennisballgross	positive
ungenannt	negative
familiär	positive
fleischgeworden	positive
fleisch geworden	positive
lässig	positive
nonchalent	positive
uneitel	positive
ungezwungen	positive
eigenhändig	negative
esssüchtig	negative
unerforscht	negative
unerkundet	negative
kodiert	negative
menschengross	positive
spleenig	negative
höher gelegen	positive
höhergelegen	positive
höchstgelegen	positive
ungemein	positive
desorientiert	negative
schlaftrunken	negative
offiziös	negative
miefig	negative
unausgeschlafen	negative
hundemüde	negative
vorrangig	positive
ungezählt	positive
unzählig	positive
hauptsächlich	positive
unermesslich	positive
immens	positive
kleinwüchsig	negative
kurierbar	negative
gestaltbar	negative
erwartbar	positive
endlos	positive
langatmig	positive
primitiv	negative
simpel	negative
sinnfällig	negative
mafiaähnlich	positive
sirupähnlich	positive
runzelig	negative
aufbrausend	negative
holografisch	positive
gefüllt	negative
randvoll	negative
leer	positive
rappeldürr	positive
begnadet	positive
kündbar	negative
zentral	positive
heterotroph	negative
zwergenhaft	negative
spiegelglatt	positive
erwartungsgemäss	positive
erwartungsgetreu	positive
mutmasslich	positive
vollbesetzt	negative
manipulierbar	negative
zerstörbar	negative
ratlos	negative
fundamental	positive
elementar	positive
staatstragend	positive
mehrfach	positive
vielfach	positive
zig	positive
eheähnlich	positive
kriegsähnlich	positive
menschenähnlich	positive
gottähnlich	positive
hundeähnlich	positive
knöchern	positive
wortarm	negative
grasartig	negative
reaktionär	negative
naturidentisch	negative
langgestreckt	positive
lang gestreckt	positive
wenig	negative
gasgefüllt	negative
hochliegend	positive
klapperdürr	positive
spindeldürr	positive
abgezehrt	positive
unterernährt	positive
abgemergelt	positive
ausgemergelt	positive
haarähnlich	positive
jahrelang	positive
goldähnlich	positive
fischähnlich	positive
filzähnlich	positive
nächtelang	positive
minutenlang	positive
unerlässlich	positive
unnatürlich	negative
mondän	positive
weltgewandt	positive
essenziell	positive
essentiell	positive
grundsätzlich	positive
heilbar	negative
kurz	negative
anthropomorph	positive
einsilbig	negative
armlang	positive
kinnlang	positive
handlang	positive
baumlang	positive
dreiviertellang	positive
mickrig	negative
eingeschränkt	negative
begrenzt	negative
runzlig	negative
glibberig	positive
äquivalent	positive
jahrzehntelang	positive
übermenschlich	positive
etherisch	negative
umkehrbar	negative
faltig	negative
isotrop	positive
veränderbar	negative
modifizierbar	negative
schroff	positive
korrigierbar	negative
prallvoll	negative
langwierig	positive
trendig	positive
gnomenhaft	negative
mini	negative
lebenswichtig	positive
prothetisch	negative
erwähnenswert	positive
plattig	positive
knielang	positive
meterlang	positive
beständig	positive
ellenlang	positive
überlang	positive
seitenlang	positive
mittellang	positive
versicherungsfremd	negative
unbewusst	negative
überlebenswichtig	positive
langgestielt	positive
vorherrschend	positive
herrschend	positive
entscheidend	positive
morphiumsüchtig	negative
stoisch	negative
vollumfänglich	negative
schweigsam	negative
wortkarg	negative
aalglatt	positive
ultralang	positive
hüftlang	positive
wadenlang	positive
bodenlang	positive
schulterlang	positive
halblang	positive
knöchellang	positive
fingerlang	positive
fusslang	positive
vielspurig	negative
fünfspurig	negative
doppelspurig	negative
dreispurig	negative
linksbündig	positive
basal	positive
mangelnd	negative
anwesend	positive
rechtsbündig	positive
unbezwingbar	positive
richtungsweisend	positive
richtungweisend	positive
programmatisch	positive
zielweisend	positive
massgebend	positive
historisch	positive
zweitwichtigste	positive
nennenswert	positive
überproportional	positive
skandalträchtig	positive
wissenswert	positive
einstudiert	negative
gigantisch	positive
bombastisch	positive
überdimensional	positive
affenähnlich	positive
auflagenstark	positive
unwichtig	negative
artifiziell	negative
essenzial	positive
essential	positive
behandelbar	negative
schlicht	negative
einfach	negative
skandalös	positive
fahl	negative
erzkonservativ	negative
vornehmlich	positive
überwiegend	positive
vorwiegend	positive
monströs	positive
hochmusikalisch	positive
distanziert	negative
achtspurig	negative
unglaubhaft	negative
kolossal	positive
kleinstmöglich	negative
kleinste	negative
längerfristig	positive
mehrmalig	positive
profan	positive
materiell	positive
weltlich	positive
lebensnotwendig	positive
verschoben	negative
diskutabel	positive
relevant	positive
pygmäenhaft	negative
ununterscheidbar	positive
nationalkonservativ	negative
einschneidend	positive
massiv	positive
unaufhörlich	positive
wertkonservativ	negative
ausführlich	positive
ausgiebig	positive
zahllos	positive
häuslich	negative
forciert	negative
weitgespannt	negative
sublim	positive
kultig	positive
in	positive
symbolhaltig	negative
mitgliederstark	positive
halb voll	positive
halbvoll	positive
sinnverwandt	positive
unzählbar	positive
säkular	positive
ewig	positive
säkularisiert	positive
allumfassend	negative
landläufig	positive
unaufdringlich	negative
totenähnlich	positive
reichhaltig	positive
umfänglich	positive
kokainabhängig	negative
wesentlich	positive
hochrangig	negative
winzig	negative
materialistisch	positive
möglich	positive
grosswüchsig	positive
ständig	positive
nicht linear	negative
nichtlinear	negative
heroinabhängig	negative
kokainsüchtig	negative
heroinsüchtig	negative
ausverkauft	negative
ausgebucht	negative
unmöglich	negative
ausdauernd	negative
unnachgiebig	negative
beharrlich	negative
hartnäckig	negative
einleitend	negative
kardinal	positive
grundlegend	positive
reserviert	negative
kontaktarm	negative
zurückgezogen	negative
spröde	negative
spröd	negative
menschenscheu	negative
unentdeckt	negative
gehaltvoll	positive
etlich	positive
zahlreich	positive
verweltlicht	positive
final	positive
augenscheinlich	positive
unwahrscheinlich	negative
umgelegt	negative
schlafwandlerisch	negative
still	negative
überfordert	positive
gleichgelagert	positive
gleich gelagert	positive
unvergleichlich	negative
einmalig	negative
einzigartig	negative
abwechselnd	negative
unvergleichbar	negative
mittelschwer	positive
verstopft	negative
primär	positive
augenfällig	positive
weitreichend	positive
weitgehend	positive
weitführend	positive
ungebeten	positive
unaufgeregt	negative
skandalumwittert	positive
undeutlich	negative
mannigfach	positive
weitgreifend	negative
kriegswichtig	positive
anscheinend	positive
deduktiv	positive
geistig behindert	negative
variabel	negative
induktiv	positive
wortgetreu	positive
hochstehend	negative
synthetisch	negative
beispiellos	negative
wechselnd	negative
erforderlich	positive
zweierlei	negative
verknallt	negative
langgezogen	positive
schleichend	positive
gestreckt	positive
ausgedehnt	positive
innovativ	positive
vergleichbar	positive
jahrhundertelang	positive
gleichlang	positive
zappelig	positive
kryptographisch	negative
kryptografisch	negative
allmählich	positive
schrittweise	positive
dreierlei	negative
dichtbebaut	negative
dicht bebaut	negative
eitel	negative
langfristig	positive
synonym	positive
differentiell	negative
differenziell	negative
impotent	negative
immerwährend	positive
zeitlos	positive
fortdauernd	positive
höchstwahrscheinlich	positive
unkenntlich	negative
permissiv	negative
opiumsüchtig	negative
klein gewachsen	negative
kleingewachsen	negative
kurzgewachsen	negative
kurz gewachsen	negative
wichtigst	positive
reizbar	negative
aufgesetzt	negative
hermeneutisch	positive
unendlich	positive
unvergänglich	positive
empirisch	positive
variierbar	negative
buchstabengetreu	positive
fehlend	negative
luftgefüllt	negative
voraussichtlich	positive
potentiell	positive
potenziell	positive
durchschlagend	positive
reichlich	positive
verwechselbar	negative
quer	positive
winzigklein	negative
krumm	negative
notwendig	positive
klapprig	positive
abgemagert	positive
normativ	positive
schuldbewusst	positive
jähzornig	negative
aufsehenerregend	positive
aufsehen erregend	positive
gleitfähig	positive
unbelastet	negative
mühsam	positive
mühselig	positive
beschwerlich	positive
unbeachtlich	negative
gehalten	negative
parkähnlich	positive
lang gefasst	positive
langgefasst	positive
sechsspurig	negative
vierspurig	negative
zweispurig	negative
kilometerlang	positive
meilenlang	positive
superwichtig	positive
hochwichtig	positive
progressiv	positive
lebenslang	positive
jahrtausendelang	positive
stundenlang	positive
tagelang	positive
wochenlang	positive
monatelang	positive
manieriert	negative
langstielig	positive
mehrheitlich	positive
maximal	positive
gering	negative
glitschig	positive
übervoll	negative
überfüllt	negative
rutschig	positive
kleinteilig	negative
brennend	positive
sanitär	positive
gasreich	positive
ballaststoffreich	positive
heilsgeschichtlich	positive
bleischwer	positive
meilenweit	positive
graduell	positive
unverzichtbar	positive
zwingend	positive
vereinfacht	negative
eineinhalbfach	positive
diachron	positive
geringstmöglich	negative
unkündbar	positive
geleert	positive
entleert	positive
selten	positive
wiederholt	positive
abstrakt	positive
naturhistorisch	positive
marginal	negative
existential	positive
existenzial	positive
geboten	positive
ernstzunehmend	positive
kalorienreich	positive
sechsfach	positive
6-fach	positive
doppelt	positive
dreifach	positive
3-fach	positive
vierfach	positive
4-fach	positive
merklich	positive
bemerkbar	positive
feststellbar	positive
zuordenbar	positive
entbehrlich	negative
verzichtbar	negative
unnötig	negative
krummlinig	negative
blühend	positive
kirchengeschichtlich	positive
hochgesteckt	positive
vergänglich	negative
letztmöglich	positive
stichpunktartig	negative
weittragend	positive
fällig	positive
hochfliegend	positive
impossibel	negative
naturgeschichtlich	positive
literaturgeschichtlich	positive
entwicklungsgeschichtlich	positive
musikgeschichtlich	positive
dreimalig	positive
3-malig	positive
4-malig	positive
viermalig	positive
reformatorisch	positive
zurechenbar	positive
beiderlei	negative
astronomisch	positive
unbedingt	positive
wasserreich	positive
obligatorisch	positive
nötig	positive
schief	negative
einschlägig	positive
unveränderbar	positive
schräg	negative
vermehrt	positive
rar	positive
wiederkehrend	positive
7-fach	positive
siebenfach	positive
8-fach	positive
achtfach	positive
9-fach	positive
neunfach	positive
10-fach	positive
zehnfach	positive
hundertfach	positive
100-fach	positive
delimitiert	negative
limitiert	negative
unbegrenzt	positive
befristet	negative
verschrumpelt	negative
schrumplig	negative
schrumpelig	negative
reduktionistisch	negative
kennzeichnend	positive
weit	positive
diachronisch	positive
sozialgeschichtlich	positive
faltenreich	positive
n-fach	positive
frequent	positive
schwerpunktmässig	positive
ausschlaggebend	positive
obligat	positive
minimalistisch	negative
vollsynthetisch	negative
allseitig	negative
unleserlich	negative
himmelweit	positive
nächstmöglich	positive
allgegenwärtig	positive
teilnehmend	positive
opulent	positive
zeitgeschichtlich	positive
geschichtlich	positive
landesgeschichtlich	positive
millionenfach	positive
brüsk	positive
klitzeklein	negative
arm	negative
extensiv	positive
häufig	positive
grossangelegt	positive
militärhistorisch	positive
verfolgbar	positive
transversal	positive
geknickt	negative
erregbar	negative
aschfahl	negative
sekundär	negative
zweitrangig	negative
unausschöpflich	positive
unschätzbar	positive
unerschöpflich	positive
weitestgehend	positive
unzureichend	negative
unzulänglich	negative
harzig	positive
überstürzt	negative
überhastet	negative
kategorisch	positive
implausibel	negative
unglaubwürdig	negative
hanebüchen	negative
distanzlos	positive
2-malig	positive
zweimalig	positive
ausführbar	positive
kurzzeitig	negative
unentwegt	negative
zigfach	positive
immateriell	negative
prompt	negative
vorgezogen	positive
unverzüglich	negative
konsensfähig	positive
mikroskopisch	negative
kammermusikalisch	positive
detailliert	positive
detailgetreu	positive
aufgeklärt	positive
zivilisiert	positive
up to date	positive
rückwärtsgewandt	negative
zeitgemäss	positive
fünffach	positive
5-fach	positive
existenziell	positive
existentiell	positive
perkutan	negative
vergriffen	negative
sofortig	negative
out	negative
fünfmalig	positive
5-malig	positive
nachgiebig	positive
anderthalbfach	positive
dornenreich	positive
modebewusst	positive
endlich	negative
zwölffach	positive
12-fach	positive
hochgestochen	positive
zehnmalig	positive
10-malig	positive
aufdringlich	positive
unvergesslich	positive
verkehrsberuhigt	positive
literarhistorisch	positive
bestimmend	positive
charakteristisch	positive
affig	negative
musikhistorisch	positive
literaturhistorisch	positive
sechsmalig	positive
6-malig	positive
nationalistisch	negative
rutschfest	negative
nachhaltig	positive
hochtrabend	positive
achtmalig	positive
8-malig	positive
7-malig	positive
siebenmalig	positive
9-malig	positive
neunmalig	positive
kirchenmusikalisch	positive
unermüdlich	negative
ideengeschichtlich	positive
gehäuft	positive
dogmengeschichtlich	positive
wissenschaftsgeschichtlich	positive
parallel	positive
unterfordert	negative
unterqualifiziert	positive
aufgeregt	positive
folgenschwer	positive
folgenreich	positive
abendfüllend	positive
zwergwüchsig	negative
unverbrüchlich	positive
unvergessen	positive
unsterblich	positive
2-fach	positive
zweifach	positive
autoritativ	positive
stichprobenartig	negative
windschief	negative
bilderreich	positive
architekturhistorisch	positive
architekturgeschichtlich	positive
vitaminreich	positive
regionalgeschichtlich	positive
futuristisch	positive
bahnbrechend	positive
diskussionswürdig	positive
zwanzigfach	positive
variationsreich	positive
unabdingbar	positive
begrifflich	positive
fettreich	positive
formenreich	positive
stadtgeschichtlich	positive
subkutan	negative
kurzfristig	negative
detailreich	positive
nährstoffreich	positive
selbstgefällig	negative
haarsträubend	negative
beobachtbar	positive
summarisch	negative
tonnenschwer	positive
nebensächlich	negative
erneuernd	positive
unvermeidbar	positive
unvermeidlich	positive
postwendend	negative
schlagwortartig	negative
realisierbar	positive
umsetzbar	positive
durchführbar	positive
abundant	positive
gewellt	negative
therapierbar	negative
zyklopisch	positive
abgeschrägt	negative
stammesgeschichtlich	positive
erdgeschichtlich	positive
wirkungsgeschichtlich	positive
x-fach	positive
allzugegen	positive
omnipräsent	positive
partizipierend	positive
verkürzt	negative
reformerisch	positive
inflationär	positive
lakonisch	negative
kurzgefasst	negative
kurz gefasst	negative
tausendfach	positive
1000-fach	positive
stichwortartig	negative
reformistisch	positive
urgeschichtlich	positive
weltgeschichtlich	positive
sprachgeschichtlich	positive
weitgefächert	positive
konzis	positive
akzidentiell	negative
akzidentell	negative
wellig	negative
rückführbar	positive
zurückführbar	positive
figurenreich	positive
überschwer	positive
eiweissreich	positive
rohstoffreich	positive
torreich	positive
variantenreich	positive
bürgerkriegsähnlich	positive
immer während	positive
verwirklichbar	positive
machbar	positive
selbstgerecht	negative
selbstherrlich	negative
affektiert	negative
geziert	negative
kilometerweit	positive
theatergeschichtlich	positive
unlesbar	negative
initial	negative
technikorientiert	positive
technikgläubig	positive
fortschrittlich	positive
lebenslänglich	positive
landeshistorisch	positive
multiplikativ	positive
eisenreich	positive
oftmalig	positive
kniefrei	negative
kirchenhistorisch	positive
filmhistorisch	positive
kriegsgeschichtlich	positive
filmgeschichtlich	positive
wirtschaftsgeschichtlich	positive
rechtsgeschichtlich	positive
militärgeschichtlich	positive
religionsgeschichtlich	positive
breitgefächert	positive
kurzstielig	negative
minder	negative
minimal	negative
schemenhaft	negative
zeithistorisch	positive
sprachhistorisch	positive
stadthistorisch	positive
welthistorisch	positive
wirtschaftshistorisch	positive
rechtshistorisch	positive
religionshistorisch	positive
unbeträchtlich	negative
universalgeschichtlich	positive
dürftig	negative
leer stehend	positive
leerstehend	positive
lax	positive
unabweisbar	positive
ausreichend	positive
optional	negative
nachrangig	negative
darstellbar	positive
überwindbar	positive
abziehbar	positive
umgehend	negative
wesensgemäss	positive
diskutierbar	positive
unmerklich	negative
vermeidbar	negative
kläglich	negative
kärglich	negative
erneut	positive
zwangsläufig	positive
notgedrungen	positive
unaufhaltsam	positive
widerruflich	negative
durchsetzbar	positive
therapieresistent	positive
weitläufig	positive
deutschlandweit	positive
weltweit	positive
regelmässig	positive
weiträumig	positive
europaweit	positive
wesenhaft	positive
winkelig	negative
unlimitiert	positive
deflationär	negative
weitverbreitet	positive
vereinbar	positive
unwandelbar	positive
revolutionär	positive
abermalig	positive
lösbar	positive
wasserarm	negative
fettarm	negative
vorbehaltlich	negative
inkompatibel	negative
unvereinbar	negative
kompatibel	positive
undurchführbar	negative
abbildbar	positive
ungenügend	negative
ärmlich	negative
rekonstruierbar	positive
unveränderlich	positive
lapidar	negative
aufführbar	positive
prüfbar	positive
verderblich	negative
eiweissarm	negative
ideell	negative
rückständig	negative
vorweggenommen	positive
invariant	positive
erfüllbar	positive
ternär	positive
unbefristet	positive
kontrolliert	negative
anachronistisch	negative
kursiv	negative
einschränkend	negative
raumgreifend	positive
penetrant	positive
kalkig	negative
lasch	positive
leger	positive
sterblich	negative
symptomatisch	positive
bezeichnend	positive
wiederholbar	positive
überkandidelt	positive
exaltiert	positive
quaternär	positive
wertbeständig	positive
unaufhaltbar	positive
überqualifiziert	negative
winklig	negative
beiläufig	negative
konkret	negative
siderisch	positive
neuerlich	positive
spielbar	positive
menschenleer	positive
luftleer	positive
unbeschränkt	positive
beschränkend	negative
unregelmässig	positive
nochmalig	positive
vitaminarm	negative
gleichbleibend	positive
blutleer	positive
konstant	positive
unverändert	positive
sinnentleert	positive
unumgänglich	positive
unausweichlich	positive
astrophysikalisch	positive
unweigerlich	positive
werterhaltend	positive
mindeste	negative
rohstoffarm	negative
peripher	negative
kalorienarm	negative
österreichweit	positive
flüchtig	negative
unbeständig	negative
calvinistisch	positive
akzessorisch	negative
nährstoffarm	negative
unentbehrlich	positive
restriktiv	negative
zahlbar	positive
ubiquitär	positive
schnellstmöglich	negative
fristlos	negative
methodistisch	positive
fleischarm	negative
imperativ	positive
unauslöschlich	positive
konstruierbar	positive
halbleer	positive
wenigste	negative
sinnleer	positive
genug	positive
genügend	positive
hinreichend	positive
wechselhaft	negative
reich	positive
aufhebbar	positive
behebbar	positive
auflöslich	positive
absetzbar	positive
auflösbar	positive
anschaulich	negative
hinlänglich	positive
antizyklisch	positive
ephemer	negative
regionaltypisch	positive
überbrückbar	positive
bundesweit	positive
archetypisch	positive
welk	negative
ephemerisch	negative
unabkömmlich	positive
minütlich	positive
stündlich	positive
jährlich	positive
alljährlich	positive
halbjährlich	positive
vierteljährlich	positive
wöchentlich	positive
allwöchentlich	positive
monatlich	positive
allmonatlich	positive
weltumspannend	positive
weltumfassend	positive
entlarvend	positive
saisonal	positive
jahreszeitlich	positive
konterrevolutionär	positive
zunehmend	negative
nachlassend	negative
fakultativ	negative
oligotroph	negative
gewinkelt	negative
unbewältigbar	negative
hochverräterisch	positive
inkonstant	negative
unabwendbar	positive
unspielbar	negative
hugenottisch	positive
landestypisch	positive
zeittypisch	positive
zurückgeblieben	negative
unrealisierbar	negative
rechtwinkelig	negative
rechtwinklig	negative
unkontrolliert	positive
gegenrevolutionär	positive
szenetypisch	positive
frauentypisch	positive
metabolisch	negative
typisch	positive
reproduzierbar	positive
gebrochen	negative
urdeutsch	positive
einklagbar	positive
rückzahlbar	positive
unstet	negative
orthogonal	negative
prozyklisch	positive
vollstreckbar	positive
zeitweilig	positive
wandelbar	positive
kalkhaltig	negative
halbstündlich	positive
zureichend	positive
männertypisch	positive
saisonbedingt	positive
ununterbrochen	positive
cyclisch	positive
zyklisch	positive
turnunsgemäss	positive
turnusmässig	positive
periodisch	positive
bettelarm	negative
bitterarm	negative
durchgehend	positive
durchgängig	positive
gelegentlich	positive
wechselvoll	negative
unterbrochen	positive
veränderlich	positive
sporadisch	positive
zeitweise	positive
temporär	positive
abnehmend	negative
verringernd	negative
degressiv	negative
muschelkalkhaltig	negative
unlösbar	negative
alsbaldig	negative
verräterisch	positive
verarmt	negative
pleite	negative
spitzwinklig	negative
spitzwinkelig	negative
stumpfwinklig	negative
stumpfwinkelig	negative
täglich	positive
iterativ	positive
wohlhabend	positive
gutsituiert	positive
betucht	positive
vermögend	positive
gut betucht	positive
gutbetucht	positive
zahlungskräftig	positive
unauflöslich	negative
schwerreich	positive
steinreich	positive
neureich	positive
stet	positive
unterentwickelt	negative
notleidend	negative
not leidend	negative
prototypisch	positive
rezessiv	negative
unaufhebbar	negative
untypisch	negative
kapitalkräftig	positive
illustrativ	negative
begütert	positive
unüberwindbar	negative
unüberwindlich	negative
superreich	positive
stinkreich	positive
situiert	positive
illusorisch	negative
utopisch	negative
pausenlos	positive
retardiert	negative
reguliert	negative
geregelt	positive
regelhaft	positive
stereotypisch	positive
stereotyp	positive
nichtständig	positive
nicht ständig	positive
idealtypisch	positive
sinkend	negative
rückläufig	negative
kaufkräftig	positive
unüberbrückbar	negative
bedürftig	negative
unauflösbar	negative
zurückgehend	negative
abflauend	negative
überreich	positive
rückgängig	negative
halbstündig	positive
hoch entwickelt	positive
hochentwickelt	positive
rückgebildet	negative
absinkend	negative
stetig	positive
dauernd	positive
fortwährend	positive
fortgesetzt	positive
kontinuierlich	positive
schutzbedürftig	negative
wärmebedürftig	negative
atypisch	negative
andauernd	positive
fallend	negative
permanent	positive
ungebrochen	positive
unablässig	positive
regressiv	negative
diskontinuierlich	negative
unstetig	negative
steigend	positive
sequentiell	positive
sequenziell	positive
aufeinander folgend	positive
aufeinanderfolgend	positive
sukzessiv	positive
fortlaufend	positive
höchstentwickelt	positive
fortschreitend	positive
konsekutiv	positive
schubweise	negative
stossweise	negative
ansteigend	positive
