gemein	negative
ausgezeichnet	positive
hässlich	negative
richtig	positive
schlecht	negative
hochwertig	positive
nett	positive
unglücklich	negative
glücklich	positive
ekelhaft	negative
arm	negative
schön	positive
lästig	negative
falsch	negative
korrekt	positive
überlegen	positive
negativ	negative
minderwertig	negative
gut	positive
positiv	positive
exzellent	positive
traurig	negative
reich	positive
richtiggehend	positive
regelrecht	positive
unrichtig	negative
ekel erregend	negative
ekelerregend	negative
ehrlich	positive
hochklassig	positive
unterlegen	negative
schwindlig	negative
preussisch	positive
verarmt	negative
übel	negative
nervig	negative
unaufrichtig	negative
geringwertig	negative
gewissenhaft	positive
ruchbar	negative
böse	negative
vertrauenswürdig	positive
bös	negative
freudlos	negative
vermögend	positive
aufrichtig	positive
unehrlich	negative
froh	positive
niederträchtig	negative
boshaft	negative
aufrecht	positive
frohgestimmt	positive
froh gestimmt	positive
