schnell	positive
nett	positive
böse	negative
langweilig	negative
stark	positive
phantastisch	positive
fantastisch	positive
schrecklich	negative
kompliziert	negative
schwierig	negative
nachtragend	negative
grossartig	positive
hervorragend	positive
bös	negative
schwach	negative
schön	positive
hübsch	positive
dumm	negative
schlimm	negative
zornig	negative
ärgerlich	negative
wütend	negative
prima	positive
langsam	negative
schlecht	negative
sympathisch	positive
grimmig	negative
lieb	positive
liebevoll	positive
rasch	positive
übel	negative
ruchbar	negative
hässlich	negative
unkalkulierbar	negative
unberechenbar	negative
unkompliziert	positive
unversöhnlich	negative
kräftig	positive
grandios	positive
herausragend	positive
liebesfähig	positive
erzürnt	negative
liebreich	positive
kraftlos	negative
uninteressant	negative
wild	negative
verärgert	negative
niederträchtig	negative
boshaft	negative
klug	positive
schwindlig	negative
gut	positive
diffizil	negative
sympathie erweckend	positive
sympathieerweckend	positive
astrein	positive
knorke	positive
dufte	positive
interessant	positive
grantig	negative
temporeich	positive
grimm	negative
kalkulierbar	positive
kraftvoll	positive
berechenbar	positive
pflegeleicht	positive
lebendig	positive
lebhaft	positive
intelligent	positive
schlau	positive
blass	negative
versöhnlich	positive
bleich	negative
phlegmatisch	negative
unintelligent	negative
einschätzbar	positive
tot	negative
faul	negative
faulig	negative
verfault	negative
fleissig	positive
emsig	positive
eifrig	positive
arbeitsam	positive
tüchtig	positive
untüchtig	negative
