prunkvoll	positive
sinnlich	positive
pompös	positive
schlecht	negative
gemein	negative
unappetitlich	negative
befehlsgemäss	positive
vierschrötig	negative
regelgemäss	positive
wahrheitsgemäss	positive
negativ	negative
unglücklich	negative
fettig	negative
lumpig	negative
schadenfroh	negative
wortlautgemäss	positive
wahrhaftig	positive
fleischlich	positive
ungepflegt	negative
triftig	positive
handfest	positive
pickelig	negative
entstellt	negative
unattraktiv	negative
preisgekrönt	positive
unterlegt	positive
schurkisch	negative
ekelhaft	negative
hochzufrieden	positive
schön	positive
begründet	positive
richtig	positive
adäquat	positive
gut	positive
regulär	positive
veritabel	positive
unästhetisch	negative
normgemäss	positive
prächtig	positive
korrekt	positive
bestimmungsgemäss	positive
gammelig	negative
garstig	negative
verkommen	negative
regelgerecht	positive
tauglich	positive
hässlich	negative
statutengemäss	positive
nett	positive
glücklich	positive
potthässlich	negative
minderwertig	negative
verlottert	negative
vorschriftsmässig	positive
wahrheitsgetreu	positive
ordnungsgemäss	positive
zufrieden	positive
positiv	positive
zerlumpt	negative
ausgezeichnet	positive
fundiert	positive
exzellent	positive
superior	positive
unansehnlich	negative
schlimm	negative
vergammelt	negative
abgerissen	negative
lästig	negative
wohlbegründet	positive
ölig	negative
prunkhaft	positive
arm	negative
verlumpt	negative
überlegen	positive
fies	negative
falsch	negative
stichhaltig	positive
verwahrlost	negative
hochwertig	positive
wahr	positive
gammlig	negative
schmuddelig	negative
wortgemäss	positive
wahrhaft	positive
satzungsgemäss	positive
angemessen	positive
ungeschlacht	negative
prachtvoll	positive
verschwitzt	negative
strähnig	negative
mies	negative
verteufelt	negative
grobschlächtig	negative
vorschriftsgemäss	positive
geeignet	positive
glimpflich	positive
seelig	positive
überglücklich	positive
glückselig	positive
ungetrübt	positive
verheerend	negative
katastrophal	negative
vernichtend	negative
sintflutartig	negative
wolkenbruchartig	negative
behindertengerecht	positive
fahrstuhlgerecht	positive
rollstuhlgerecht	positive
zweckgemäss	positive
empfehlenswert	positive
ratsam	positive
unakzeptabel	negative
inakzeptabel	negative
zweckentsprechend	positive
erfolglos	negative
angezeigt	positive
hübsch	positive
empörend	negative
eklig	negative
arg	negative
unannehmbar	negative
himmelschreiend	negative
unvertretbar	negative
schmuck	positive
dekorativ	positive
bildhübsch	positive
verkehrssicher	positive
verkehrstauglich	positive
schmuckvoll	positive
nährstoffarm	negative
danebengegangen	negative
unverrichtet	negative
schiefgegangen	negative
fehlgeschlagen	negative
schiefgelaufen	negative
oligotroph	negative
reichverziert	positive
reich verziert	positive
nutzbringend	positive
nützlich	positive
hochseetüchtig	positive
seetüchtig	positive
geländetauglich	positive
kriegstauglich	positive
fahrtauglich	positive
diensttauglich	positive
alltagstauglich	positive
fahrtüchtig	positive
praxistauglich	positive
wehrtauglich	positive
wehrfähig	positive
wehrdienstfähig	positive
fördernd	positive
förderlich	positive
umweltgerecht	positive
entwicklungsgemäss	positive
differenziert	positive
gebührend	positive
fachgerecht	positive
umsichtig	positive
hoffähig	positive
zünftig	positive
begründbar	positive
gerechtfertigt	positive
ausgewogen	positive
nachahmenswert	positive
einvernehmlich	positive
wohlproportioniert	positive
standesgemäss	positive
situationsgerecht	positive
statthaft	positive
sachgerecht	positive
praxisgerecht	positive
gütlich	positive
sachgemäss	positive
fachgemäss	positive
lohnend	positive
lohnenswert	positive
gedeihlich	positive
verkaufsfördernd	positive
wachstumsfördernd	positive
leistungsfördernd	positive
abbauwürdig	positive
stilsicher	positive
stilgerecht	positive
bildschön	positive
geschmackvoll	positive
wunderschön	positive
stilvoll	positive
vitaminarm	negative
eiweissarm	negative
fettarm	negative
fleischarm	negative
wasserarm	negative
kalorienarm	negative
rohstoffarm	negative
auserwählt	positive
erkoren	positive
prädestiniert	positive
auserkoren	positive
vorbestimmt	positive
akzeptabel	positive
genehm	positive
lausig	negative
schäbig	negative
abgewrackt	negative
vertretbar	positive
hinnehmbar	positive
passabel	positive
annehmbar	positive
verantwortbar	positive
ungeeignet	negative
marktfähig	positive
untauglich	negative
endgeil	positive
spitze	positive
klasse	positive
marktgerecht	positive
marktreif	positive
marktführend	positive
marktbeherrschend	positive
erfolgreich	positive
chancenreich	positive
wehruntauglich	negative
verkehrsuntauglich	negative
perspektivreich	positive
vielversprechend	positive
aussichtsreich	positive
siegreich	positive
stümperhaft	negative
fündig	positive
zukunftsfähig	positive
erfolgsverwöhnt	positive
erfolgsgewöhnt	positive
dilettantisch	negative
verheissungsvoll	positive
gewinnbar	positive
förderungswürdig	positive
verlockend	positive
neuwertig	positive
qualitätsvoll	positive
qualitätvoll	positive
wertig	positive
amateurhaft	negative
ungeschlagen	positive
unbesiegt	positive
wegweisend	positive
zukunftsträchtig	positive
zukunftweisend	positive
zukunftsweisend	positive
laienhaft	negative
fehlerhaft	negative
widrig	negative
lebensfeindlich	negative
hochklassig	positive
grandios	positive
meisterhaft	positive
meisterlich	positive
grossartig	positive
gekonnt	positive
famos	positive
fulminant	positive
kunstfertig	positive
virtuos	positive
wettbewerbsfähig	positive
konkurrenzfähig	positive
idyllisch	positive
hervorragend	positive
herausragend	positive
vortrefflich	positive
vorzüglich	positive
bestechend	positive
anrüchig	negative
unprofessionell	negative
ungünstig	negative
chancenlos	negative
unedel	negative
glücklos	negative
zweckfrei	negative
unvorteilhaft	negative
unzweckmässig	negative
ungut	negative
zwecklos	negative
mistig	negative
oll	negative
ätzend	negative
ineffektiv	negative
ergebnislos	negative
grottig	negative
misslungen	negative
grauslich	negative
strafwürdig	negative
grottenschlecht	negative
amoralisch	negative
miserabel	negative
unschön	negative
leid	negative
missraten	negative
malerisch	positive
arkadisch	positive
druckfähig	positive
erlebbar	positive
reaktionsfähig	positive
mischbar	positive
waffenfähig	positive
singbar	positive
magnetisierbar	positive
lagerfähig	positive
tanzbar	positive
kombinierbar	positive
börsenfähig	positive
bespielbar	positive
beihilfefähig	positive
erstattungsfähig	positive
panzerbrechend	positive
teilbar	positive
anrechnungsfähig	positive
erlernbar	positive
abzugsfähig	positive
geländegängig	positive
lötfähig	positive
wünschenswert	positive
sensationell	positive
märchenhaft	positive
glückreich	positive
traumhaft	positive
zweckmässig	positive
elefantös	positive
überragend	positive
erstrebenswert	positive
himmlisch	positive
paradiesisch	positive
herrlich	positive
gelungen	positive
wunderbar	positive
geraten	positive
wundervoll	positive
sinnvoll	positive
sinnreich	positive
sinnhaft	positive
sinnig	positive
sagenhaft	positive
berauschend	positive
gehoben	positive
begrüssenswert	positive
gutartig	positive
herzensgut	positive
perfekt	positive
prima	positive
unfehlbar	positive
okay	positive
erstklassig	positive
bedenkenswert	positive
spitzenmässig	positive
erfolgversprechend	positive
ideal	positive
unübertrefflich	positive
ergebnisreich	positive
ehrenvoll	positive
blendend	positive
erfolg versprechend	positive
unsinnig	negative
absurd	negative
abstrus	negative
irrwitzig	negative
hirnrissig	negative
aberwitzig	negative
sinnlos	negative
erlaucht	positive
ausgesucht	positive
auserlesen	positive
ausersehen	positive
deformiert	negative
unförmig	negative
zerbeult	negative
verformt	negative
uneinholbar	positive
unnachahmlich	positive
unübertroffen	positive
unerreicht	positive
wohlgeformt	positive
griffig	positive
wohl geformt	positive
brauchbar	positive
nutzbar	positive
verarbeitbar	positive
verwertbar	positive
bedienbar	positive
erweiterbar	positive
erweiterungsfähig	positive
ausbaufähig	positive
aufladbar	positive
auswertbar	positive
benutzbar	positive
erneuerbar	positive
nachrüstbar	positive
skalierbar	positive
renovierbar	positive
internetfähig	positive
speicherbar	positive
abbaubar	positive
praktikabel	positive
erschliessbar	positive
netzwerkfähig	positive
instandsetzbar	positive
anbaufähig	positive
handlich	positive
schmelzbar	positive
schmiedbar	positive
recyclingfähig	positive
bearbeitbar	positive
kompostierbar	positive
wiederverwertbar	positive
benutzerfreundlich	positive
anwenderfreundlich	positive
wiederaufladbar	positive
gebrauchsfähig	positive
regenerativ	positive
gerichtsverwertbar	positive
froh gestimmt	positive
frohgestimmt	positive
märchen	positive
volksmärchen	positive
kunstmärchen	positive
zaubermärchen	positive
nervtötend	negative
erfolg	positive
meisterleistung	positive
kabinettstückchen	positive
glanzleistung	positive
nonplusultra	positive
fahndungserfolg	positive
teilerfolg	positive
achtungserfolg	positive
behandlungserfolg	positive
charterfolg	positive
turniererfolg	positive
heilerfolg	positive
kinoerfolg	positive
überraschungserfolg	positive
publikumserfolg	positive
riesenerfolg	positive
verkaufserfolg	positive
welterfolg	positive
medaillenerfolg	positive
fortune	positive
anfangserfolg	positive
therapierfolg	positive
lernerfolg	positive
vereinserfolg	positive
zuchterfolg	positive
unstimmig	negative
erleichtert	positive
vergnügt	positive
heilfroh	positive
lebensfroh	positive
lebenslustig	positive
fröhlich	positive
lebensbejahend	positive
quietschvergnügt	positive
ausgelassen	positive
euphorisch	positive
beruhigt	positive
feuchtfröhlich	positive
humorvoll	positive
lustbetont	positive
lustvoll	positive
humorig	positive
befreit	positive
erlöst	positive
übermütig	positive
überschäumend	positive
überbordend	positive
legendär	positive
legendenhaft	positive
wahrheit	positive
halbwahrheit	positive
armselig	negative
elendig	negative
erbärmlich	negative
elend	negative
drittklassig	negative
zweitklassig	negative
viertklassig	negative
jämmerlich	negative
kümmerlich	negative
widerwärtig	negative
widerlich	negative
dienlich	positive
exploit	positive
beschissen	negative
traumatisierend	negative
schnöde	negative
flugtauglich	positive
wunder	positive
mythisch	positive
auferstehung	positive
himmelfahrt	positive
auferweckung	positive
wiederauferstehung	positive
wählbar	positive
verwerten	positive
verschrotten	positive
abwracken	positive
popelig	negative
poplig	negative
herausfordernd	negative
ehrlos	negative
unehrenhaft	negative
kampfeslustig	negative
verleumderisch	negative
angriffslustig	negative
gehässig	negative
provokativ	negative
forsch	negative
schnoddrig	negative
kampflustig	negative
vaterlandslos	negative
unrühmlich	negative
ungezogen	negative
vorlaut	negative
aggressiv	negative
provozierend	negative
beleidigend	negative
unfreundlich	negative
unverfroren	negative
impertinent	negative
bissig	negative
vollmundig	negative
hetzerisch	negative
ausfallend	negative
aufwiegelnd	negative
undankbar	negative
offensiv	negative
aufhetzend	negative
zynisch	negative
höhnisch	negative
draufgängerisch	negative
kriegerisch	negative
schnippisch	negative
demagogisch	negative
streitlustig	negative
scharfzüngig	negative
unverschämt	negative
sträflich	negative
selbstironisch	negative
marktschreierisch	negative
ironisch	negative
sarkastisch	negative
tadelnswert	negative
grosskotzig	negative
lautstark	negative
zänkisch	negative
zanksüchtig	negative
streitsüchtig	negative
wichtigtuerisch	negative
prahlerisch	negative
grossspurig	negative
prätentiös	negative
ehrverletzend	negative
grossmäulig	negative
angeberisch	negative
schikanös	negative
ehrrührig	negative
denunziatorisch	negative
ehrenrührig	negative
miesepetrig	negative
muffelig	negative
barsch	negative
griesgrämig	negative
charakterlos	negative
bescheiden	negative
spitzfindig	negative
spöttisch	negative
spitz	negative
unwürdig	negative
würdelos	negative
lustig	positive
verschmitzt	positive
schelmisch	positive
schalkhaft	positive
lausbübisch	positive
possenhaft	positive
lausbubenhaft	positive
burlesk	positive
scherzhaft	positive
effektiv	positive
entwürdigend	negative
froh	positive
freudig	positive
erfreulich	positive
erquicklich	positive
traumatisch	negative
unerreichbar	positive
überragen	positive
anspruchslos	negative
übermächtig	positive
flugfähig	positive
ruchbar	negative
genügsam	negative
verlebt	negative
nervig	negative
ekelerregend	negative
ekel erregend	negative
gesucht	positive
unfair	negative
bettelarm	negative
bitterarm	negative
schelm	positive
schalk	positive
subjektiv	negative
voreingenommen	negative
bestechlich	negative
intersubjektiv	negative
parteiisch	negative
korrupt	negative
tendenziös	negative
käuflich	negative
rechtslastig	negative
linkslastig	negative
eifrig	positive
fleissig	positive
emsig	positive
servil	positive
geschäftstüchtig	positive
betriebsam	positive
diensteifrig	positive
tüchtig	positive
arbeitsam	positive
geschäftig	positive
agil	positive
gelehrig	positive
tugendlich	positive
beflissen	positive
tugendreich	positive
arbeitsfreudig	positive
ehrenhaft	positive
tugendhaft	positive
übereifrig	positive
untadelig	positive
rechtschaffen	positive
untadlig	positive
redlich	positive
arbeitswillig	positive
eilfertig	positive
lebenstüchtig	positive
lieb	positive
liebenswürdig	positive
liebenswert	positive
gütig	positive
liebesfähig	positive
liebevoll	positive
liebreich	positive
zärtlich	positive
lobenswert	positive
glorreich	positive
ruhmvoll	positive
löblich	positive
rühmlich	positive
ruhmreich	positive
gnädig	positive
verzeihend	positive
huldreich	positive
preiswürdig	positive
bravourös	positive
anerkennenswert	positive
achtbar	positive
ehrenwert	positive
ehrbar	positive
ehrsam	positive
fair	positive
gerecht	positive
honorig	positive
honorabel	positive
honett	positive
friedliebend	positive
friedlich	positive
friedfertig	positive
friedvoll	positive
unblutig	positive
gutmütig	positive
sanftmütig	positive
barmherzig	positive
gutherzig	positive
grossherzig	positive
ungerecht	negative
drollig	positive
amüsant	positive
vergnüglich	positive
leidig	negative
niedlich	positive
herzig	positive
putzig	positive
goldig	positive
possierlich	positive
knuffig	positive
glanzvoll	positive
tatkräftig	positive
phänomenal	positive
unfähig	negative
unbegabt	negative
untalentiert	negative
erwerbsunfähig	negative
dienstunfähig	negative
beziehungsunfähig	negative
arbeitsunfähig	negative
manövrierunfähig	negative
schuldunfähig	negative
ausserstande	negative
lebensunfähig	negative
kampfunfähig	negative
bewegungsunfähig	negative
haftunfähig	negative
berufsunfähig	negative
unzurechnungsfähig	negative
handlungsunfähig	negative
flugunfähig	negative
unterstützend	positive
subsidiär	positive
mannschaftsdienlich	positive
mannschaftstauglich	positive
dahinterstehend	positive
unverhältnismässig	negative
unziemlich	negative
unstandesgemäss	negative
ungerechtfertigt	negative
unerhört	negative
unwahr	negative
ungehörig	negative
unangemessen	negative
inadäquat	negative
verfehlt	negative
verkehrt	negative
vorgetäuscht	negative
fälschlich	negative
gespielt	negative
irrtümlich	negative
vermeintlich	negative
gelogen	negative
unzuständig	negative
unbillig	negative
erlogen	negative
gefälscht	negative
unbefugt	negative
unsachgemäss	negative
angeblich	negative
unecht	negative
irregulär	negative
unrecht	negative
grundfalsch	negative
unkorrekt	negative
irrig	negative
unautorisiert	negative
unberechtigt	negative
umgekehrt	negative
illegitim	negative
unrechtmässig	negative
trügerisch	negative
unpassend	negative
unangebracht	negative
täuschend	negative
sinnentstellend	negative
sachfremd	negative
korrekturbedürftig	negative
ungelegen	negative
kontrafaktisch	negative
unzutreffend	negative
irritierend	negative
verwirrend	negative
deplaziert	negative
irreführend	negative
fehlleitend	negative
deplatziert	negative
kleidsam	positive
taugen	positive
unbegründet	negative
spassig	positive
spasshaft	positive
unverdient	negative
vorgeschoben	negative
fadenscheinig	negative
süss	positive
süsslich	positive
zuckersüss	positive
tatsache	positive
fact	positive
faktum	positive
binsenweisheit	positive
binsenwahrheit	positive
fakt	positive
grundlos	negative
edelmütig	positive
unbescholten	positive
geringwertig	negative
prunk	positive
beruhigen	positive
begöschen	positive
einlullen	positive
beschwichtigen	positive
abwiegeln	positive
besänftigen	positive
begütigen	positive
trösten	positive
übel	negative
edel	positive
experimentierfreudig	positive
findig	positive
unternehmungslustig	positive
abenteuerlustig	positive
vergnügungsorientiert	positive
freizeitorientiert	positive
furchtbar	negative
fürchterlich	negative
scheusslich	negative
entsetzlich	negative
abscheulich	negative
verabscheuungswürdig	negative
schrecklich	negative
tragisch	negative
feingeschnitten	positive
fein geschnitten	positive
witzig	positive
traum	positive
alptraum	positive
klartraum	positive
tagtraum	positive
albtraum	positive
lebenstraum	positive
wunschtraum	positive
träumerei	positive
verbraucht	negative
glänzend	positive
schillernd	positive
schimmernd	positive
changierend	positive
hochglänzend	positive
goldglänzend	positive
auserwählen	positive
blumenpracht	positive
mau	negative
achtsam	positive
gesetzt	positive
seriös	positive
klotzig	negative
klobig	negative
pracht	positive
zutreffend	positive
sinngemäss	positive
sinngetreu	positive
flau	negative
echt	positive
originalgetreu	positive
urtümlich	positive
unverfälscht	positive
werkgetreu	positive
verzerrungsfrei	positive
stilecht	positive
urig	positive
massstabsgerecht	positive
urwüchsig	positive
wirklichkeitsgetreu	positive
winkeltreu	positive
flor	positive
sinn	positive
gerechtigkeitsgefühl	positive
gerechtigkeitssinn	positive
geschäftssinn	positive
realitätssinn	positive
rechtssinn	positive
ordnungssinn	positive
familiensinn	positive
bürgersinn	positive
berechtigt	positive
saukomisch	positive
urkomisch	positive
ulkig	positive
sieg	positive
aktiv	positive
kämpferisch	positive
aufrichtig	positive
aufrecht	positive
flugbereit	positive
nichtig	negative
läppisch	negative
chance	positive
dankbar	positive
treffsicher	positive
lauter	positive
tugend	positive
kardinaltugend	positive
ordnungsliebend	positive
siegchance	positive
gewinnchance	positive
moderat	positive
massvoll	positive
allegro	positive
allegretto	positive
förmlich	positive
penibel	positive
pedantisch	positive
medaillenaussichten	positive
meisterschaftschance	positive
titelchance	positive
medaillenchance	positive
treffend	positive
trefflich	positive
sorgsam	positive
ehrlich	positive
stümper	negative
gelingen	positive
lachhaft	positive
glattgehen	positive
glatt gehen	positive
gutgehen	positive
gut gehen	positive
trefferchance	positive
torchance	positive
unmusikalisch	negative
konkordant	positive
konform	positive
verwachsen	negative
heiter	positive
leichtfüssig	positive
fidel	positive
unbeschwert	positive
froh gelaunt	positive
launig	positive
gut aufgelegt	positive
gutgelaunt	positive
gut gelaunt	positive
frohgelaunt	positive
frohgemut	positive
aufgeräumt	positive
heilungschance	positive
erfolgschance	positive
erfolgsaussicht	positive
überlebenschance	positive
sexy	positive
reinlich	positive
effekt	positive
verehrungswürdig	positive
hehr	positive
distinguiert	positive
himmel	positive
würdevoll	positive
schwindlig	negative
schmalzig	negative
boshaft	negative
niederträchtig	negative
viele	positive
vielerlei	positive
allerlei	positive
mancherlei	positive
tückisch	negative
aufgebraucht	negative
objektiv	positive
methodisch	positive
generalstabsmässig	positive
wissenschaftsmethodisch	positive
hermeneutisch	positive
induktiv	positive
deduktiv	positive
empirisch	positive
offensichtlichkeit	positive
unverdorben	positive
frank	positive
arbeitsfreude	positive
arbeitswille	positive
böse	negative
vorgeblich	negative
opportun	positive
angebracht	positive
verarmt	negative
eignen	positive
prädestinieren	positive
frommen	positive
nutzlos	negative
nichtsnutzig	negative
unnützlich	negative
sternhimmel	positive
sternenhimmel	positive
wolkenhimmel	positive
nordhimmel	positive
frühjahrshimmel	positive
abendhimmel	positive
südhimmel	positive
dezemberhimmel	positive
mittagshimmel	positive
herbsthimmel	positive
dämmerungshimmel	positive
nachthimmel	positive
tageshimmel	positive
frühlingshimmel	positive
westhimmel	positive
gewitterhimmel	positive
taghimmel	positive
morgenhimmel	positive
winterhimmel	positive
osthimmel	positive
föhnhimmel	positive
sommerhimmel	positive
fixsternhimmel	positive
ordentlich	positive
säuberlich	positive
formen	positive
zivil	positive
zweck	positive
verwendungszweck	positive
selbstzweck	positive
rechtsgefühl	positive
insolvent	negative
zahlungsunfähig	negative
abgebrannt	negative
schutzzweck	positive
verteidigungszweck	positive
geschäftszweck	positive
studienzweck	positive
behuf	positive
repräsentationszweck	positive
demonstrationszweck	positive
testzweck	positive
versuchszweck	positive
unterrichtszweck	positive
erholungszweck	positive
werbezweck	positive
vereinszweck	positive
marketingzweck	positive
einsatzzweck	positive
kriegszweck	positive
forschungszweck	positive
trainingszweck	positive
heilzweck	positive
wohnzweck	positive
propagandazweck	positive
lehrzweck	positive
übungszweck	positive
dokumentationszweck	positive
hauptzweck	positive
heizzweck	positive
vergleichszweck	positive
ausbildungszweck	positive
anwendungszweck	positive
glückstrahlend	positive
erhaben	positive
sorgfältig	positive
ernsthaft	positive
rosig	positive
verbrauchen	negative
arglistig	negative
heimtückisch	negative
gewalttätig	negative
elefant	positive
kriegselefant	positive
afrikanischer elefant	positive
indischer elefant	positive
mammut	positive
konsumieren	negative
abnutzen	negative
drogen nehmen	negative
reinziehen	negative
verkonsumieren	negative
passend	positive
naturgetreu	positive
massgerecht	positive
mundgerecht	positive
artgerecht	positive
massgeschneidert	positive
artgemäss	positive
massstabsgetreu	positive
massstäblich	positive
kindgerecht	positive
kindgetreu	positive
kindgemäss	positive
flächentreu	positive
stimmig	positive
abgestimmt	positive
hervorragen	positive
wettbewerb	positive
süffisant	negative
mephistophelisch	negative
hasserfüllt	negative
stiefmütterlich	negative
teuflisch	negative
dämonisch	negative
luziferisch	negative
diabolisch	negative
satanisch	negative
hämisch	negative
böswillig	negative
maliziös	negative
bösartig	negative
firmament	positive
recyclen	positive
recyceln	positive
wiederverwenden	positive
wertlos	negative
dahergelaufen	negative
aufbrauchen	negative
stümperin	negative
blank	negative
blankgeputzt	negative
blitzeblank	negative
gewienert	negative
blitzblank	negative
tragikomisch	positive
