sinnlich	positive
schlecht	negative
nachtragend	negative
gütig	positive
lieb	positive
ärgerlich	negative
unbeschreiblich	negative
unüberprüfbar	negative
fleischlich	positive
zornig	negative
liebesfähig	positive
schwach	negative
liebenswürdig	positive
böse	negative
phantastisch	positive
andantino	negative
liebevoll	positive
prima	positive
unsagbar	negative
schön	positive
liebenswert	positive
fantastisch	positive
verzeihend	positive
schnell	positive
wütend	negative
unbeschreibbar	negative
träge	negative
stark	positive
undurchschaubar	negative
hübsch	positive
liebreich	positive
kompliziert	negative
gemächlich	negative
nett	positive
gnädig	positive
träg	negative
unsäglich	negative
hervorragend	positive
andante	negative
langweilig	negative
schlimm	negative
grimmig	negative
sympathisch	positive
intensiv	positive
grossartig	positive
transusig	negative
hochgradig	positive
huldreich	positive
tranig	negative
schwierig	negative
schrecklich	negative
langsam	negative
stockend	negative
bildhübsch	positive
zärtlich	positive
unkontrollierbar	negative
dumm	negative
unaussprechlich	negative
verheerend	negative
katastrophal	negative
vernichtend	negative
radikal	positive
extrem	positive
tiefsinnig	positive
eilig	positive
voreilig	positive
tiefgehend	positive
dringend	positive
dringlich	positive
sintflutartig	negative
tiefreichend	positive
hintersinnig	positive
wolkenbruchartig	negative
ernstlich	positive
tiefschürfend	positive
tiefgründig	positive
gründlich	positive
hastig	positive
tiefgreifend	positive
hintergründig	positive
vorschnell	positive
unaufschiebbar	positive
abgründig	positive
profund	positive
subtil	positive
schmählich	negative
schmachvoll	negative
linksextrem	positive
linksextremistisch	positive
linksradikal	positive
rechtsextremistisch	positive
rechtsradikal	positive
rechtsextrem	positive
reiflich	positive
sublim	positive
eklig	negative
arg	negative
blass	negative
bleich	negative
vielschichtig	negative
komplex	negative
beziehungsreich	negative
hochkomplex	negative
verwaschen	negative
schmuck	positive
dekorativ	positive
schmuckvoll	positive
reichverziert	positive
reich verziert	positive
stilsicher	positive
stilgerecht	positive
bildschön	positive
geschmackvoll	positive
wunderschön	positive
stilvoll	positive
begriffsstutzig	negative
verzwickt	negative
verwünscht	negative
hochkompliziert	negative
verzwackt	negative
vermaledeit	negative
vertrackt	negative
verflucht	negative
verflixt	negative
fluchtartig	positive
flink	positive
kometenhaft	positive
wieselflink	positive
verstärkt	positive
trottelhaft	negative
idiotenhaft	negative
idiotisch	negative
trottelig	negative
blitzschnell	positive
blitzartig	positive
sekundenschnell	positive
rasant	positive
explosionsartig	positive
ruckartig	positive
betont	positive
verzögerungslos	positive
ausgesprochen	positive
nahtlos	positive
emphatisch	positive
akzentuiert	positive
hervorgehoben	positive
zügig	positive
reflexhaft	positive
geschwind	positive
hurtig	positive
pfeilschnell	positive
superschnell	positive
galoppierend	positive
schnellwüchsig	positive
rapide	positive
schnellfüssig	positive
rapid	positive
reflexartig	positive
saudumm	negative
dusslig	negative
doof	negative
tumb	negative
töricht	negative
saudoof	negative
saublöd	negative
debil	negative
dusselig	negative
blöd	negative
geistesschwach	negative
unterbelichtet	negative
dämlich	negative
strohdumm	negative
ignorant	negative
schwachsinnig	negative
einfältig	negative
dull	negative
strohdoof	negative
durchsetzungsfähig	positive
streitbar	positive
schlagkräftig	positive
durchschlagskräftig	positive
selbstbewusst	positive
selbstsicher	positive
keck	positive
schlagfertig	positive
kess	positive
gewaltig	positive
druckvoll	positive
überhart	positive
kopfballstark	positive
unbezähmbar	positive
unvermindert	positive
überstark	positive
gefestigt	positive
konfliktfähig	positive
verkehrsarm	negative
verkehrsschwach	negative
lichtschwach	negative
entscheidungsschwach	negative
rauchschwach	negative
finanzschwach	negative
willensschwach	negative
weinerlich	negative
wirtschaftsschwach	negative
leistungsschwach	negative
nervenschwach	negative
einkommensschwach	negative
mitgliederschwach	negative
umsatzschwach	negative
farbschwach	negative
fehlbar	negative
geburtenschwach	negative
charakterschwach	negative
strukturschwach	negative
verkaufsschwach	negative
unauffallend	negative
unbeobachtet	negative
unbeachtet	negative
unbemerkt	negative
verstohlen	negative
unscheinbar	negative
unverdächtig	negative
unspektakulär	negative
ungesehen	negative
unerkannt	negative
ungehört	negative
unauffällig	negative
dezent	negative
totalitär	positive
schwer erziehbar	negative
gemeingefährlich	negative
schwererziehbar	negative
zurückhaltend	negative
niedlich	positive
goldig	positive
herzig	positive
possierlich	positive
putzig	positive
knuffig	positive
diktatorisch	positive
erbittert	negative
famos	positive
fulminant	positive
unberechenbar	negative
unkalkulierbar	negative
vorzüglich	positive
bestechend	positive
vortrefflich	positive
süss	positive
süsslich	positive
zuckersüss	positive
auffallend	positive
wohlgeformt	positive
griffig	positive
wohl geformt	positive
belämmert	negative
behämmert	negative
bescheuert	negative
unaufdringlich	negative
reserviert	negative
zurückgezogen	negative
spröde	negative
menschenscheu	negative
spröd	negative
kontaktarm	negative
drollig	positive
beknackt	negative
erzürnt	negative
ruchbar	negative
bitterböse	negative
erbost	negative
grandios	positive
herausragend	positive
distanziert	negative
evolutionistisch	positive
marxistisch-leninistisch	positive
sexistisch	positive
doktrinär	positive
fanatisch	positive
dogmatisch	positive
fundamentalistisch	positive
ideologisch	positive
extremistisch	positive
technokratisch	positive
bürokratisch	positive
hochklassig	positive
hochgespannt	positive
missvergnügt	negative
angefressen	negative
unbefriedigt	negative
unzufrieden	negative
traumatisierend	negative
scheiss	negative
kreideweiss	negative
kalkweiss	negative
unversöhnlich	negative
schleppend	negative
gebleicht	negative
verblasst	negative
ausgebleicht	negative
hervorstechend	positive
ausgeprägt	positive
markant	positive
verdächtig	positive
beachtet	positive
ostentativ	positive
demonstrativ	positive
provokant	positive
suspekt	positive
tückisch	negative
schadenfroh	negative
schurkisch	negative
garstig	negative
fies	negative
mies	negative
gemein	negative
diabolisch	negative
satanisch	negative
teuflisch	negative
dämonisch	negative
hasserfüllt	negative
bösartig	negative
stiefmütterlich	negative
hämisch	negative
süffisant	negative
luziferisch	negative
mephistophelisch	negative
böswillig	negative
maliziös	negative
begreifen	negative
arglistig	negative
heimtückisch	negative
hinterhältig	negative
höllisch	positive
mörderisch	positive
markig	positive
facettenreich	negative
traumatisch	negative
infam	negative
perfid	negative
perfide	negative
durchtrieben	negative
hinterlistig	negative
hinterfotzig	negative
sterbenslangweilig	negative
stinklangweilig	negative
inhaltsarm	negative
geisttötend	negative
nichtssagend	negative
nichts sagend	negative
ermüdend	negative
pikiert	negative
eingeschnappt	negative
gekränkt	negative
beleidigt	negative
feige	negative
feig	negative
technokrat	positive
bürokrat	positive
chauvinistisch	positive
vorwurfsvoll	negative
unerotisch	negative
reizlos	negative
übel	negative
boshaft	negative
niederträchtig	negative
bös	negative
neuwertig	positive
qualitätsvoll	positive
qualitätvoll	positive
wertig	positive
fuchsteufelswild	negative
empört	negative
fuchsig	negative
indigniert	negative
entrüstet	negative
geharnischt	negative
aufgebracht	negative
geschockt	negative
fassungslos	negative
entsetzt	negative
schockiert	negative
entgeistert	negative
gelähmt	negative
paralysiert	negative
lahm	negative
gehbehindert	negative
technokratin	positive
bürokratin	positive
verärgert	negative
säuerlich	negative
sauer	negative
kernig	positive
nationalistisch	positive
prekär	negative
problemvoll	negative
heikel	negative
verfänglich	negative
knifflig	negative
problematisch	negative
unbegreiflich	negative
unbegreifbar	negative
unverständlich	negative
unfassbar	negative
unerklärbar	negative
unerfindlich	negative
unerklärlich	negative
unergründlich	negative
prächtig	positive
prachtvoll	positive
prunkvoll	positive
pompös	positive
prunkhaft	positive
entwürdigend	negative
zorn	negative
auffällig	positive
verletzt	negative
machtvoll	positive
flau	negative
dogmatiker	positive
dornig	negative
erbittern	negative
mau	negative
furchtbar	negative
fürchterlich	negative
scheusslich	negative
entsetzlich	negative
abscheulich	negative
verabscheuungswürdig	negative
tragisch	negative
exzessiv	positive
aromatisch	positive
brutal	positive
wut	negative
jähzorn	negative
zerstörungswut	negative
volkszorn	negative
dogmatikerin	positive
diebisch	negative
sexy	positive
widerstandsfähig	positive
unverwüstlich	positive
winterhart	positive
konditionsstark	positive
kraftvoll	positive
feingeschnitten	positive
fein geschnitten	positive
ermüden	negative
ideologe	positive
unakzeptabel	negative
inakzeptabel	negative
erfolglos	negative
empörend	negative
unannehmbar	negative
himmelschreiend	negative
unvertretbar	negative
danebengegangen	negative
schiefgegangen	negative
fehlgeschlagen	negative
schiefgelaufen	negative
unverrichtet	negative
lausig	negative
schäbig	negative
abgewrackt	negative
ungeeignet	negative
untauglich	negative
wehruntauglich	negative
verkehrsuntauglich	negative
stümperhaft	negative
dilettantisch	negative
amateurhaft	negative
laienhaft	negative
fehlerhaft	negative
widrig	negative
lebensfeindlich	negative
zweckfrei	negative
unzweckmässig	negative
zwecklos	negative
mistig	negative
oll	negative
ätzend	negative
anrüchig	negative
unprofessionell	negative
chancenlos	negative
unedel	negative
glücklos	negative
ineffektiv	negative
ergebnislos	negative
grauslich	negative
strafwürdig	negative
grottenschlecht	negative
amoralisch	negative
leid	negative
ungünstig	negative
unvorteilhaft	negative
ungut	negative
grottig	negative
misslungen	negative
miserabel	negative
unschön	negative
missraten	negative
naseweis	positive
vorwitzig	positive
einprägsam	positive
prägnant	positive
vital	positive
schwindlig	negative
brisant	negative
unübersehbar	positive
verzögerung	positive
zeitverzögerung	positive
lieferverzögerung	positive
trainiert	positive
fit	positive
rage	negative
schleppen	negative
hochwertig	positive
belastungsfähig	positive
belastbar	positive
nervenstark	positive
monoton	negative
eintönig	negative
unsinnig	negative
stechend	positive
beissend	positive
absurd	negative
abstrus	negative
irrwitzig	negative
hirnrissig	negative
aberwitzig	negative
sinnlos	negative
durchtrainiert	positive
farblos	negative
fahl	negative
aschfahl	negative
sehnig	positive
drahtig	positive
erschlaffen	negative
abschlaffen	negative
muskulös	positive
muskelbepackt	positive
mächtig	positive
allmächtig	positive
omnipotent	positive
einflussreich	positive
finanzkräftig	positive
finanzstark	positive
imperial	positive
wirkungsreich	positive
wirkmächtig	positive
wirkungsmächtig	positive
umsatzstark	positive
kampfstark	positive
spielstark	positive
tonangebend	positive
robust	positive
verblichen	negative
flucht	positive
brenzlig	negative
panisch	negative
panikartig	negative
uninteressant	negative
hervorragen	positive
diktatur	positive
totalitarismus	positive
nazidiktatur	positive
militärdiktatur	positive
ns-diktatur	positive
franco-diktatur	positive
sed-diktatur	positive
verworren	negative
verwoben	negative
lädiert	negative
entzündet	negative
vereitert	negative
schwerverwundet	negative
eiternd	negative
wund	negative
krankenhausreif	negative
blessiert	negative
eitrig	negative
verschorft	negative
schwerverletzt	negative
unstimmig	negative
abgehärtet	positive
wuchtig	positive
betonen	positive
wetterfest	positive
alterungsbeständig	positive
winterfest	positive
korrosionsbeständig	positive
hitzebeständig	positive
säurefest	positive
lichtecht	positive
farbecht	positive
kochfest	positive
temperaturbeständig	positive
kältebeständig	positive
reissfest	positive
rhythmisieren	positive
akzentuieren	positive
pointieren	positive
formen	positive
kränken	negative
unbesiegbar	positive
unschlagbar	positive
ermatten	negative
beschissen	negative
beleidigen	negative
brachial	positive
mitleidslos	positive
schonungslos	positive
blutrünstig	positive
gnadenlos	positive
handgreiflich	positive
militant	positive
erbarmungslos	positive
rüde	positive
tätlich	positive
rüd	positive
infernal	negative
erbosen	negative
wucht	positive
gewalttätig	positive
