glücklich	positive
ausgezeichnet	positive
hochklassig	positive
korrekt	positive
gut	positive
richtiggehend	positive
positiv	positive
richtig	positive
hochwertig	positive
regelrecht	positive
exzellent	positive
preussisch	positive
überlegen	positive
schön	positive
nett	positive
gewissenhaft	positive
ekelerregend	negative
hässlich	negative
unaufrichtig	negative
verarmt	negative
arm	negative
niederträchtig	negative
böse	negative
negativ	negative
ruchbar	negative
unglücklich	negative
ekel erregend	negative
nervig	negative
übel	negative
boshaft	negative
unrichtig	negative
gemein	negative
lästig	negative
schwindlig	negative
geringwertig	negative
ekelhaft	negative
falsch	negative
schlecht	negative
minderwertig	negative
bös	negative
