übermütig	positive
sinnlich	positive
freudig	positive
verlustieren	positive
demonstrationsobjekt	positive
töten	negative
edel	positive
gemein	negative
geheimnisverrat	negative
unzüchtig	negative
lachen	positive
nachtragend	negative
hinterlistig	negative
lieben	positive
begehrt	positive
beschädigt	negative
unappetitlich	negative
saus	positive
vergewaltigen	negative
passioniert	positive
froh gestimmt	positive
erklagen	negative
lieblingsobjekt	positive
vierschrötig	negative
gütig	positive
hoffnung	positive
ausklagen	negative
verderben	negative
behaglich	positive
verschlagen	negative
jubeln	positive
mangelhaft	negative
verrucht	negative
ehrlich	positive
lieb	positive
vergehen	negative
nächstenliebe	positive
leidlich	positive
enthusiastisch	positive
arrogant	negative
fettig	negative
lumpig	negative
schadenfroh	negative
glücklichkeit	positive
verbrecherisch	negative
krieg	negative
unbeschreiblich	negative
freundlich	positive
zerrüttet	negative
hinterhältig	negative
verlogen	negative
effektiv	positive
hass	negative
unüberprüfbar	negative
frohgestimmt	positive
lauschig	positive
verworfen	negative
fleischlich	positive
lebensfroh	positive
ungepflegt	negative
schätzen	positive
zerstören	negative
lamentieren	negative
gewagt	negative
superstimmung	positive
enzymdefekt	negative
schimpfen	negative
sicherheitsgefährdend	negative
goldschatz	positive
liebesfähig	positive
pickelig	negative
entstellt	negative
liebenswürdig	positive
unattraktiv	negative
humorvoll	positive
friedensgefährdend	negative
dekadent	negative
erträglich	positive
genusssüchtig	negative
komfortabel	positive
taktvoll	positive
allerbeste	positive
schurkisch	negative
begeistert	positive
entzücken	positive
galant	positive
unkeusch	negative
übel	negative
liebevoll	positive
lustbetont	positive
jugendgefährdend	negative
hoffnungsfunke	positive
unsittlich	negative
murren	negative
domschatz	positive
hochzufrieden	positive
unsagbar	negative
faszinierend	positive
wehklagen	negative
anständig	positive
liederlich	negative
einladend	positive
erleichtert	positive
verwerflich	negative
schön	positive
liebenswert	positive
lieblingsschauspieler	positive
erfreulich	positive
verzeihend	positive
paradedisziplin	positive
unehrlich	negative
ertragbar	positive
brillant	positive
ungeschützt	negative
vernichten	negative
hölle	negative
lustvoll	positive
fest	positive
ausgelassen	positive
amüsieren	positive
obsessiv	positive
wütend	negative
gut	positive
zuvorkommend	positive
brüderlichkeit	positive
unfein	negative
präferenz	positive
fabelhaft	positive
humorig	positive
lieblingsmusik	positive
vergnügt	positive
aufrichtig	positive
gesundheitsgefährdend	negative
mord	negative
lichtblick	positive
unästhetisch	negative
vergnügen	positive
scheisse	negative
motivieren	positive
empört	negative
lügnerisch	negative
erholung	positive
befreit	positive
gesprächsbereit	positive
unbeschreibbar	negative
frohlocken	positive
renovierungsbedürftig	negative
lächeln	positive
schrottreif	negative
fürsorglich	positive
lebenslustig	positive
kirchenschatz	positive
empören	negative
plebejisch	negative
unverständlich	negative
fröhlich	positive
heilfroh	positive
freuen	positive
undurchschaubar	negative
verbrechen	negative
listig	negative
ramponiert	negative
erquicklich	positive
gammelig	negative
garstig	negative
verklagen	negative
kaputt	negative
verkommen	negative
liebreich	positive
gemütlich	positive
verdorben	negative
blasphemisch	negative
kompliziert	negative
hässlich	negative
vorzeigeobjekt	positive
überschäumend	positive
misslingen	negative
frevlerisch	negative
gendefekt	negative
schwesterlichkeit	positive
nett	positive
glücklich	positive
erfahrungsschatz	positive
hoffnungsschimmer	positive
freude	positive
lieblingssache	positive
geruhsam	positive
elegant	positive
potthässlich	negative
entartet	negative
beeumeln	positive
ladehemmung	negative
risikobehaftet	negative
verlottert	negative
schatz	positive
sanierungsbedürftig	negative
einklagen	negative
problematisch	negative
zerissen	negative
unaufrichtig	negative
reparaturbedürftig	negative
wehrkraftzersetzung	negative
affäre	negative
missbrauch	negative
gnädig	positive
zufrieden	positive
wassergefährdend	negative
liebe	positive
zerlumpt	negative
ausgezeichnet	positive
zernichten	negative
gefährdend	negative
qualitätvoll	positive
entgegenkommend	positive
kardinaltugend	positive
gefährlich	negative
unsäglich	negative
korrosiv	negative
rassenhass	negative
zumutbar	positive
hervorragend	positive
anbeten	positive
intrigant	negative
staatsschatz	positive
sündhaft	negative
irreführend	negative
unansehnlich	negative
vernichtet	negative
vorliebe	positive
ausrotten	negative
klagen	negative
vergammelt	negative
unschicklich	negative
perforiert	negative
bodenschatz	positive
geschwisterliebe	positive
verärgert	negative
wünschen	positive
hochverrat	negative
fröhlichkeit	positive
betrügen	negative
idealistisch	positive
heuchlerisch	negative
erheiterung	positive
abgerissen	negative
ölig	negative
zerlöchert	negative
jammern	negative
tugend	positive
beölen	positive
höflich	positive
beliebt	positive
froh	positive
grossartig	positive
kompromissbereit	positive
verlumpt	negative
lebenstrieb	positive
güte	positive
bezaubernd	positive
euphorisch	positive
gotteslästerlich	negative
staatsgefährdend	negative
feindlich	negative
hoffnungsstrahl	positive
fies	negative
historischer krieg	negative
falsch	negative
lebensbejahend	positive
ungesichert	negative
huldreich	positive
jubel	positive
defekt	negative
erlöst	positive
zotig	negative
erstaunlich	positive
wohnlich	positive
gewalt	negative
verwahrlost	negative
lästerlich	negative
frohsinn	positive
diskret	positive
bequem	positive
gammlig	negative
eingefallen	negative
schadhaft	negative
begeisterung	positive
quietschvergnügt	positive
sündig	negative
schmuddelig	negative
einwandfrei	positive
heruntergekommen	negative
bombenstimmung	positive
judenfeindlichkeit	negative
schrecklich	negative
judenhass	negative
riskant	negative
schwärmerisch	positive
ungeschlacht	negative
unanständig	negative
überbordend	positive
betrug	negative
attraktiv	positive
aushaltbar	positive
zärtlich	positive
angenehm	positive
lasterhaft	negative
unkontrollierbar	negative
beruhigt	positive
eros	positive
unmoralisch	negative
verschwitzt	negative
dumm	negative
unaussprechlich	negative
berühmt	positive
landesverrat	negative
hassen	negative
unbeliebt	negative
erfreuen	positive
lieblingsfarbe	positive
zerstört	negative
feuchtfröhlich	positive
verrat	negative
strähnig	negative
mies	negative
grobschlächtig	negative
risikoreich	negative
lieblingsschauspielerin	positive
sittenlos	negative
ungehobelt	negative
wüst	negative
aggressiv	negative
vergöttern	positive
verdammt	negative
luderhaft	negative
glimpflich	positive
schimmelig	negative
seelig	positive
verschimmelt	negative
überglücklich	positive
glückselig	positive
ungetrübt	positive
lebensgefährlich	negative
bedrohlich	negative
lebensbedrohend	negative
lebensbedrohlich	negative
selbstliebe	positive
vaterlandsliebe	positive
befriedigend	positive
gottesliebe	positive
schmeichelhaft	positive
zufriedenstellend	positive
minne	positive
mitmenschlichkeit	positive
mutterliebe	positive
selbstmörderisch	negative
wohlmeinend	positive
seelsorgerlich	positive
schützend	positive
treu sorgend	positive
seelsorglich	positive
wohlwollend	positive
behütend	positive
seelsorgerisch	positive
treusorgend	positive
gutgemeint	positive
letal	negative
tödlich	negative
kichern	positive
ranzig	negative
verfallen	negative
verrottet	negative
verderbt	negative
auslachen	positive
verlachen	positive
gickern	positive
gickeln	positive
torgefährlich	negative
brandgefährlich	negative
existenzbedrohend	negative
hochgefährlich	negative
explosionsgefährlich	negative
gefahrvoll	negative
giggeln	positive
gackern	positive
giggern	positive
vielschichtig	negative
komplex	negative
beziehungsreich	negative
hochkomplex	negative
hübsch	positive
schmuck	positive
dekorativ	positive
bildhübsch	positive
schmuckvoll	positive
reichverziert	positive
reich verziert	positive
fortwünschen	positive
herbeisehnen	positive
wegwünschen	positive
herwünschen	positive
stilsicher	positive
stilgerecht	positive
bildschön	positive
zurückwünschen	positive
geschmackvoll	positive
wunderschön	positive
herbeiwünschen	positive
stilvoll	positive
begriffsstutzig	negative
prusten	positive
loslatzen	positive
verzwickt	negative
verwünscht	negative
loslachen	positive
hochkompliziert	negative
losbrüllen	positive
verzwackt	negative
feixen	positive
vermaledeit	negative
auflachen	positive
vertrackt	negative
losplatzen	positive
herausplatzen	positive
verflucht	negative
losprusten	positive
verflixt	negative
enthaupten	negative
verfügungsgewalt	negative
waffengewalt	negative
polizeigewalt	negative
legislativgewalt	negative
heftigkeit	negative
amtsgewalt	negative
feindeshand	negative
vehemenz	negative
exekutive	negative
herrschaftsgewalt	negative
entscheidungsgewalt	negative
naturgewalt	negative
hoheitsgewalt	negative
judikative	negative
regierungsgewalt	negative
kameradschaftlich	positive
freundschaftlich	positive
partnerschaftlich	positive
dekaptieren	negative
dekapitieren	negative
anschnauben	negative
anknurren	negative
anblasen	negative
anzischen	negative
anfauchen	negative
anblaffen	negative
anschnauzen	negative
schnarren	negative
anschnarren	negative
sechstagekrieg	negative
falklandkrieg	negative
sonderbundskrieg	negative
vietnamkrieg	negative
bosnienkrieg	negative
burgunderkrieg	negative
zulukrieg	negative
vietnam-krieg	negative
markgrafenkrieg	negative
jugoslawienkrieg	negative
koreakrieg	negative
golfkrieg	negative
palästinakrieg	negative
kroatienkrieg	negative
perserkrieg	negative
bruderkrieg	negative
pazifikkrieg	negative
hussitenkrieg	negative
balkankrieg	negative
burenkrieg	negative
winterkrieg	negative
irakkrieg	negative
kosovokrieg	negative
indianerkrieg	negative
gären	negative
erschiessen	negative
erstechen	negative
trottelhaft	negative
idiotenhaft	negative
idiotisch	negative
trottelig	negative
vergären	negative
erdolchen	negative
suizidieren	negative
selbst töten	negative
leutselig	positive
magenfreundlich	positive
hautfreundlich	positive
wohlgesonnen	positive
kumpelhaft	positive
gesinnt	positive
bedienungsfreundlich	positive
jovial	positive
kundenfreundlich	positive
wartungsfreundlich	positive
investitionsfreundlich	positive
wohlgesinnt	positive
leserfreundlich	positive
entleiben	negative
religionskrieg	negative
abkanzeln	negative
giften	negative
anscheissen	negative
zusammenstauchen	negative
runtermachen	negative
anranzen	negative
deckeln	negative
heruntermachen	negative
runterputzen	negative
fluchen	negative
motzen	negative
herunterkanzeln	negative
abkapiteln	negative
heiliger krieg	negative
dschihad	negative
saudumm	negative
dusslig	negative
doof	negative
tumb	negative
töricht	negative
modern	negative
vermodern	negative
saudoof	negative
saublöd	negative
debil	negative
dusselig	negative
verrotten	negative
blöd	negative
geistesschwach	negative
unterbelichtet	negative
dämlich	negative
strohdumm	negative
ignorant	negative
schwachsinnig	negative
einfältig	negative
dull	negative
strohdoof	negative
rassistisch	negative
ausländerfeindlich	negative
xenophob	negative
fremdenfeindlich	negative
antisemitisch	negative
judenfeindlich	negative
familienfeindlich	negative
schwulenfeindlich	negative
umbringen	negative
dahinraffen	negative
massakrieren	negative
erschlagen	negative
niederstechen	negative
abschlachten	negative
abmurksen	negative
hinwegraffen	negative
niedermetzeln	negative
totschlagen	negative
hinmorden	negative
ertränken	negative
ersäufen	negative
ermorden	negative
feindselig	negative
feindschaftlich	negative
homophob	negative
kinderfeindlich	negative
angriffskrieg	negative
präventivkrieg	negative
christenfeindlich	negative
regimefeindlich	negative
republikfeindlich	negative
gesellschaftsfeindlich	negative
behindertenfeindlich	negative
minderheitenfeindlich	negative
kaiserfeindlich	negative
religionsfeindlich	negative
männerfeindlich	negative
technikfeindlich	negative
fortschrittsfeindlich	negative
parteifeindlich	negative
wissenschaftsfeindlich	negative
reformfeindlich	negative
demokratiefeindlich	negative
volksfeindlich	negative
kunstfeindlich	negative
kirchenfeindlich	negative
regierungsfeindlich	negative
deutschfeindlich	negative
islamfeindlich	negative
israelfeindlich	negative
leibfeindlich	negative
antiklerikal	negative
bildungsfeindlich	negative
antideutsch	negative
menschenfeindlich	negative
kulturfeindlich	negative
umweltfeindlich	negative
lustfeindlich	negative
körperfeindlich	negative
staatsfeindlich	negative
verfassungsfeindlich	negative
geistfeindlich	negative
frauenfeindlich	negative
amtsmissbrauch	negative
machtmissbrauch	negative
kindesmissbrauch	negative
kolonialkrieg	negative
vernichtungskrieg	negative
sachsenkrieg	negative
bandenkrieg	negative
partisanenkrieg	negative
weltkrieg	negative
kleinkrieg	negative
eroberungskrieg	negative
luftkrieg	negative
bürgerkrieg	negative
glaubenskrieg	negative
bombenkrieg	negative
ringkrieg	negative
koalitionskrieg	negative
seekrieg	negative
opiumkrieg	negative
handelskrieg	negative
atomkrieg	negative
grenzkrieg	negative
befreiungskrieg	negative
grabenkrieg	negative
krimkrieg	negative
fortsetzungskrieg	negative
landkrieg	negative
sezessionskrieg	negative
stammeskrieg	negative
blitzkrieg	negative
abnutzungskrieg	negative
bauernkrieg	negative
stellvertreterkrieg	negative
revolutionskrieg	negative
unabhängigkeitskrieg	negative
stellungskrieg	negative
verteidigungskrieg	negative
städtekrieg	negative
einigungskrieg	negative
klonkrieg	negative
freiheitskrieg	negative
erbfolgekrieg	negative
zweifrontenkrieg	negative
gebirgskrieg	negative
behandlungsgut	positive
kulturgut	positive
gemeingut	positive
sammlungsgut	positive
rüstungsgut	positive
gefahrgut	positive
investitionsgut	positive
versorgungsgut	positive
massenstückgut	positive
volksgut	positive
liedgut	positive
massengut	positive
obszön	negative
ordinär	negative
vulgär	negative
tadellos	positive
ausätschen	positive
niedlich	positive
goldig	positive
herzig	positive
possierlich	positive
putzig	positive
knuffig	positive
schamlos	negative
faible	positive
drollig	positive
preisgekrönt	positive
zauberhaft	positive
famos	positive
fulminant	positive
vortrefflich	positive
vorzüglich	positive
bestechend	positive
ruchlos	negative
zerlöchern	negative
perforieren	negative
durchlöchern	negative
einstanzen	negative
exzellent	positive
ätschen	positive
ergötzen	positive
süsslich	positive
zuckersüss	positive
süss	positive
hilfsbereit	positive
grandios	positive
herausragend	positive
abknallen	negative
deformiert	negative
unförmig	negative
zerbeult	negative
verformt	negative
grundübel	negative
unverdorben	positive
frank	positive
wohlgefallen	positive
frivol	negative
anstössig	negative
versagen	negative
scheitern	negative
niederlage	negative
missgeschick	negative
trauerspiel	negative
ungeschick	negative
reinfall	negative
debakel	negative
desaster	negative
armageddon	negative
fiasko	negative
flop	negative
marktversagen	negative
satzverlust	negative
punkteverlust	negative
knock-out	negative
auswärtsniederlage	negative
wahlniederlage	negative
heimniederlage	negative
finalniederlage	negative
abstimmungsniederlage	negative
k.o.-niederlage	negative
schlappe	negative
punktniederlage	negative
kriegsniederlage	negative
knockout	negative
punktverlust	negative
wahlschlappe	negative
betörend	positive
apart	positive
liebreizend	positive
unwiderstehlich	positive
rassig	positive
begehrenswert	positive
adrett	positive
verführerisch	positive
kokett	positive
appetitlich	positive
lieblich	positive
hinreissend	positive
scharmant	positive
charmant	positive
gepflegt	positive
reizend	positive
bezückend	positive
entzückend	positive
grienen	positive
lustig	positive
burlesk	positive
schelmisch	positive
schalkhaft	positive
possenhaft	positive
verschmitzt	positive
lausbubenhaft	positive
lausbübisch	positive
scherzhaft	positive
anstand	positive
verbrecher	negative
anzüglich	negative
beschmunzeln	positive
fehlleistung	negative
vergnügtheit	positive
gefällig	positive
wohlgeformt	positive
griffig	positive
wohl geformt	positive
aufgebracht	negative
geharnischt	negative
schockiert	negative
geschockt	negative
gelähmt	negative
paralysiert	negative
fassungslos	negative
entsetzt	negative
entgeistert	negative
behilflich	positive
konstruktiv	positive
schwäche	positive
fehlsichtigkeit	positive
sehschwäche	positive
weitsichtigkeit	positive
kurzsichtigkeit	positive
nachtblindheit	positive
rotgrünblindheit	positive
farbenblindheit	positive
lese-rechtschreib-schwäche	positive
anfälligkeit	positive
schlaffheit	positive
schlappheit	positive
altersschwäche	positive
rechenschwäche	positive
dyskalkulie	positive
dyslexie	positive
herzschwäche	positive
muskelschwäche	positive
armutszeugnis	positive
bindegewebsschwäche	positive
legasthenie	positive
hinfälligkeit	positive
erbauen	positive
renommiert	positive
pfuscherei	negative
pfusch	negative
pfuschwerk	negative
murks	negative
abschiessen	negative
bejubeln	positive
triumphieren	positive
prunkvoll	positive
pompös	positive
prunkhaft	positive
prachtvoll	positive
prächtig	positive
gefallen	positive
menschenwürdig	positive
menschenfreundlich	positive
inferno	negative
qualitätsvoll	positive
hochklassig	positive
fehlschlag	negative
grinsen	positive
schelm	positive
schalk	positive
anbetung	positive
vergötterung	positive
humanitär	positive
philanthropisch	positive
ungemach	negative
edelmütig	positive
human	positive
menschlich	positive
scharm	positive
charme	positive
faulen	negative
fäulen	negative
link	negative
indigniert	negative
entrüstet	negative
malheur	negative
misserfolg	negative
vertrauenswürdig	positive
unliebsam	negative
missliebig	negative
verhasst	negative
väterlich	positive
mütterlich	positive
grossväterlich	positive
anziehend	positive
schmunzeln	positive
vergnüglich	positive
amüsant	positive
kriegsbegeisterung	positive
fanatismus	positive
enthusiasmus	positive
eingängig	positive
flau	negative
belämmert	negative
behämmert	negative
bescheuert	negative
bärendienst	positive
wohltat	positive
liebesdienst	positive
missvergnügt	negative
unbefriedigt	negative
unzufrieden	negative
angefressen	negative
fehlleitend	negative
hilfreich	positive
verfaulen	negative
mau	negative
freundschaft	positive
fanfreundschaft	positive
völkerfreundschaft	positive
männerfreundschaft	positive
städtefreundschaft	positive
brieffreundschaft	positive
gastfreundschaft	positive
orgiastisch	negative
pfuschen	negative
schiefgehen	negative
floppen	negative
daneben gehen	negative
schief gehen	negative
missraten	negative
danebengehen	negative
schief laufen	negative
fehlschlagen	negative
fehl schlagen	negative
stümpern	negative
dilettieren	negative
schieflaufen	negative
schludern	negative
schlampen	negative
haltbar	positive
hinreissen	positive
liebhaben	positive
spassig	positive
spasshaft	positive
zügellos	negative
fauxpas	negative
aufrecht	positive
atemberaubend	positive
atemraubend	positive
gefälligkeit	positive
infam	negative
perfid	negative
durchtrieben	negative
perfide	negative
hinterfotzig	negative
rodung	negative
abholzung	negative
zerstückelung	negative
zerlegung	negative
abtötung	negative
ausrottung	negative
bücherverbrennung	negative
zerschlagung	negative
aktenvernichtung	negative
ausmerzung	negative
segmentierung	negative
primfaktorzerlegung	negative
entwaldung	negative
waldrodung	negative
brandrodung	negative
kahlschlag	negative
massenmord	negative
massenvernichtung	negative
genozid	negative
völkermord	negative
massaker	negative
blutvergiessen	negative
blutbad	negative
gemetzel	negative
abschlachtung	negative
gemorde	negative
judenvernichtung	negative
beknackt	negative
suizid	negative
selbstmord	negative
selbsttötung	negative
freitod	negative
ritualmord	negative
ehrenmord	negative
fememord	negative
meuchelmord	negative
tyrannenmord	negative
raubmord	negative
judenmord	negative
brudermord	negative
giftmord	negative
lynchmord	negative
auftragsmord	negative
doppelmord	negative
justizmord	negative
enthauptung	negative
kindermord	negative
seppuku	negative
harakiri	negative
beschädigen	negative
zunichtemachen	negative
ätzen	negative
kaputtmachen	negative
einätzen	negative
herausätzen	negative
kleinkriegen	negative
einstampfen	negative
devastieren	negative
randalieren	negative
verheeren	negative
zerfräsen	negative
zerpflügen	negative
auslöschen	negative
zerschiessen	negative
demolieren	negative
verwüsten	negative
zusammenschlagen	negative
zernagen	negative
zerschlitzen	negative
eindellen	negative
verbeulen	negative
versengen	negative
begreifen	negative
hemmungslos	negative
ungezügelt	negative
witzig	positive
weiden	positive
beweiden	positive
abweiden	positive
verherrlichung	positive
beruhigen	positive
patzen	negative
leidenschaftlich	positive
begöschen	positive
einlullen	positive
beschwichtigen	positive
abwiegeln	positive
besänftigen	positive
begütigen	positive
trösten	positive
vermiesen	negative
sexuelle orientierung	positive
homosexueller	positive
homo	positive
schwule	positive
tunte	positive
schwuler	positive
lesbe	positive
homosexualität	positive
päderastie	positive
sadomasochist	positive
pädophiler	positive
heterosexueller	positive
pädophile	positive
sadomasochistin	positive
hetero	positive
heterosexuelle	positive
bisexualität	positive
heterosexualität	positive
lebensgefahr	negative
pikant	negative
verleiden	negative
geehrt	positive
hoch gelobt	positive
umschwärmt	positive
hochgelobt	positive
umworben	positive
viel gepriesen	positive
vielgelobt	positive
viel gerühmt	positive
vergöttert	positive
geliebt	positive
vielgepriesen	positive
gehuldigt	positive
vielgerühmt	positive
gemocht	positive
viel gelobt	positive
verehrt	positive
gelobt	positive
hochverehrt	positive
bewundert	positive
vielgeliebt	positive
gehässig	negative
bissig	negative
zynisch	negative
höhnisch	negative
schnippisch	negative
scharfzüngig	negative
beleidigend	negative
provokativ	negative
herausfordernd	negative
selbstironisch	negative
impertinent	negative
ironisch	negative
undankbar	negative
ehrverletzend	negative
unverschämt	negative
zanksüchtig	negative
streitsüchtig	negative
verleumderisch	negative
unverfroren	negative
sarkastisch	negative
wichtigtuerisch	negative
hetzerisch	negative
grosskotzig	negative
ausfallend	negative
schikanös	negative
grossspurig	negative
prätentiös	negative
denunziatorisch	negative
grossmäulig	negative
angeberisch	negative
provozierend	negative
forsch	negative
schnoddrig	negative
prahlerisch	negative
zänkisch	negative
ungezogen	negative
vorlaut	negative
aufwiegelnd	negative
aufhetzend	negative
draufgängerisch	negative
kriegerisch	negative
demagogisch	negative
streitlustig	negative
offensiv	negative
ehrrührig	negative
ehrenrührig	negative
vollmundig	negative
lautstark	negative
marktschreierisch	negative
facettenreich	negative
arglistig	negative
heimtückisch	negative
panne	negative
autopanne	negative
motorradpanne	negative
fahrradpanne	negative
mopedpanne	negative
radpanne	negative
erhoffen	positive
spitzfindig	negative
spöttisch	negative
agape	positive
skandal	negative
spendenaffäre	negative
liebesaffäre	negative
liaison	negative
techtelmechtel	negative
schmiergeldaffäre	negative
bestechungsaffäre	negative
spionageaffäre	negative
korruptionsaffäre	negative
finanzaffäre	negative
abhöraffäre	negative
spendenskandal	negative
korruptionsskandal	negative
lebensmittelskandal	negative
bestechungsskandal	negative
finanzskandal	negative
wettskandal	negative
dopingskandal	negative
abhörskandal	negative
parteispendenaffäre	negative
parteispendenskandal	negative
unfassbar	negative
unerfindlich	negative
unerklärlich	negative
unergründlich	negative
unerklärbar	negative
ordnungswidrigkeit	negative
vertragsverletzung	negative
dienstvergehen	negative
landfriedensbruch	negative
rechtswidrigkeit	negative
rechtsverstoss	negative
kavaliersdelikt	negative
sakrileg	negative
kameradschaft	positive
pfadfinder	positive
ymca	positive
christlicher verein junger menschen	positive
cvjm	positive
pfadfinderschaft	positive
jungschar	positive
jugendgruppe	positive
kriegsveteranenbund	positive
scout	positive
verschimmeln	negative
heiter	positive
leichtfüssig	positive
fidel	positive
unbeschwert	positive
frohgemut	positive
launig	positive
aufgeräumt	positive
gut gelaunt	positive
frohgelaunt	positive
froh gelaunt	positive
gut aufgelegt	positive
gutgelaunt	positive
spitz	negative
jubilieren	positive
glorifizierung	positive
glorifikation	positive
allegretto	positive
allegro	positive
ruchbar	negative
belieben	positive
neuwertig	positive
wertig	positive
feiern	positive
zelebrieren	positive
zechen	positive
nachfeiern	positive
schwindlig	negative
kreuzzug	negative
fettnäpfchen	negative
verschandeln	negative
urkomisch	positive
saukomisch	positive
ulkig	positive
gewaltverbrecherin	negative
gewalttäter	negative
gewaltverbrecher	negative
gewalttäterin	negative
täterin	negative
straftäter	negative
delinquentin	negative
täter	negative
straftäterin	negative
delinquent	negative
entführerin	negative
entführer	negative
dieb	negative
diebin	negative
langfinger	negative
killerin	negative
mörder	negative
killer	negative
mörderin	negative
attentäterin	negative
attentäter	negative
folterer	negative
folterin	negative
haupttäter	negative
einzeltäterin	negative
brandstifterin	negative
feuerlegerin	negative
selbstmörder	negative
feuerleger	negative
ns-täter	negative
schreibtischtäterin	negative
einzeltäter	negative
selbstmörderin	negative
wiederholungstäterin	negative
schreibtischtäter	negative
ns-täterin	negative
serientäter	negative
wiederholungstäter	negative
serientäterin	negative
brandstifter	negative
peinigerin	negative
peiniger	negative
betrüger	negative
prellerin	negative
preller	negative
betrügerin	negative
autodieb	negative
ladendiebin	negative
meisterdieb	negative
taschendiebin	negative
meisterdiebin	negative
autodiebin	negative
taschendieb	negative
ladendieb	negative
kriegsverbrecher	negative
kriegsverbrecherin	negative
schmugglerin	negative
schmuggler	negative
terrorist	negative
terroristin	negative
frauenmörderin	negative
frauenmörder	negative
folterknecht	negative
kindermörderin	negative
serienkiller	negative
massenmörder	negative
serienmörder	negative
assasine	negative
serienmörderin	negative
kopfgeldjägerin	negative
serienkillerin	negative
massenmörderin	negative
auftragsmörder	negative
kopfgeldjäger	negative
kindermörder	negative
auftragskiller	negative
auftragskillerin	negative
auftragsmörderin	negative
kindesentführer	negative
busentführer	negative
luftpiratin	negative
busentführerin	negative
luftpirat	negative
flugzeugentführer	negative
kidnapper	negative
kindesentführerin	negative
hijackerin	negative
flugzeugentführerin	negative
hijacker	negative
kidnapperin	negative
zechpreller	negative
zechprellerin	negative
falschspieler	negative
falschspielerin	negative
kamikazepilot	negative
kamikazepilotin	negative
selbstmordattentäterin	negative
kamikaze	negative
selbstmordattentäter	negative
geiselnehmer	negative
geiselnehmerin	negative
schädiger	negative
erpresser	negative
rechtsbrecher	negative
kleinkrimineller	negative
schwerverbrecherin	negative
unterdrücker	negative
schleuser	negative
menschenhändlerin	negative
hehler	negative
ns-verbrecher	negative
einbrecherin	negative
pleitier	negative
pimp	negative
gangster	negative
schwerverbrecher	negative
rechtsbrecherin	negative
unterdrückerin	negative
schleuserin	negative
assassine	negative
zuhälter	negative
wegelagerer	negative
bankrotteur	negative
ns-verbrecherin	negative
plündrerin	negative
plünderin	negative
kleinkriminelle	negative
erpresserin	negative
eindringling	negative
lude	negative
naziverbrecherin	negative
plündrer	negative
bankrotteurin	negative
naziverbrecher	negative
plünderer	negative
einbrecher	negative
hehlerin	negative
blaubart	negative
menschenhändler	negative
drogenschmugglerin	negative
hauptkriegsverbrecher	negative
hauptkriegsverbrecherin	negative
drogenschmuggler	negative
topterrorist	negative
minenleger	negative
topterroristin	negative
idealismus	positive
ächzen	negative
verlebt	negative
kuschelig	positive
kuschlig	positive
tückisch	negative
vernichtung	negative
eliminieren	negative
eliminierung	negative
auslöschung	negative
scheinheilig	negative
bigott	negative
schändlich	negative
effekt	positive
kurpfuschen	negative
gewaltverherrlichung	positive
problemvoll	negative
wohltätig	positive
caritativ	positive
mildtätig	positive
karitativ	positive
rechtschaffenheit	positive
fairness	positive
feindseligkeit	negative
glücksgefühl	positive
fuchsteufelswild	negative
zornig	negative
fuchsig	negative
erzürnt	negative
erbittert	negative
verpatzen	negative
wohlig	positive
unterstützend	positive
subsidiär	positive
mannschaftsdienlich	positive
mannschaftstauglich	positive
dahinterstehend	positive
gibbeln	positive
gekicher	positive
geiern	positive
gebibbel	positive
gegeier	positive
missglücken	negative
flaggschiff	positive
dankbar	positive
umkämpft	positive
viel gefragt	positive
vielgefragt	positive
verhunzen	negative
holocaust	negative
scheiss	negative
bedrohen	negative
partnerschaft	positive
paarbeziehung	positive
gemeindepartnerschaft	positive
städtepartnerschaft	positive
sozialpartnerschaft	positive
lebenspartnerschaft	positive
schulpartnerschaft	positive
konkubinat	positive
zerbrechlichkeit	positive
fragilität	positive
gemeingefährlich	negative
schwer erziehbar	negative
schwererziehbar	negative
versägen	negative
verkacken	negative
vergeigen	negative
versemmeln	negative
vermasseln	negative
todesgefahr	negative
verfault	negative
faulig	negative
rassismus	negative
judenfeindschaft	negative
apartheid	negative
antijudaismus	negative
antisemitismus	negative
stöhnen	negative
angriffslustig	negative
kampfeslustig	negative
kampflustig	negative
umgänglich	positive
verpfuschen	negative
verbocken	negative
verkorksen	negative
vermurksen	negative
ungeliebt	negative
mordfall	negative
unverhältnismässig	negative
unziemlich	negative
unstandesgemäss	negative
ungerechtfertigt	negative
unerhört	negative
unwahr	negative
ungehörig	negative
unangemessen	negative
inadäquat	negative
verfehlt	negative
verkehrt	negative
vorgetäuscht	negative
fälschlich	negative
gespielt	negative
irrtümlich	negative
vermeintlich	negative
gelogen	negative
unzuständig	negative
unbillig	negative
erlogen	negative
gefälscht	negative
unbefugt	negative
unsachgemäss	negative
angeblich	negative
unecht	negative
irregulär	negative
unrecht	negative
grundfalsch	negative
unkorrekt	negative
irrig	negative
unautorisiert	negative
unberechtigt	negative
umgekehrt	negative
illegitim	negative
unrechtmässig	negative
trügerisch	negative
unpassend	negative
unangebracht	negative
täuschend	negative
sinnentstellend	negative
sachfremd	negative
korrekturbedürftig	negative
ungelegen	negative
kontrafaktisch	negative
unzutreffend	negative
irritierend	negative
verwirrend	negative
deplaziert	negative
deplatziert	negative
weltberühmt	positive
unkalkulierbar	negative
unberechenbar	negative
verbrecherin	negative
kriminelle	negative
krimineller	negative
räuberin	negative
fesselnd	positive
begeisternd	positive
unbegründet	negative
aufmerksam	positive
unverdient	negative
vorgeschoben	negative
fadenscheinig	negative
holzeinschlag	negative
holzschlag	negative
feingeschnitten	positive
fein geschnitten	positive
lapsus	negative
feig	negative
feige	negative
verve	positive
grundlos	negative
triebverbrecher	negative
sexualverbrecher	negative
sexualverbrecherin	negative
triebverbrecherin	negative
sexualstraftäterin	negative
triebtäter	negative
sexualstraftäter	negative
triebtäterin	negative
mordtat	negative
ermordung	negative
beabsichtigen	positive
hoffen	positive
möchten	positive
zurückwollen	positive
zudenken	positive
erträumen	positive
intendieren	positive
bezwecken	positive
hornhautverkrümmung	positive
stabsichtigkeit	positive
böse	negative
totschlägerin	negative
unschuldig	positive
unversöhnlich	negative
schimmeln	negative
ansprechend	positive
gewinnend	positive
einnehmend	positive
sympathieerweckend	positive
sympathie erweckend	positive
sympathisch	positive
wiehern	positive
ehren	positive
verehren	positive
anhimmeln	positive
huldigen	positive
zerhauen	negative
zerkloppen	negative
wassergüte	positive
wasserqualität	positive
bodenqualität	positive
oberflächengüte	positive
textqualität	positive
gewässergüte	positive
trinkwasserqualität	positive
anteilig	negative
rudimentär	negative
durchbrochen	negative
halb	negative
fragmentarisch	negative
bruchstückhaft	negative
notbehelfsmässig	negative
partiell	negative
notdürftig	negative
teilweise	negative
bruchstückartig	negative
ergänzungsbedürftig	negative
achtzigprozentig	negative
sechzigprozentig	negative
dreissigprozentig	negative
hochprozentig	negative
zwanzigprozentig	negative
fünfprozentig	negative
fünfzigprozentig	negative
siebzigprozentig	negative
neunzigprozentig	negative
zehnprozentig	negative
dienlich	positive
quacksalbern	negative
euthanasie	negative
panisch	negative
panikartig	negative
lachhaft	positive
inbrünstig	positive
verbraucht	negative
fünf	negative
zollen	positive
anfeindung	negative
versieben	negative
gefährden	negative
erfrischung	positive
erfrischen	positive
sonnenbaden	positive
nichtstun	positive
sonnenbad	positive
ausruhen	positive
faulenzen	positive
naherholung	positive
labsal	positive
lebensqualität	positive
zerschlagenheit	positive
mattigkeit	positive
zerteppern	negative
zerdeppern	negative
zertrümmern	negative
zartheit	positive
versauen	negative
klotzig	negative
klobig	negative
frotteurin	negative
vergewaltigerin	negative
kinderschänder	negative
kinderschänderin	negative
vergewaltiger	negative
frotteur	negative
grapscher	negative
grabscher	negative
grapscherin	negative
grabscherin	negative
fummler	negative
fummlerin	negative
destruktion	negative
zerstörung	negative
zertrümmerung	negative
bildersturm	negative
umweltzerstörung	negative
verschrottung	negative
demolition	negative
implosion	negative
kriegszerstörung	negative
verwüstung	negative
sprengzündung	negative
lebensraumzerstörung	negative
abwrackung	negative
ikonoklasmus	negative
selbstentzündung	negative
selbstzerstörung	negative
ritterlich	positive
liebschaft	negative
liebelei	negative
liebesabenteuer	negative
liebesgeschichte	negative
reifenpanne	negative
feindschaft	negative
unbegreiflich	negative
unbegreifbar	negative
höfisch	positive
adlig	positive
adelig	positive
blaublütig	positive
aristokratisch	positive
kaiserlich-königlich	positive
hochadlig	positive
feudalistisch	positive
freiherrlich	positive
hochherrschaftlich	positive
altadelig	positive
feudal	positive
altadlig	positive
kaiserlich	positive
nobel	positive
kleinadelig	positive
königlich	positive
standesherrlich	positive
kleinadlig	positive
royal	positive
hochadelig	positive
erbost	negative
bitterböse	negative
juchzen	positive
jauchzen	positive
überfall	negative
schmuggel	negative
spionagetätigkeit	negative
agententätigkeit	negative
spionage	negative
entführung	negative
menschenhandel	negative
eigentumsdelikt	negative
erpressung	negative
unterlassungssünde	negative
steuerdelikt	negative
verkehrsdelikt	negative
missetat	negative
strassenverkehrsdelikt	negative
untat	negative
betriebsspionage	negative
werksspionage	negative
wirtschaftsspionage	negative
infiltration	negative
firmenspionage	negative
industriespionage	negative
gegenspionage	negative
naziverbrechen	negative
rechtsbeugung	negative
bagatelldelikt	negative
strafsache	negative
tötungsdelikt	negative
hausfriedensbruch	negative
drogendelikt	negative
urheberrechtsverletzung	negative
sittlichkeitsverbrechen	negative
vertragsbruch	negative
verfassungsbruch	negative
kapitalverbrechen	negative
geldwäsche	negative
amoklauf	negative
sexualdelikt	negative
kriegsgräuel	negative
gewaltdelikt	negative
hehlerei	negative
kabale	negative
ränke	negative
kriegsverbrechen	negative
gewaltverbrechen	negative
intrige	negative
sünde	negative
drogenhandel	negative
drogenschmuggel	negative
verkehrsverstoss	negative
verschleppung	negative
deportation	negative
flugzeugentführung	negative
kindesentführung	negative
frauenhandel	negative
hinterziehung	negative
unterschlagung	negative
sklavenhandel	negative
waffenschmuggel	negative
atomschmuggel	negative
menschenschmuggel	negative
schleusung	negative
fahrerflucht	negative
schutzgelderpressung	negative
steuerhinterziehung	negative
heroinhandel	negative
kokainhandel	negative
todesmarsch	negative
raubüberfall	negative
banküberfall	negative
handstreich	negative
stürmung	negative
erstürmung	negative
jugendsünde	negative
todsünde	negative
schandtat	negative
erbsünde	negative
gotteslästerung	negative
blasphemie	negative
mögen	positive
ungefährdet	positive
überzeugt	positive
felsenfest	positive
bombensicher	positive
erhängen	negative
one-night-stand	negative
scharfsinnig	positive
gegrinse	positive
ritterlichkeit	positive
glaubhaftigkeit	positive
sterbehilfe	negative
selbstentblösserin	negative
selbstentblösser	negative
exhibitionistin	negative
exhibitionist	negative
majestätisch	positive
atomisierung	negative
ästimieren	positive
hochachten	positive
würdigen	positive
billigkeit	positive
zerschlagen	negative
gelächter	positive
hochwertig	positive
straucheln	negative
schlecht	negative
totschläger	negative
stranden	negative
ausschweifend	negative
aufgedreht	positive
aufgekratzt	positive
tod	negative
ungehemmt	negative
demontage	negative
schwärmen	positive
prunk	positive
bös	negative
gutherzigkeit	positive
grossmut	positive
übertretung	negative
stolz	positive
integrität	positive
strassenräuberin	negative
banditin	negative
strassenräuber	negative
bandit	negative
grabräuberin	negative
grabräuber	negative
bankräuber	negative
bankräuberin	negative
brigant	negative
gräuel	negative
gräueltat	negative
geeignet	positive
tauglich	positive
verkehrstauglich	positive
verkehrssicher	positive
nutzbringend	positive
nützlich	positive
fahrtauglich	positive
fahrtüchtig	positive
wehrtauglich	positive
wehrfähig	positive
wehrdienstfähig	positive
hochseetüchtig	positive
seetüchtig	positive
geländetauglich	positive
kriegstauglich	positive
diensttauglich	positive
alltagstauglich	positive
praxistauglich	positive
förderlich	positive
fördernd	positive
lohnend	positive
lohnenswert	positive
gedeihlich	positive
verkaufsfördernd	positive
wachstumsfördernd	positive
leistungsfördernd	positive
abbauwürdig	positive
auserkoren	positive
auserwählt	positive
erkoren	positive
prädestiniert	positive
vorbestimmt	positive
akzeptabel	positive
genehm	positive
vertretbar	positive
hinnehmbar	positive
passabel	positive
annehmbar	positive
verantwortbar	positive
marktfähig	positive
spitze	positive
klasse	positive
endgeil	positive
marktgerecht	positive
marktreif	positive
marktbeherrschend	positive
marktführend	positive
erfolgreich	positive
chancenreich	positive
perspektivreich	positive
aussichtsreich	positive
vielversprechend	positive
siegreich	positive
fündig	positive
zukunftsfähig	positive
erfolgsverwöhnt	positive
erfolgsgewöhnt	positive
verheissungsvoll	positive
gewinnbar	positive
förderungswürdig	positive
verlockend	positive
ungeschlagen	positive
unbesiegt	positive
wegweisend	positive
zukunftsträchtig	positive
zukunftweisend	positive
zukunftsweisend	positive
meisterlich	positive
meisterhaft	positive
gekonnt	positive
kunstfertig	positive
virtuos	positive
wettbewerbsfähig	positive
konkurrenzfähig	positive
idyllisch	positive
malerisch	positive
arkadisch	positive
druckfähig	positive
erlebbar	positive
reaktionsfähig	positive
mischbar	positive
waffenfähig	positive
singbar	positive
magnetisierbar	positive
lagerfähig	positive
tanzbar	positive
kombinierbar	positive
börsenfähig	positive
bespielbar	positive
beihilfefähig	positive
erstattungsfähig	positive
panzerbrechend	positive
teilbar	positive
anrechnungsfähig	positive
erlernbar	positive
abzugsfähig	positive
geländegängig	positive
lötfähig	positive
wünschenswert	positive
sensationell	positive
märchenhaft	positive
glückreich	positive
traumhaft	positive
zweckmässig	positive
elefantös	positive
überragend	positive
erstrebenswert	positive
nahestehen	positive
sympathisieren	positive
himmlisch	positive
paradiesisch	positive
herrlich	positive
wunderbar	positive
gelungen	positive
wundervoll	positive
geraten	positive
mattheit	positive
sinnvoll	positive
sinnhaft	positive
sinnig	positive
sinnreich	positive
erfolgversprechend	positive
erfolg versprechend	positive
sagenhaft	positive
berauschend	positive
gehoben	positive
begrüssenswert	positive
gutartig	positive
herzensgut	positive
perfekt	positive
prima	positive
unfehlbar	positive
okay	positive
erstklassig	positive
bedenkenswert	positive
spitzenmässig	positive
ideal	positive
unübertrefflich	positive
ergebnisreich	positive
ehrenvoll	positive
blendend	positive
fragwürdig	negative
erhaben	positive
wohltuend	positive
blumenpracht	positive
luder	negative
geschätzt	positive
pracht	positive
animosität	negative
patzer	negative
schnitzer	negative
inspirieren	positive
zerknallen	negative
schmierig	negative
unvollkommen	negative
lückenhaft	negative
unvollständig	negative
defizitär	negative
zerfurchen	negative
riskieren	negative
verwachsen	negative
bomben	negative
zerbomben	negative
flor	positive
schwafeln	negative
matt	negative
bluttat	negative
quälerei	negative
auspeitschung	negative
seeräuberei	negative
freibeuterei	negative
piraterie	negative
geisselung	negative
ärgerlich	negative
schmachvoll	negative
schmählich	negative
tötung	negative
totschlag	negative
drangsalierung	negative
tierquälerei	negative
schlachtung	negative
massentötung	negative
hausschlachtung	negative
niederreissung	negative
ungerecht	negative
romanze	negative
satanisch	negative
teuflisch	negative
dämonisch	negative
diabolisch	negative
hasserfüllt	negative
stiefmütterlich	negative
luziferisch	negative
mephistophelisch	negative
hämisch	negative
böswillig	negative
maliziös	negative
bösartig	negative
süffisant	negative
komisch	positive
behagen	positive
sanftmut	positive
euphorie	positive
hochgefühl	positive
hochstimmung	positive
wonne	positive
lebensglück	positive
heil	positive
freudentaumel	positive
sexy	positive
rein	positive
pharisäisch	negative
listenreich	negative
fintenreich	negative
trickreich	negative
destruieren	negative
glückstrahlend	positive
zerplatzen	negative
beleidigt	negative
pikiert	negative
eingeschnappt	negative
gekränkt	negative
delikt	negative
rechtsbruch	negative
straftat	negative
gesetzesverstoss	negative
vorhaben	positive
formschön	positive
formvollendet	positive
belangen	negative
mitsollen	positive
verbrennung	negative
hexenverbrennung	negative
selbstverbrennung	negative
sonnenbrand	negative
faul	negative
schmalzig	negative
dünkelhaft	negative
altklug	negative
besserwisserisch	negative
selbstverliebt	negative
blasiert	negative
anmassend	negative
aufgeblasen	negative
eingebildet	negative
lehrerhaft	negative
neunmalklug	negative
siebengescheit	negative
rechthaberisch	negative
oberlehrerhaft	negative
swingerin	positive
seeräuberin	negative
seeräuber	negative
piratin	negative
freibeuter	negative
freibeuterin	negative
pirat	negative
erlaucht	positive
ausgesucht	positive
auserlesen	positive
ausersehen	positive
stumpf	negative
überschwang	positive
aufgebraucht	negative
durchfall	negative
vorwurfsvoll	negative
vitalienbrüder	negative
verehrungswürdig	positive
hehr	positive
entrüsten	negative
stolpern	negative
unnachahmlich	positive
unübertroffen	positive
unerreicht	positive
uneinholbar	positive
hinrichten	negative
exekutieren	negative
geistesgegenwärtig	positive
wachsam	positive
meditativ	positive
reaktionsschnell	positive
versunken	positive
hellhörig	positive
kontemplativ	positive
menschenrechtsverletzung	negative
feten	positive
staunen	positive
lacher	positive
feindschaftlichkeit	negative
dealerin	negative
dealer	negative
drogendealer	negative
drogendealerin	negative
vorgeblich	negative
subjektiv	negative
voreingenommen	negative
tendenziös	negative
intersubjektiv	negative
parteiisch	negative
korrupt	negative
bestechlich	negative
käuflich	negative
rechtslastig	negative
linkslastig	negative
gelitten	positive
kleidsam	positive
normalisieren	positive
übermut	positive
plattfuss	negative
leiden	positive
trauern	positive
darben	positive
herumschleppen	positive
durchleiden	positive
betrauern	positive
grämen	positive
formen	positive
gewalttat	negative
einschläfern	positive
körperverletzung	negative
vorzeigbar	positive
misshandlung	negative
kindesmisshandlung	negative
hinrichtung	negative
überschwänglich	positive
sollen	positive
verworren	negative
verwoben	negative
brauchbar	positive
nutzbar	positive
verarbeitbar	positive
verwertbar	positive
bedienbar	positive
erweiterbar	positive
erweiterungsfähig	positive
ausbaufähig	positive
erneuerbar	positive
aufladbar	positive
auswertbar	positive
benutzbar	positive
nachrüstbar	positive
skalierbar	positive
internetfähig	positive
speicherbar	positive
abbaubar	positive
praktikabel	positive
erschliessbar	positive
netzwerkfähig	positive
anbaufähig	positive
handlich	positive
renovierbar	positive
instandsetzbar	positive
recyclingfähig	positive
wiederverwertbar	positive
schmelzbar	positive
schmiedbar	positive
bearbeitbar	positive
kompostierbar	positive
benutzerfreundlich	positive
anwenderfreundlich	positive
regenerativ	positive
wiederaufladbar	positive
gebrauchsfähig	positive
gerichtsverwertbar	positive
platzen	negative
bersten	negative
detonieren	negative
zerbersten	negative
sauer	negative
säuerlich	negative
brüllen	positive
drogenabhängigkeit	negative
drogenmissbrauch	negative
drogensucht	negative
koffeinmissbrauch	negative
koffeinabhängigkeit	negative
koffeinsucht	negative
sexsucht	negative
arbeitssucht	negative
spielsucht	negative
tablettenabhängigkeit	negative
nikotinsucht	negative
tablettenmissbrauch	negative
nikotinmissbrauch	negative
zigarettenabhängigkeit	negative
nikotinabhängigkeit	negative
tablettensucht	negative
kaffeesucht	negative
kokainsucht	negative
morphiumsucht	negative
kokainabhängigkeit	negative
heroinmissbrauch	negative
heroinabhängigkeit	negative
heroinsucht	negative
kokainmissbrauch	negative
schwierig	negative
wettern	negative
astigmatismus	positive
arroganz	positive
anmassung	positive
selbstherrlichkeit	positive
überheblichkeit	positive
dünkel	positive
selbstgefälligkeit	positive
eitelkeit	positive
standesdünkel	positive
verbrauchen	negative
boshaft	negative
niederträchtig	negative
erlegen	negative
aushängeschild	positive
märchen	positive
oberwasser	positive
volksmärchen	positive
kunstmärchen	positive
zaubermärchen	positive
zeitüberschreitung	negative
transzendenz	negative
übersättigung	negative
hervorragen	positive
vergewaltigung	negative
erfolg	positive
kabinettstückchen	positive
glanzleistung	positive
meisterleistung	positive
nonplusultra	positive
fahndungserfolg	positive
teilerfolg	positive
achtungserfolg	positive
behandlungserfolg	positive
charterfolg	positive
turniererfolg	positive
heilerfolg	positive
kinoerfolg	positive
überraschungserfolg	positive
publikumserfolg	positive
riesenerfolg	positive
verkaufserfolg	positive
welterfolg	positive
medaillenerfolg	positive
fortune	positive
anfangserfolg	positive
therapierfolg	positive
lernerfolg	positive
vereinserfolg	positive
zuchterfolg	positive
strahlen	positive
konsumieren	negative
abnutzen	negative
drogen nehmen	negative
reinziehen	negative
verkonsumieren	negative
erstrahlen	positive
liquidator	negative
verletzt	negative
korsar	negative
zugänglich	positive
erbittern	negative
unfair	negative
einbeulen	negative
verstoss	negative
wut	negative
verfehlung	negative
räuber	negative
höhenflug	positive
aufbrauchen	negative
schlüsselgewalt	negative
mafioso	negative
präferieren	positive
swinger	positive
schimmel	negative
edelschimmel	negative
beleidigen	negative
verdämmern	negative
hereinlegen	negative
hintergehen	negative
kungeln	negative
mauscheln	negative
neppen	negative
übervorteilen	negative
hinwegtäuschen	negative
fremdgehen	negative
hörnen	negative
bluffen	negative
ablinken	negative
behumpsen	negative
behumsen	negative
linken	negative
henken	negative
aufknüpfen	negative
verbauen	negative
wagen	negative
erkühnen	negative
anmassen	negative
erfrechen	negative
erdreisten	negative
einstossen	negative
kabbalistisch	negative
entstellen	negative
verzapfen	negative
ausfressen	negative
zetern	negative
tragikomisch	positive
mogeln	negative
schummeln	negative
betuppen	negative
lächerlich	positive
beschummeln	negative
vergällen	negative
