schlecht	negative
gemein	negative
negativ	negative
unglücklich	negative
ekelhaft	negative
schön	positive
richtig	positive
gut	positive
korrekt	positive
hässlich	negative
nett	positive
glücklich	positive
minderwertig	negative
positiv	positive
ausgezeichnet	positive
lästig	negative
arm	negative
überlegen	positive
falsch	negative
hochwertig	positive
adäquat	positive
angemessen	positive
exzellent	positive
unansehnlich	negative
preisgekrönt	positive
verteufelt	negative
superior	positive
geeignet	positive
entstellt	negative
wahr	positive
schadenfroh	negative
schurkisch	negative
garstig	negative
fies	negative
mies	negative
schlimm	negative
unattraktiv	negative
unästhetisch	negative
vorschriftsmässig	positive
ordnungsgemäss	positive
regelgemäss	positive
regulär	positive
regelgerecht	positive
vorschriftsgemäss	positive
ungepflegt	negative
unappetitlich	negative
schmuddelig	negative
prächtig	positive
prachtvoll	positive
unförmig	negative
befehlsgemäss	positive
wortlautgemäss	positive
normgemäss	positive
bestimmungsgemäss	positive
statutengemäss	positive
wortgemäss	positive
satzungsgemäss	positive
froh gestimmt	positive
frohgestimmt	positive
pickelig	negative
sinnlich	positive
nervtötend	negative
begründet	positive
zufrieden	positive
vierschrötig	negative
ungeschlacht	negative
grobschlächtig	negative
prunkhaft	positive
widerwärtig	negative
widerlich	negative
prunkvoll	positive
pompös	positive
potthässlich	negative
deformiert	negative
verformt	negative
fröhlich	positive
vergnügt	positive
erleichtert	positive
seelig	positive
überglücklich	positive
glückselig	positive
glimpflich	positive
ungetrübt	positive
strähnig	negative
fettig	negative
lebensfroh	positive
lebenslustig	positive
lebensbejahend	positive
heilfroh	positive
lumpig	negative
gammelig	negative
zerlumpt	negative
gammlig	negative
abgerissen	negative
ölig	negative
tauglich	positive
ausgelassen	positive
wahrheitsgemäss	positive
zerbeult	negative
wahrhaftig	positive
wahrhaft	positive
lustbetont	positive
lustvoll	positive
qualitätsvoll	positive
qualitätvoll	positive
neuwertig	positive
wertig	positive
froh	positive
elendig	negative
erbärmlich	negative
armselig	negative
elend	negative
übermächtig	positive
nervig	negative
ekelerregend	negative
ekel erregend	negative
verkommen	negative
verlottert	negative
vergammelt	negative
verlumpt	negative
verwahrlost	negative
verschwitzt	negative
behindertengerecht	positive
wahrheitsgetreu	positive
drittklassig	negative
zweitklassig	negative
viertklassig	negative
unakzeptabel	negative
inakzeptabel	negative
jämmerlich	negative
kümmerlich	negative
angriffslustig	negative
kampfeslustig	negative
kampflustig	negative
aggressiv	negative
hochzufrieden	positive
erfolglos	negative
hübsch	positive
quietschvergnügt	positive
schmuck	positive
dekorativ	positive
wohlgeformt	positive
wohl geformt	positive
nährstoffarm	negative
leidig	negative
provozierend	negative
provokativ	negative
lustig	positive
gehässig	negative
bissig	negative
nutzbringend	positive
nützlich	positive
zweckgemäss	positive
unangemessen	negative
inadäquat	negative
verfehlt	negative
empfehlenswert	positive
ratsam	positive
schnöde	negative
ungerecht	negative
beruhigt	positive
bildschön	positive
stilsicher	positive
stilgerecht	positive
geschmackvoll	positive
wunderschön	positive
stilvoll	positive
unwahr	negative
unpassend	negative
unangebracht	negative
herausfordernd	negative
schmuckvoll	positive
unfair	negative
veritabel	positive
vitaminarm	negative
eiweissarm	negative
fettarm	negative
fleischarm	negative
wasserarm	negative
kalorienarm	negative
rohstoffarm	negative
streitsüchtig	negative
zänkisch	negative
befreit	positive
unautorisiert	negative
unberechtigt	negative
unbefugt	negative
fleischlich	positive
zanksüchtig	negative
vermeintlich	negative
angeblich	negative
unbegründet	negative
bettelarm	negative
bitterarm	negative
erlöst	positive
grundlos	negative
forsch	negative
aufwiegelnd	negative
aufhetzend	negative
draufgängerisch	negative
kriegerisch	negative
demagogisch	negative
streitlustig	negative
hetzerisch	negative
offensiv	negative
verlebt	negative
hochklassig	positive
achtsam	positive
griffig	positive
akzeptabel	positive
ehrlos	negative
unehrenhaft	negative
umweltgerecht	positive
entwicklungsgemäss	positive
differenziert	positive
gebührend	positive
umsichtig	positive
hoffähig	positive
zünftig	positive
begründbar	positive
ausgewogen	positive
nachahmenswert	positive
einvernehmlich	positive
wohlproportioniert	positive
standesgemäss	positive
situationsgerecht	positive
statthaft	positive
praxisgerecht	positive
fachgerecht	positive
gerechtfertigt	positive
sachgerecht	positive
gütlich	positive
sachgemäss	positive
fachgemäss	positive
lausig	negative
schäbig	negative
genehm	positive
voreingenommen	negative
subjektiv	negative
unzutreffend	negative
empörend	negative
unerhört	negative
unbillig	negative
unsachgemäss	negative
ungehörig	negative
unverhältnismässig	negative
unziemlich	negative
unstandesgemäss	negative
ungerechtfertigt	negative
trügerisch	negative
täuschend	negative
berechtigt	positive
ungeeignet	negative
unfreundlich	negative
illegitim	negative
unzuständig	negative
unrechtmässig	negative
unannehmbar	negative
himmelschreiend	negative
unvertretbar	negative
tugendlich	positive
tugendhaft	positive
ordnungsliebend	positive
tugendreich	positive
zynisch	negative
höhnisch	negative
schnippisch	negative
scharfzüngig	negative
endgeil	positive
spitze	positive
klasse	positive
angezeigt	positive
triftig	positive
handfest	positive
unterlegt	positive
wohlbegründet	positive
stichhaltig	positive
fundiert	positive
erfolgreich	positive
chancenreich	positive
bildhübsch	positive
fördernd	positive
verheerend	negative
katastrophal	negative
vernichtend	negative
deplaziert	negative
sachfremd	negative
deplatziert	negative
ungelegen	negative
eifrig	positive
fleissig	positive
tüchtig	positive
arbeitsam	positive
emsig	positive
förderlich	positive
unsinnig	negative
fälschlich	negative
irrtümlich	negative
unecht	negative
irregulär	negative
unrecht	negative
grundfalsch	negative
unkorrekt	negative
irrig	negative
umgekehrt	negative
verkehrt	negative
kontrafaktisch	negative
vorgeschoben	negative
fadenscheinig	negative
unverdient	negative
brauchbar	positive
nutzbar	positive
ehrenhaft	positive
sinnlos	negative
oligotroph	negative
dankbar	positive
sorgsam	positive
stümperhaft	negative
freudig	positive
erfreulich	positive
dilettantisch	negative
pedantisch	positive
penibel	positive
förmlich	positive
echt	positive
humorig	positive
popelig	negative
poplig	negative
unrühmlich	negative
verleumderisch	negative
lohnend	positive
humorvoll	positive
entwürdigend	negative
übermütig	positive
spitzfindig	negative
spöttisch	negative
feingeschnitten	positive
fein geschnitten	positive
konkordant	positive
konform	positive
geringwertig	negative
lohnenswert	positive
fahrstuhlgerecht	positive
rollstuhlgerecht	positive
laienhaft	negative
fehlerhaft	negative
widrig	negative
ruchbar	negative
nichtig	negative
läppisch	negative
spitz	negative
klotzig	negative
klobig	negative
reinlich	positive
wahrheit	positive
verbraucht	negative
tatkräftig	positive
tendenziös	negative
methodisch	positive
abgewrackt	negative
vaterlandslos	negative
zweckentsprechend	positive
irritierend	negative
verwirrend	negative
irreführend	negative
fehlleitend	negative
grandios	positive
meisterhaft	positive
meisterlich	positive
grossartig	positive
verarmt	negative
gedeihlich	positive
würdelos	negative
unwürdig	negative
arbeitsfreudig	positive
arbeitswillig	positive
lieb	positive
sinnentstellend	negative
korrekturbedürftig	negative
überschäumend	positive
euphorisch	positive
überbordend	positive
feuchtfröhlich	positive
absurd	negative
abstrus	negative
heiter	positive
gelogen	negative
erlogen	negative
vorgetäuscht	negative
gespielt	negative
gefälscht	negative
ordentlich	positive
vollmundig	negative
lautstark	negative
vertretbar	positive
lebenstüchtig	positive
geschäftstüchtig	positive
eilfertig	positive
servil	positive
betriebsam	positive
diensteifrig	positive
geschäftig	positive
agil	positive
gelehrig	positive
beflissen	positive
übereifrig	positive
eklig	negative
arg	negative
übel	negative
hervorragend	positive
idyllisch	positive
schiefgelaufen	negative
danebengegangen	negative
unverrichtet	negative
schiefgegangen	negative
fehlgeschlagen	negative
dienlich	positive
herausragend	positive
massvoll	positive
moderat	positive
edel	positive
wissenschaftsmethodisch	positive
bestechlich	negative
korrupt	negative
käuflich	negative
intersubjektiv	negative
parteiisch	negative
beleidigend	negative
furchtbar	negative
fürchterlich	negative
marktführend	positive
marktbeherrschend	positive
pracht	positive
ausfallend	negative
verwachsen	negative
zweckfrei	negative
unvorteilhaft	negative
unzweckmässig	negative
mistig	negative
oll	negative
miserabel	negative
unschön	negative
missraten	negative
ungünstig	negative
ungut	negative
zwecklos	negative
ätzend	negative
grottig	negative
misslungen	negative
unedel	negative
glücklos	negative
ineffektiv	negative
ergebnislos	negative
grauslich	negative
strafwürdig	negative
grottenschlecht	negative
amoralisch	negative
leid	negative
anrüchig	negative
unprofessionell	negative
chancenlos	negative
ironisch	negative
sarkastisch	negative
untadelig	positive
rechtschaffen	positive
untadlig	positive
redlich	positive
passabel	positive
hinnehmbar	positive
annehmbar	positive
auserwählt	positive
prunk	positive
vorbestimmt	positive
erkoren	positive
prädestiniert	positive
auserkoren	positive
untauglich	negative
niederträchtig	negative
boshaft	negative
insolvent	negative
abgebrannt	negative
zahlungsunfähig	negative
glückstrahlend	positive
