anrüchig	negative
unecht	negative
irregulär	negative
wünschenswert	positive
drittklassig	negative
sinnlich	positive
unprofessionell	negative
abgeschlagen	negative
gefällig	positive
mustergültig	positive
unrecht	negative
unangemessen	negative
sagenhaft	positive
vitaminarm	negative
neuwertig	positive
schlecht	negative
edel	positive
gemein	negative
bettelarm	negative
gewissenhaft	positive
nutzbringend	positive
lausig	negative
feingeschnitten	positive
ungünstig	negative
qualitätsvoll	positive
zweitklassig	negative
fair	positive
blank	negative
angriffslustig	negative
froh gestimmt	positive
fälschlich	negative
beispielhaft	positive
regelgemäss	positive
unfreundlich	negative
ordnungsliebend	positive
verschlagen	negative
berauschend	positive
chancenlos	negative
erfolgreich	positive
gutherzig	positive
beknackt	negative
lieb	positive
nützlich	positive
gehoben	positive
begrüssenswert	positive
glimpflich	positive
negativ	negative
friedliebend	positive
unglücklich	negative
peinlich	positive
boshaft	negative
tugendlich	positive
unnütz	negative
bedürftig	negative
schadenfroh	negative
irrtümlich	negative
unedel	negative
gutartig	positive
glücklos	negative
herzensgut	positive
freundlich	positive
verlogen	negative
graziös	positive
frohgestimmt	positive
endgeil	positive
tugendreich	positive
eiweissarm	negative
sensationell	positive
zweckfrei	negative
charakterlos	negative
fettarm	negative
wohlgeformt	positive
sittlich	positive
friedlich	positive
mythisch	positive
fein geschnitten	positive
unvorteilhaft	negative
vorbildlich	positive
perfekt	positive
nutzlos	negative
mau	negative
pickelig	negative
himmlisch	positive
entstellt	negative
unattraktiv	negative
stümperhaft	negative
gerecht	positive
legendär	positive
böse	negative
laienhaft	negative
glückstrahlend	positive
phantastisch	positive
chancenreich	positive
elendig	negative
preisgekrönt	positive
schurkisch	negative
grundfalsch	negative
anmutig	positive
ekelhaft	negative
gewalttätig	negative
gelungen	positive
sinnhaft	positive
prima	positive
unkorrekt	negative
vorbildhaft	positive
unfehlbar	positive
märchenhaft	positive
deformiert	negative
nichtsnutzig	negative
geraten	positive
schön	positive
stilsicher	positive
okay	positive
edelmütig	positive
fantastisch	positive
bös	negative
exzeptionell	positive
eifrig	positive
penibel	positive
glückreich	positive
richtig	positive
imageträchtig	positive
genehm	positive
unzweckmässig	negative
adäquat	positive
vermeintlich	negative
seelig	positive
ungerecht	negative
stilgerecht	positive
idyllisch	positive
pejorativ	negative
verarmt	negative
blutarm	negative
ungut	negative
zwecklos	negative
feinschmeckerisch	positive
sorgsam	positive
grandios	positive
irrig	negative
günstig	positive
erstklassig	positive
gut	positive
matt	negative
mistig	negative
regulär	positive
bedenkenswert	positive
fleischarm	negative
legendenhaft	positive
paradigmatisch	positive
unakzeptabel	negative
bildschön	positive
faul	negative
wasserarm	negative
kampfeslustig	negative
regelrecht	positive
unästhetisch	negative
umgekehrt	negative
ausserordentlich	positive
kampflustig	negative
achtsam	positive
traumhaft	positive
zweckmässig	positive
lügnerisch	negative
bestmöglich	positive
spitzenmässig	positive
erfolgversprechend	positive
leidig	negative
prächtig	positive
grossherzig	positive
spitze	positive
schwindlig	negative
korrekt	positive
viertklassig	negative
übel	negative
unschädlich	positive
nährstoffarm	negative
unfair	negative
herrlich	positive
klasse	positive
geschmackvoll	positive
meisterhaft	positive
unschuldig	positive
fragwürdig	negative
flau	negative
oll	negative
unsinnig	negative
elefantös	positive
erfolglos	negative
insolvent	negative
verformt	negative
nichtig	negative
herausragend	positive
bitterarm	negative
tüchtig	positive
garstig	negative
regelgerecht	positive
hübsch	positive
richtiggehend	positive
hochklassig	positive
arbeitsam	positive
ätzend	negative
verdorben	negative
ruiniert	negative
schädigend	negative
beschissen	negative
hässlich	negative
strahlend	positive
ideal	positive
förmlich	positive
wunderschön	positive
besser	positive
ineffektiv	negative
meisterlich	positive
ordentlich	positive
nett	positive
glücklich	positive
widerwärtig	negative
verdriesslich	negative
fehlerhaft	negative
potthässlich	negative
erbärmlich	negative
minderwertig	negative
prestigeträchtig	positive
pleite	negative
vorschriftsmässig	positive
bescheiden	negative
sinnlos	negative
verlebt	negative
unförmig	negative
unaufrichtig	negative
ordnungsgemäss	positive
eingängig	positive
schmuck	positive
armselig	negative
unübertrefflich	positive
zufrieden	positive
positiv	positive
ekelerregend	negative
ausgezeichnet	positive
ergebnisreich	positive
unwahr	negative
qualitätvoll	positive
zuträglich	positive
kalorienarm	negative
ergebnislos	negative
widrig	negative
exzellent	positive
moralisch	positive
superior	positive
wohl geformt	positive
ekel erregend	negative
paradiesisch	positive
hervorragend	positive
intrigant	negative
unansehnlich	negative
sinnvoll	positive
grottig	negative
tugendhaft	positive
misslungen	negative
brutal	negative
schlimm	negative
ehrenvoll	positive
inadäquat	negative
unnützlich	negative
grauslich	negative
zutreffend	positive
ehrlos	negative
unrichtig	negative
verträglich	positive
lästig	negative
blendend	positive
übermächtig	positive
sinnig	positive
inakzeptabel	negative
kulinarisch	positive
läppisch	negative
kriminell	negative
überglücklich	positive
strafwürdig	negative
froh	positive
elend	negative
arm	negative
grossartig	positive
schäbig	negative
unehrenhaft	negative
anziehend	positive
angeblich	negative
abträglich	negative
optimal	positive
widerlich	negative
grottenschlecht	negative
scheiss	negative
schädlich	negative
überlegen	positive
fies	negative
amoralisch	negative
falsch	negative
fleissig	positive
recht	positive
akzeptabel	positive
wertig	positive
ethisch	positive
dekorativ	positive
hochwertig	positive
schuldig	negative
dilettantisch	negative
erfolg versprechend	positive
überragend	positive
kontrafaktisch	negative
verfehlt	negative
unzutreffend	negative
wahr	positive
miserabel	negative
niederträchtig	negative
erledigt	negative
gutmütig	positive
phänomenal	positive
nervig	negative
pedantisch	positive
link	negative
rohstoffarm	negative
angemessen	positive
nervtötend	negative
aussergewöhnlich	positive
verbraucht	negative
wundervoll	positive
barmherzig	positive
attraktiv	positive
geringwertig	negative
angenehm	positive
prachtvoll	positive
zahlungsunfähig	negative
unschön	negative
stilvoll	positive
leid	negative
emsig	positive
verkehrt	negative
bankrott	negative
ärmlich	negative
fein	positive
wunderbar	positive
mies	negative
verteufelt	negative
ungeeignet	negative
glückselig	positive
schwarz	negative
ungetrübt	positive
abgebrannt	negative
sorgfältig	positive
sinnreich	positive
preussisch	positive
toll	positive
vorschriftsgemäss	positive
missraten	negative
geeignet	positive
aggressiv	negative
