unecht	negative
irregulär	negative
wünschenswert	positive
solide	positive
sinnlich	positive
saudumm	negative
rudimentär	negative
trottelhaft	negative
freudig	positive
dusslig	negative
gefällig	positive
wild	negative
mustergültig	positive
ranzig	negative
unrecht	negative
unangemessen	negative
sagenhaft	positive
schlecht	negative
edel	positive
christenfeindlich	negative
gemein	negative
unzüchtig	negative
missvergnügt	negative
regimefeindlich	negative
nutzbringend	positive
feingeschnitten	positive
indigniert	negative
nachtragend	negative
gefragt	positive
hinterlistig	negative
qualitätsvoll	positive
begehrt	positive
beschädigt	negative
geschätzt	positive
befriedigend	positive
letal	negative
fair	positive
doof	negative
ansprechend	positive
passioniert	positive
angriffslustig	negative
froh gestimmt	positive
fälschlich	negative
belämmert	negative
durchbrochen	negative
republikfeindlich	negative
gehässig	negative
leutselig	positive
beispielhaft	positive
ruchbar	negative
gütig	positive
behaglich	positive
verschlagen	negative
verworren	negative
mangelhaft	negative
verrucht	negative
unberechenbar	negative
berauschend	positive
wohltuend	positive
ehrlich	positive
tumb	negative
erfolgreich	positive
gutherzig	positive
beknackt	negative
lieb	positive
nützlich	positive
gehoben	positive
begrüssenswert	positive
ausländerfeindlich	negative
ärgerlich	negative
ungeliebt	negative
glimpflich	positive
bruchstückhaft	negative
provokativ	negative
friedliebend	positive
magenfreundlich	positive
apart	positive
unbegreiflich	negative
unliebsam	negative
enthusiastisch	positive
arrogant	negative
tugendlich	positive
herausfordernd	negative
menschenwürdig	positive
schwer erziehbar	negative
schadenfroh	negative
irrtümlich	negative
blaublütig	positive
liebreizend	positive
menschenfreundlich	positive
gutartig	positive
verbrecherisch	negative
verfallen	negative
kollegial	positive
herzensgut	positive
forsch	negative
freundlich	positive
zerrüttet	negative
hinterhältig	negative
verlogen	negative
vielschichtig	negative
effektiv	positive
standfest	positive
ansehnlich	positive
graziös	positive
frohgestimmt	positive
verworfen	negative
verzwickt	negative
kameradschaftlich	positive
lebensfroh	positive
endgeil	positive
tugendreich	positive
idiotenhaft	negative
sensationell	positive
gesellschaftsfeindlich	negative
bissig	negative
unwiderstehlich	positive
wohlgeformt	positive
sittlich	positive
friedlich	positive
mythisch	positive
beschränkt	negative
lebensgefährlich	negative
fein geschnitten	positive
vorbildlich	positive
fuchsteufelswild	negative
zornig	negative
perfekt	positive
umkämpft	positive
vergöttert	positive
mau	negative
liebesfähig	positive
pickelig	negative
himmlisch	positive
entstellt	negative
liebenswürdig	positive
unattraktiv	negative
verwünscht	negative
eisenhart	positive
gerecht	positive
legendär	positive
böse	negative
glückstrahlend	positive
behindertenfeindlich	negative
erträglich	positive
komfortabel	positive
phantastisch	positive
taktvoll	positive
chancenreich	positive
allerbeste	positive
preisgekrönt	positive
schurkisch	negative
begeistert	positive
galant	positive
rassig	positive
unkeusch	negative
grundfalsch	negative
anmutig	positive
aristokratisch	positive
freundschaftlich	positive
liebevoll	positive
gelungen	positive
sinnhaft	positive
prima	positive
unkorrekt	negative
bedrohlich	negative
lebensbedrohend	negative
vorbildhaft	positive
unfehlbar	positive
unsittlich	negative
märchenhaft	positive
adlig	positive
minderheitenfeindlich	negative
faszinierend	positive
anständig	positive
töricht	negative
deformiert	negative
erleichtert	positive
geraten	positive
verwerflich	negative
notbehelfsmässig	negative
unvollständig	negative
begeisternd	positive
umschwärmt	positive
schön	positive
kaiserfeindlich	negative
torgefährlich	negative
stilsicher	positive
okay	positive
edelmütig	positive
liebenswert	positive
fantastisch	positive
schimmelig	negative
bös	negative
hochnäsig	negative
erfreulich	positive
exzeptionell	positive
eifrig	positive
glückreich	positive
religionsfeindlich	negative
geliebt	positive
unehrlich	negative
imageträchtig	positive
genehm	positive
ertragbar	positive
begehrenswert	positive
hochkompliziert	negative
männerfeindlich	negative
hetzerisch	negative
technikfeindlich	negative
brillant	positive
steif	positive
vermeintlich	negative
seelig	positive
stilgerecht	positive
idyllisch	positive
hochherrschaftlich	positive
grandios	positive
hautfreundlich	positive
irrig	negative
günstig	positive
vortrefflich	positive
anzüglich	negative
vorzüglich	positive
obsessiv	positive
erstklassig	positive
partiell	negative
wütend	negative
gut	positive
halbherzig	negative
adrett	positive
matt	negative
zuvorkommend	positive
überheblich	negative
bedenkenswert	positive
verschimmelt	negative
verführerisch	positive
aufwiegelnd	negative
fabelhaft	positive
problemvoll	negative
offensiv	negative
unbegreifbar	negative
leidenschaftlich	positive
saudoof	negative
vergnügt	positive
saublöd	negative
legendenhaft	positive
aufrichtig	positive
paradigmatisch	positive
bildschön	positive
faul	negative
debil	negative
kampfeslustig	negative
unästhetisch	negative
umgekehrt	negative
ausserordentlich	positive
kampflustig	negative
wohlgesonnen	positive
komplex	negative
traumhaft	positive
stupid	negative
zweckmässig	positive
empört	negative
bewundert	positive
lügnerisch	negative
bestmöglich	positive
spitzenmässig	positive
fest	positive
fortschrittsfeindlich	negative
erfolgversprechend	positive
brandgefährlich	negative
xenophob	negative
dusselig	negative
prächtig	positive
grossherzig	positive
spitze	positive
kumpelhaft	positive
parteifeindlich	negative
schwindlig	negative
aufhetzend	negative
übel	negative
kokett	positive
unschädlich	positive
tödlich	negative
wissenschaftsfeindlich	negative
herrlich	positive
formell	positive
klasse	positive
reformfeindlich	negative
verzwackt	negative
schrottreif	negative
geschmackvoll	positive
fürsorglich	positive
lebenslustig	positive
meisterhaft	positive
trickreich	negative
draufgängerisch	negative
unschuldig	positive
fragwürdig	negative
ortsfest	positive
human	positive
flau	negative
unverständlich	negative
kriegerisch	negative
viel gefragt	positive
elefantös	positive
unerklärbar	negative
entrüstet	negative
fröhlich	positive
umgänglich	positive
heilfroh	positive
begriffsstutzig	negative
gesinnt	positive
fuchsig	negative
faulig	negative
fesselnd	positive
verformt	negative
herausragend	positive
demokratiefeindlich	negative
volksfeindlich	negative
undurchschaubar	negative
blöd	negative
tüchtig	positive
kunstfeindlich	negative
listig	negative
ramponiert	negative
stupide	negative
garstig	negative
appetitlich	positive
kaputt	negative
unzufrieden	negative
scharmant	positive
unverdorben	positive
infam	negative
hübsch	positive
geistesschwach	negative
perfid	negative
hochklassig	positive
arbeitsam	positive
liebreich	positive
notdürftig	negative
gemütlich	positive
verdorben	negative
kompliziert	negative
kirchenfeindlich	negative
hässlich	negative
regierungsfeindlich	negative
bedienungsfreundlich	positive
hybrid	negative
hart	positive
strahlend	positive
deutschfeindlich	negative
ideal	positive
unterbelichtet	negative
wunderschön	positive
besser	positive
perfide	negative
meisterlich	positive
islamfeindlich	negative
nett	positive
glücklich	positive
gemeingefährlich	negative
dämlich	negative
verfault	negative
jovial	positive
teilweise	negative
geruhsam	positive
feig	negative
betörend	positive
frivol	negative
elegant	positive
israelfeindlich	negative
potthässlich	negative
unflexibel	positive
pharisäisch	negative
prestigeträchtig	positive
risikobehaftet	negative
gelitten	positive
geehrt	positive
schmeichelhaft	positive
renommiert	positive
familienfeindlich	negative
kundenfreundlich	positive
durchtrieben	negative
existenzbedrohend	negative
problematisch	negative
leibfeindlich	negative
zerissen	negative
verlebt	negative
unförmig	negative
unaufrichtig	negative
listenreich	negative
reparaturbedürftig	negative
hochgefährlich	negative
bestechend	positive
stramm	positive
eingängig	positive
schmuck	positive
charismatisch	positive
unübertrefflich	positive
dankbar	positive
zufrieden	positive
positiv	positive
charmant	positive
ausgezeichnet	positive
ergebnisreich	positive
feige	negative
unwahr	negative
unerbittlich	positive
qualitätvoll	positive
entgegenkommend	positive
strohdumm	negative
arglistig	negative
gefährlich	negative
vermaledeit	negative
gemocht	positive
verwoben	negative
zuträglich	positive
partnerschaftlich	positive
stahlhart	positive
vornehm	positive
exzellent	positive
korrosiv	negative
antiklerikal	negative
ästhetisch	positive
schwulenfeindlich	negative
moralisch	positive
dünkelhaft	negative
aufgebracht	negative
unfassbar	negative
schmierig	negative
wohl geformt	positive
paradiesisch	positive
hervorragend	positive
zauberhaft	positive
intrigant	negative
blasiert	negative
defizitär	negative
adelig	positive
irreführend	negative
unansehnlich	negative
lieblich	positive
vernichtet	negative
sinnvoll	positive
tugendhaft	positive
geckenhaft	negative
vertrackt	negative
unbarmherzig	positive
angefressen	negative
zänkisch	negative
unerfindlich	negative
lebensbedrohlich	negative
ehrenvoll	positive
frank	positive
geschmeidig	positive
perforiert	negative
bruchstückartig	negative
zufriedenstellend	positive
inadäquat	negative
druckfest	positive
vorzeigbar	positive
famos	positive
verärgert	negative
fulminant	positive
anmassend	negative
unkalkulierbar	negative
umworben	positive
unrichtig	negative
verträglich	positive
atemberaubend	positive
feindselig	negative
idiotisch	negative
bildungsfeindlich	negative
idealistisch	positive
heuchlerisch	negative
behämmert	negative
antideutsch	negative
blendend	positive
sinnig	positive
wartungsfreundlich	positive
beziehungsreich	negative
zerlöchert	negative
demagogisch	negative
steinhart	positive
abgehoben	negative
bigott	negative
solid	positive
zugänglich	positive
unbeweglich	positive
vielgefragt	positive
höflich	positive
überglücklich	positive
beliebt	positive
froh	positive
verehrt	positive
streitlustig	negative
grossartig	positive
felsenfest	positive
gegeben	positive
verbindlich	positive
feststehend	positive
anziehend	positive
unfertig	negative
menschenfeindlich	negative
angeblich	negative
verrottet	negative
bombensicher	positive
bezaubernd	positive
investitionsfreundlich	positive
ungefährdet	positive
optimal	positive
schwererziehbar	negative
scharfsinnig	positive
feindlich	negative
ungelenk	positive
wohlgesinnt	positive
fremdenfeindlich	negative
altklug	negative
fies	negative
ignorant	negative
verwickelt	negative
falsch	negative
prominent	positive
lebensbejahend	positive
trottelig	negative
fleissig	positive
missliebig	negative
akzeptabel	positive
verflucht	negative
pikant	negative
unvollkommen	negative
schändlich	negative
defekt	negative
aufgeblasen	negative
erstaunlich	positive
heimtückisch	negative
überraschend	positive
lückenhaft	negative
eingebildet	negative
explosionsgefährlich	negative
ethisch	positive
schwierig	negative
dekorativ	positive
kulturfeindlich	negative
hochwertig	positive
erfolg versprechend	positive
überragend	positive
kontrafaktisch	negative
diskret	positive
verfehlt	negative
menschlich	positive
unzutreffend	negative
halb	negative
bequem	positive
fix	positive
verhasst	negative
eingefallen	negative
schadhaft	negative
hinterfotzig	negative
schwachsinnig	negative
überzeugt	positive
unerklärlich	negative
gutmütig	positive
phänomenal	positive
abgelaufen	negative
einwandfrei	positive
anstössig	negative
gepflegt	positive
tadellos	positive
ungelenkig	positive
schrecklich	negative
link	negative
unergründlich	negative
scheinheilig	negative
einfältig	negative
riskant	negative
umweltfeindlich	negative
schwärmerisch	positive
herablassend	negative
hieratisch	positive
sicher	positive
geharnischt	negative
aussergewöhnlich	positive
unversöhnlich	negative
lustfeindlich	negative
unanständig	negative
verbraucht	negative
wundervoll	positive
barmherzig	positive
körperfeindlich	negative
staatsfeindlich	negative
attraktiv	positive
dull	negative
angenehm	positive
verfassungsfeindlich	negative
ergänzungsbedürftig	negative
gefahrvoll	negative
starr	positive
atemraubend	positive
prachtvoll	positive
anteilig	negative
leserfreundlich	positive
unelastisch	positive
unmoralisch	negative
besserwisserisch	negative
fragmentarisch	negative
stilvoll	positive
dumm	negative
emsig	positive
geistfeindlich	negative
berühmt	positive
sonnig	positive
weltberühmt	positive
verkehrt	negative
anerkannt	positive
tückisch	negative
zanksüchtig	negative
unbeliebt	negative
nobel	positive
strohdoof	negative
zerstört	negative
fehlleitend	negative
glühend	positive
kabbalistisch	negative
fein	positive
wunderbar	positive
selbstverliebt	negative
fintenreich	negative
vertrauenswürdig	positive
aufrecht	positive
verderbt	negative
verflixt	negative
mies	negative
rassistisch	negative
bescheuert	negative
erzürnt	negative
glückselig	positive
streitsüchtig	negative
risikoreich	negative
frauenfeindlich	negative
ungetrübt	positive
wohlig	positive
sinnreich	positive
sittenlos	negative
toll	positive
luderhaft	negative
geeignet	positive
immobil	positive
aggressiv	negative
provozierend	negative
feindschaftlich	negative
verdammt	negative
