schlecht	negative
gemein	negative
gewissenhaft	positive
negativ	negative
unglücklich	negative
ekelhaft	negative
schön	positive
richtig	positive
verarmt	negative
gut	positive
regelrecht	positive
schwindlig	negative
korrekt	positive
übel	negative
richtiggehend	positive
hochklassig	positive
hässlich	negative
nett	positive
glücklich	positive
minderwertig	negative
unaufrichtig	negative
positiv	positive
ekelerregend	negative
ausgezeichnet	positive
exzellent	positive
ekel erregend	negative
unrichtig	negative
lästig	negative
arm	negative
überlegen	positive
falsch	negative
hochwertig	positive
nervig	negative
geringwertig	negative
preussisch	positive
