anrüchig	negative
dufte	positive
fade	negative
sinnlich	positive
saudumm	negative
trottelhaft	negative
unprofessionell	negative
knorke	positive
dusslig	negative
abgeschlagen	negative
lichtschwach	negative
verzögerungslos	positive
wild	negative
hämisch	negative
bärenstark	positive
schlecht	negative
gemein	negative
missvergnügt	negative
lausig	negative
uninteressant	negative
feingeschnitten	positive
entwürdigend	negative
indigniert	negative
druckvoll	positive
nachtragend	negative
brenzlig	negative
ungünstig	negative
grau	negative
monoton	negative
überhart	positive
konditionsstark	positive
fluchtartig	positive
reizlos	negative
furchtbar	negative
doof	negative
angriffslustig	negative
lächerlich	negative
belämmert	negative
rasch	positive
blass	negative
mickerig	negative
eilig	positive
memmenhaft	negative
ruchbar	negative
verkehrsarm	negative
gütig	positive
unfreundlich	negative
verworren	negative
grimm	negative
öde	negative
unberechenbar	negative
chancenlos	negative
tumb	negative
beknackt	negative
wuchtig	positive
lieb	positive
stinklangweilig	negative
ärgerlich	negative
muskelbepackt	positive
negativ	negative
übertrieben	positive
altersschwach	negative
unglücklich	negative
peinlich	negative
kraftlos	negative
verheerend	negative
reissend	positive
unbegreiflich	negative
fad	negative
boshaft	negative
unnütz	negative
schmählich	negative
schwer erziehbar	negative
katastrophal	negative
unedel	negative
muskelschwach	negative
glücklos	negative
hinfällig	negative
hinterhältig	negative
vielschichtig	negative
unmässig	positive
eintönig	negative
muskulös	positive
graziös	positive
süffisant	negative
teuflisch	negative
kraftvoll	positive
verzwickt	negative
machtvoll	positive
trainiert	positive
idiotenhaft	negative
zweckfrei	negative
charakterlos	negative
flott	positive
wohlgeformt	positive
dämonisch	negative
beschränkt	negative
fein geschnitten	positive
blitzschnell	positive
unvorteilhaft	negative
fuchsteufelswild	negative
zornig	negative
gebrechlich	negative
unselbständig	negative
nutzlos	negative
zügig	positive
mau	negative
liebesfähig	positive
verloren	negative
schwach	negative
liebenswürdig	positive
entscheidungsschwach	negative
verwünscht	negative
stümperhaft	negative
böse	negative
laienhaft	negative
phantastisch	positive
hündisch	negative
rauchschwach	negative
sympathieerweckend	positive
anmutig	positive
unumschränkt	positive
gewalttätig	negative
kopfballstark	positive
finanzschwach	negative
liebevoll	positive
prima	positive
flink	positive
gekränkt	negative
unbezähmbar	positive
eklig	negative
töricht	negative
nichtsnutzig	negative
schön	positive
schlaff	negative
diabolisch	negative
stilsicher	positive
liebenswert	positive
fantastisch	positive
bös	negative
stabil	positive
willensschwach	negative
erbittert	negative
schnell	positive
unzweckmässig	negative
hochkompliziert	negative
verkehrsschwach	negative
ungerecht	negative
stilgerecht	positive
pejorativ	negative
ungut	negative
zwecklos	negative
sehschwach	negative
prekär	negative
grandios	positive
vortrefflich	positive
temporeich	positive
vorzüglich	positive
vernichtend	negative
wütend	negative
matt	negative
reflexhaft	positive
mistig	negative
geschwind	positive
höllisch	positive
problemvoll	negative
trocken	negative
weinerlich	negative
unbegreifbar	negative
saudoof	negative
morbide	negative
saublöd	negative
unakzeptabel	negative
bildschön	positive
faul	negative
debil	negative
kampfeslustig	negative
schleppend	negative
kampflustig	negative
komplex	negative
stupid	negative
fürchterlich	negative
empört	negative
verletzt	negative
konditionsschwach	negative
bitterböse	negative
dusselig	negative
prächtig	positive
genierlich	negative
gelind	negative
träge	negative
kräftig	positive
selbstständig	positive
selbständig	positive
schwindlig	negative
stark	positive
übel	negative
unsportlich	negative
unfair	negative
böswillig	negative
verzwackt	negative
geschmackvoll	positive
flau	negative
unverständlich	negative
oll	negative
unsinnig	negative
erfolglos	negative
entrüstet	negative
begriffsstutzig	negative
wirtschaftsschwach	negative
fuchsig	negative
herausragend	positive
undurchschaubar	negative
blöd	negative
stupide	negative
unzufrieden	negative
hübsch	positive
maliziös	negative
geistesschwach	negative
hochklassig	positive
beleidigt	negative
liebreich	positive
zart	negative
ätzend	negative
leistungsschwach	negative
schädigend	negative
kompliziert	negative
beschissen	negative
hart	positive
nichtssagend	negative
unterbelichtet	negative
gemächlich	negative
wunderschön	positive
ineffektiv	negative
sterbenslangweilig	negative
unvermindert	positive
diffizil	negative
nett	positive
gemeingefährlich	negative
dämlich	negative
überstark	positive
sauer	negative
feig	negative
hurtig	positive
durchsetzungsfähig	positive
fehlerhaft	negative
erbost	negative
instabil	negative
zäh	positive
nahtlos	positive
kometenhaft	positive
öd	negative
bescheiden	negative
sinnlos	negative
allegro	positive
problematisch	negative
zittrig	negative
hasserfüllt	negative
eklatant	positive
pfeilschnell	positive
bestechend	positive
stramm	positive
schmuck	positive
traumatisch	negative
geisttötend	negative
nervenschwach	negative
hilflos	negative
einkommensschwach	negative
gefestigt	positive
unerträglich	negative
feige	negative
strohdumm	negative
gefährlich	negative
vermaledeit	negative
verwoben	negative
träg	negative
ergebnislos	negative
widrig	negative
superschnell	positive
bleich	negative
selbstbewusst	positive
wohl geformt	positive
blitzartig	positive
hervorragend	positive
konfliktfähig	positive
mitgliederschwach	negative
leicht	negative
sekundenschnell	positive
grottig	negative
misslungen	negative
brutal	positive
vertrackt	negative
andante	negative
sympathie erweckend	positive
angefressen	negative
bösartig	negative
langweilig	negative
schlimm	negative
astrein	positive
galoppierend	positive
immunschwach	negative
genant	negative
ermüdend	negative
unnützlich	negative
schnellwüchsig	positive
famos	positive
verärgert	negative
fulminant	positive
grauslich	negative
umsatzschwach	negative
unkalkulierbar	negative
ehrlos	negative
idiotisch	negative
behämmert	negative
gewaltig	positive
lahm	negative
durchtrainiert	positive
beziehungsreich	negative
inakzeptabel	negative
grimmig	negative
sympathisch	positive
hastig	positive
kriminell	negative
absolut	positive
heikel	negative
untrainiert	negative
schwächlich	negative
intensiv	positive
strafwürdig	negative
unauffällig	negative
satanisch	negative
grossartig	positive
fit	positive
transusig	negative
schäbig	negative
unehrenhaft	negative
anziehend	positive
unauffallend	negative
abträglich	negative
grottenschlecht	negative
schwererziehbar	negative
verstärkt	positive
scheiss	negative
schädlich	negative
masslos	positive
nichts sagend	negative
oberflächlich	negative
absolutistisch	positive
pikiert	negative
amoralisch	negative
ignorant	negative
mächtig	positive
verwickelt	negative
hochgradig	positive
trottelig	negative
tranig	negative
rasant	positive
verflucht	negative
selbstsicher	positive
labil	negative
widerstandsfähig	positive
anfällig	negative
schmachvoll	negative
arg	negative
schwierig	negative
dekorativ	positive
rapide	positive
hochwertig	positive
schuldig	negative
farbschwach	negative
dilettantisch	negative
stiefmütterlich	negative
fehlbar	negative
schnellfüssig	positive
fix	positive
miserabel	negative
eingeschnappt	negative
schwachsinnig	negative
niederträchtig	negative
explosionsartig	positive
schlapp	negative
einförmig	negative
unselbstständig	negative
schrecklich	negative
rapid	positive
einfältig	negative
langsam	negative
sicher	positive
geburtenschwach	negative
unversöhnlich	negative
souverän	positive
stockend	negative
kernig	positive
attraktiv	positive
bildhübsch	positive
dull	negative
getragen	negative
brisant	negative
zärtlich	positive
prachtvoll	positive
unschön	negative
gefährdet	negative
stilvoll	positive
leid	negative
eigenständig	positive
dumm	negative
mörderisch	positive
tückisch	negative
traumatisierend	negative
heftig	positive
strohdoof	negative
charakterschwach	negative
reflexartig	positive
fein	positive
strukturschwach	negative
dornig	negative
verflixt	negative
gelinde	negative
grantig	negative
ungeeignet	negative
bescheuert	negative
erzürnt	negative
schwarz	positive
knifflig	negative
verkaufsschwach	negative
missraten	negative
aggressiv	negative
