schnöde	negative
anrüchig	negative
geschäftsschädigend	negative
unecht	negative
irregulär	negative
drittklassig	negative
rudimentär	negative
unprofessionell	negative
abgeschlagen	negative
ranzig	negative
hämisch	negative
unrecht	negative
unangemessen	negative
unsympathisch	negative
vitaminarm	negative
schlecht	negative
gemein	negative
bettelarm	negative
gewissenhaft	positive
lausig	negative
entwürdigend	negative
unerquicklich	negative
ungünstig	negative
zweitklassig	negative
anoxisch	negative
furchtbar	negative
angriffslustig	negative
froh gestimmt	positive
unbefriedigend	negative
fälschlich	negative
durchbrochen	negative
leutselig	positive
ruchbar	negative
regelgemäss	positive
gütig	positive
unfreundlich	negative
ordnungsliebend	positive
verschlagen	negative
mangelhaft	negative
chancenlos	negative
unangenehm	negative
lieb	positive
schade	negative
glimpflich	positive
misslich	negative
negativ	negative
bruchstückhaft	negative
dürftig	negative
unglücklich	negative
peinlich	positive
verheerend	negative
jämmerlich	negative
magenfreundlich	positive
unbequem	negative
boshaft	negative
unnütz	negative
bedürftig	negative
menschenwürdig	positive
schadenfroh	negative
irrtümlich	negative
katastrophal	negative
kärglich	negative
unedel	negative
menschenfreundlich	positive
glücklos	negative
verfallen	negative
kollegial	positive
bedauernswert	negative
freundlich	positive
verlogen	negative
frohgestimmt	positive
süffisant	negative
teuflisch	negative
verworfen	negative
kameradschaftlich	positive
unkomfortabel	negative
eiweissarm	negative
zweckfrei	negative
charakterlos	negative
fettarm	negative
verbessernd	positive
beängstigend	negative
dämonisch	negative
unvorteilhaft	negative
nutzlos	negative
mau	negative
liebesfähig	positive
pickelig	negative
entstellt	negative
liebenswürdig	positive
unattraktiv	negative
stümperhaft	negative
böse	negative
laienhaft	negative
glückstrahlend	positive
hündisch	negative
elendig	negative
preisgekrönt	positive
schurkisch	negative
grundfalsch	negative
bedrückend	negative
ekelhaft	negative
freundschaftlich	positive
liebevoll	positive
unkorrekt	negative
gekränkt	negative
eklig	negative
deformiert	negative
nichtsnutzig	negative
verwerflich	negative
notbehelfsmässig	negative
unvollständig	negative
nachrangig	negative
diabolisch	negative
liebenswert	positive
schimmelig	negative
bös	negative
umweltschädlich	negative
penibel	positive
richtig	positive
stachlig	negative
unzweckmässig	negative
seelig	positive
ungerecht	negative
pejorativ	negative
verarmt	negative
blutarm	negative
ungut	negative
zwecklos	negative
sorgsam	positive
hautfreundlich	positive
irrig	negative
partiell	negative
vernichtend	negative
halbherzig	negative
matt	negative
mistig	negative
regulär	positive
verschimmelt	negative
fleischarm	negative
ruinös	negative
unakzeptabel	negative
faul	negative
wasserarm	negative
kampfeslustig	negative
regelrecht	positive
unästhetisch	negative
umgekehrt	negative
kampflustig	negative
wohlgesonnen	positive
achtsam	positive
fürchterlich	negative
verletzt	negative
lügnerisch	negative
parteischädigend	negative
befremdlich	negative
beklagenswert	negative
bitterböse	negative
kumpelhaft	positive
unterlegen	negative
schwindlig	negative
korrekt	positive
viertklassig	negative
übel	negative
giftig	negative
gesundheitsschädlich	negative
nährstoffarm	negative
unfair	negative
fürsorglich	positive
fragwürdig	negative
human	positive
flau	negative
oll	negative
erdrückend	negative
unsinnig	negative
erfolglos	negative
schmalspurig	negative
umgänglich	positive
gesinnt	positive
faulig	negative
verformt	negative
nichtig	negative
bitterarm	negative
ungemütlich	negative
garstig	negative
bedauerlich	negative
regelgerecht	positive
hübsch	positive
maliziös	negative
richtiggehend	positive
beleidigt	negative
liebreich	positive
notdürftig	negative
ätzend	negative
verdorben	negative
ruiniert	negative
schädigend	negative
scheusslich	negative
beschissen	negative
hässlich	negative
bedienungsfreundlich	positive
strahlend	positive
förmlich	positive
besser	positive
ineffektiv	negative
rufschädigend	negative
ordentlich	positive
nett	positive
glücklich	positive
verfault	negative
sauer	negative
jovial	positive
teilweise	negative
widerwärtig	negative
fehlerhaft	negative
potthässlich	negative
erbärmlich	negative
erbost	negative
minderwertig	negative
belastend	negative
bemitleidenswert	negative
kundenfreundlich	positive
vorschriftsmässig	positive
bescheiden	negative
sinnlos	negative
unförmig	negative
unaufrichtig	negative
ordnungsgemäss	positive
hasserfüllt	negative
traumatisch	negative
armselig	negative
zufrieden	positive
ekelerregend	negative
ausgezeichnet	positive
unerträglich	negative
unwahr	negative
unverträglich	negative
gefährlich	negative
partnerschaftlich	positive
kalorienarm	negative
ergebnislos	negative
widrig	negative
exzellent	positive
beklemmend	negative
superior	positive
mulmig	negative
ekel erregend	negative
intrigant	negative
defizitär	negative
unansehnlich	negative
gesundheitsschädigend	negative
destruktiv	negative
grottig	negative
misslungen	negative
schlimm	negative
bruchstückartig	negative
inadäquat	negative
unnützlich	negative
grauslich	negative
zutreffend	positive
ehrlos	negative
unrichtig	negative
lästig	negative
zerstörerisch	negative
übermächtig	positive
wartungsfreundlich	positive
inakzeptabel	negative
läppisch	negative
kriminell	negative
überglücklich	positive
strafwürdig	negative
froh	positive
elend	negative
arm	negative
satanisch	negative
schäbig	negative
unehrenhaft	negative
kontraproduktiv	negative
unfertig	negative
stachelig	negative
verrottet	negative
abträglich	negative
investitionsfreundlich	positive
widerlich	negative
grottenschlecht	negative
scheiss	negative
schädlich	negative
wohlgesinnt	positive
pikiert	negative
unerfreulich	negative
überlegen	positive
fies	negative
amoralisch	negative
falsch	negative
recht	positive
unvollkommen	negative
lückenhaft	negative
arg	negative
schuldig	negative
dilettantisch	negative
stiefmütterlich	negative
überragend	positive
kontrafaktisch	negative
verfehlt	negative
menschlich	positive
unzutreffend	negative
wahr	positive
halb	negative
miserabel	negative
eingeschnappt	negative
kümmerlich	negative
niederträchtig	negative
delikat	negative
erledigt	negative
abgelaufen	negative
nervig	negative
umweltschädigend	negative
schrecklich	negative
pedantisch	positive
link	negative
rohstoffarm	negative
unbehaglich	negative
unanständig	negative
unglückselig	negative
bildhübsch	positive
geringwertig	negative
ergänzungsbedürftig	negative
abstossend	negative
unschön	negative
leserfreundlich	positive
fragmentarisch	negative
leid	negative
sonnig	positive
verkehrt	negative
traumatisierend	negative
ärmlich	negative
toxisch	negative
kläglich	negative
verderbt	negative
mies	negative
verteufelt	negative
ungeeignet	negative
glückselig	positive
ungetrübt	positive
sorgfältig	positive
luderhaft	negative
vorschriftsgemäss	positive
missraten	negative
aggressiv	negative
