angenehm	positive
anziehend	positive
attraktiv	positive
ausgezeichnet	positive
besser	positive
bildschön	positive
endgeil	positive
exzellent	positive
fein	positive
freude	positive
freundlich	positive
geeignet	positive
gewissenhaft	positive
glück	positive
glücklich	positive
glückselig	positive
glücksgefühl	positive
grandios	positive
grossartig	positive
gut	positive
herausragend	positive
hervorragend	positive
höherwertig	positive
hübsch	positive
ideal	positive
klasse	positive
korrekt	positive
lieb	positive
liebenswert	positive
liebenswürdig	positive
nett	positive
positiv	positive
praktisch	positive
preussisch	positive
recht	positive
regelrecht	positive
richtig	positive
richtiggehend	positive
schön	positive
seelig	positive
spitze	positive
verbindlich	positive
wahr	positive
wunderbar	positive
wunderschön	positive
wundervoll	positive
überglücklich	positive
überlegen	positive
überragend	positive
absolut	negative
abträglich	negative
achtsam	negative
adrett	negative
adäquat	negative
akzeptabel	negative
angemessen	negative
anmutig	negative
ansehnlich	negative
ansprechend	negative
anziehend	negative
apart	negative
appetitlich	negative
arbeitsam	negative
arm	negative
armselig	negative
attraktiv	negative
aufrecht	negative
aufrichtig	negative
barmherzig	negative
bedauerlich	negative
bedauernswert	negative
behaglich	negative
bequem	negative
berauschend	negative
bestechend	negative
bestmöglich	negative
bildhübsch	negative
bildschön	negative
blendend	negative
boshaft	negative
böse	negative
defizitär	negative
dekorativ	negative
drollig	negative
dürftig	negative
edel	negative
edelmütig	negative
ehrlich	negative
eifrig	negative
eingängig	negative
ekelerregend	negative
ekelhaft	negative
ekelig	negative
elend	negative
elendig	negative
emsig	negative
endgeil	negative
erbärmlich	negative
erfolgreich	negative
ertragbar	negative
erträglich	negative
ethisch	negative
fair	negative
falsch	negative
fantastisch	negative
fein	negative
fest	negative
fies	negative
fleissig	negative
freude	negative
freund	negative
freundin	negative
freundschaftlich	negative
friedlich	negative
friedliebend	negative
froh	negative
froh gestimmt	negative
fälschlich	negative
förmlich	negative
geeignet	negative
gefällig	negative
gefühl empfindend	negative
gehoben	negative
gelungen	negative
gemein	negative
gemütlich	negative
genehm	negative
gepflegt	negative
geraten	negative
gerecht	negative
geringwertig	negative
geruhsam	negative
geschmackvoll	negative
glimpflich	negative
glück	negative
glückselig	negative
glücksgefühl	negative
goldig	negative
grandios	negative
graziös	negative
grossartig	negative
gänzlich	negative
günstig	negative
gütig	negative
hart	negative
herausragend	negative
herrlich	negative
hervorragend	negative
herzig	negative
himmlisch	negative
human	negative
hässlich	negative
ideal	negative
irreal	negative
irrig	negative
irrtümlich	negative
jovial	negative
klasse	negative
kläglich	negative
knuffig	negative
komfortabel	negative
komplett	negative
kraftlos	negative
kraftvoll	negative
kräftig	negative
kummer	negative
kumpelhaft	negative
kärglich	negative
leid	negative
leidwesen	negative
liebenswert	negative
liebenswürdig	negative
liebesfähig	negative
liebevoll	negative
liebreich	negative
lückenhaft	negative
mangelhaft	negative
meisterhaft	negative
meisterlich	negative
menschenfreundlich	negative
menschenwürdig	negative
menschlich	negative
minderwertig	negative
misslich	negative
moralisch	negative
nachrangig	negative
negativ	negative
niederträchtig	negative
niedlich	negative
nutzbringend	negative
nützlich	negative
optimal	negative
ordentlich	negative
ordnungsgemäss	negative
ordnungsliebend	negative
paradiesisch	negative
pedantisch	negative
peinlich	negative
penibel	negative
perfekt	negative
possierlich	negative
prachtvoll	negative
pragmatisch	negative
praktisch	negative
praxis	negative
prima	negative
prächtig	negative
putzig	negative
rassig	negative
real	negative
recht	negative
regelgemäss	negative
regelgerecht	negative
regulär	negative
reich	negative
ruchbar	negative
schade	negative
scheusslich	negative
schlecht	negative
schlimm	negative
schmuck	negative
schwach	negative
schwindlig	negative
schädigend	negative
schädlich	negative
seelig	negative
sinnhaft	negative
sinnig	negative
sinnreich	negative
sinnvoll	negative
sittlich	negative
sonnig	negative
sorge	negative
sorgfältig	negative
sorgsam	negative
spass	negative
spitze	negative
stark	negative
stilgerecht	negative
stilsicher	negative
stilvoll	negative
surreal	negative
süss	negative
toll	negative
total	negative
triumph	negative
tüchtig	negative
unangenehm	negative
unaufrichtig	negative
unbarmherzig	negative
unerbittlich	negative
unerfreulich	negative
unfehlbar	negative
unglück	negative
unglücklich	negative
ungünstig	negative
unrecht	negative
unrichtig	negative
unschädlich	negative
unterlegen	negative
unvollkommen	negative
unvollständig	negative
unwirklich	negative
verarmt	negative
verbindlich	negative
verdorben	negative
vermögend	negative
vertrauenswürdig	negative
verträglich	negative
vollkommen	negative
vollständig	negative
vollzählig	negative
vorschriftsgemäss	negative
vorschriftsmässig	negative
vorzeigbar	negative
völlig	negative
wahr	negative
wahrhaft	negative
wahrhaftig	negative
widerlich	negative
widerwärtig	negative
wirklich	negative
wunderbar	negative
wunderschön	negative
wundervoll	negative
zufrieden	negative
zuträglich	negative
zweckmässig	negative
ärmlich	negative
ästhetisch	negative
übel	negative
überglücklich	negative
übung	negative
abgebrannt	neutral
abscheu	neutral
abwertend	neutral
aggressiv	neutral
agil	neutral
aktiv	neutral
akzeptieren	neutral
amigo	neutral
angeblich	neutral
angebracht	neutral
angriffslustig	neutral
annehmbar	neutral
arg	neutral
astrein	neutral
auserkoren	neutral
auserwählt	neutral
ausgeruht	neutral
authentisch	neutral
bankrott	neutral
bedrückend	neutral
beflissen	neutral
beflissenheit	neutral
befremdlich	neutral
befriedigend	neutral
befugt	neutral
begründet	neutral
begütert	neutral
beklemmend	neutral
beknackt	neutral
bekömmlich	neutral
belastend	neutral
beleidigt	neutral
berechtigt	neutral
bescheiden	neutral
beschissen	neutral
betriebsam	neutral
betucht	neutral
bewährt	neutral
blank	neutral
blass	neutral
bleich	neutral
brauch	neutral
bruchstückartig	neutral
bruchstückhaft	neutral
brutal	neutral
bösartig	neutral
böswillig	neutral
chancenlos	neutral
chillig	neutral
cool	neutral
dankbar	neutral
dementsprechend	neutral
demgemäss	neutral
desinteressiert	neutral
destruktiv	neutral
diabolisch	neutral
dienlich	neutral
diensteifrig	neutral
dilettantisch	neutral
doll	neutral
dufte	neutral
durchtrainiert	neutral
dämonisch	neutral
echt	neutral
eden	neutral
effektiv	neutral
eifer	neutral
eifersüchtig	neutral
eigentlich	neutral
eingeschnappt	neutral
ekel	neutral
ekelgefühl	neutral
eklatant	neutral
eklig	neutral
emotion	neutral
empfehlenswert	neutral
empfindung	neutral
emsigkeit	neutral
entspannend	neutral
entspannt	neutral
erfahrung	neutral
erfolg	neutral
erfolglos	neutral
erfreulich	neutral
erfunden	neutral
ergebnislos	neutral
erholsam	neutral
erkoren	neutral
erleichtert	neutral
ernst	neutral
ernsthaft	neutral
erprobt	neutral
ertragen	neutral
essbar	neutral
euphorie	neutral
fabelhaft	neutral
fachgemäss	neutral
fachgerecht	neutral
faktisch	neutral
fantastisch	neutral
faul	neutral
feeling	neutral
fehlerhaft	neutral
feige	neutral
feind	neutral
feindin	neutral
fett	neutral
fiktiv	neutral
firmament	neutral
fit	neutral
flau	neutral
fleiss	neutral
fleissigkeit	neutral
fragmentarisch	neutral
fragwürdig	neutral
freudig	neutral
freudlos	neutral
freundschaft	neutral
friedfertig	neutral
fröhlich	neutral
furchtbar	neutral
fürchterlich	neutral
ganz	neutral
ganzheitlich	neutral
garten eden	neutral
gebrechlich	neutral
gefallen	neutral
gefühl	neutral
gefühllos	neutral
gefühlsarm	neutral
gefühlskalt	neutral
gefühlvoll	neutral
geil	neutral
gekränkt	neutral
gelegen	neutral
gelingen	neutral
gemässigt	neutral
gemütsbewegung	neutral
geniessbar	neutral
gering	neutral
geschäftig	neutral
geschäftsschädigend	neutral
gesellschaftsverträglich	neutral
gestreng	neutral
gesund	neutral
gesundheitsdienlich	neutral
gesundheitsförderlich	neutral
gesundheitsfördernd	neutral
gesundheitsschädigend	neutral
gesundheitsschädlich	neutral
gewaltig	neutral
gewalttätig	neutral
giftig	neutral
glaubhaft	neutral
glaubwürdig	neutral
gleichgültig	neutral
glücklichkeit	neutral
gnädig	neutral
grottig	neutral
gut betucht	neutral
gutsituiert	neutral
halb	neutral
hart	neutral
hasserfüllt	neutral
hautverträglich	neutral
heftig	neutral
hilfreich	neutral
himmel	neutral
hinfällig	neutral
hinnehmbar	neutral
hinnehmen	neutral
hinterhältig	neutral
hochgefühl	neutral
hochgradig	neutral
hochstimmung	neutral
hoffähig	neutral
huldreich	neutral
humanitär	neutral
hämisch	neutral
höllisch	neutral
illusorisch	neutral
imaginär	neutral
implausibel	neutral
inadäquat	neutral
indifferent	neutral
individuum	neutral
infamie	neutral
inhuman	neutral
insolvent	neutral
integral	neutral
integrierend	neutral
intensiv	neutral
interessiert	neutral
jämmerlich	neutral
kampfeslustig	neutral
kampflustig	neutral
katastrophal	neutral
knorke	neutral
konform	neutral
konkordant	neutral
kontraproduktiv	neutral
kraft	neutral
krank	neutral
krass	neutral
krux	neutral
kumpan	neutral
kumpel	neutral
kunstfertig	neutral
kümmerlich	neutral
lausig	neutral
lebensbejahend	neutral
lebensfroh	neutral
lebenslustig	neutral
lehrmeister	neutral
lehrmeisterin	neutral
leidlich	neutral
link	neutral
lohnend	neutral
lohnenswert	neutral
läppisch	neutral
lästig	neutral
lückenlos	neutral
lügnerisch	neutral
magenverträglich	neutral
maliziös	neutral
marter	neutral
massvoll	neutral
matt	neutral
mau	neutral
meister	neutral
meisterin	neutral
mensch	neutral
menschenunwürdig	neutral
menschenverachtend	neutral
menschenverträglich	neutral
mies	neutral
miserabel	neutral
missgünstig	neutral
mitmensch	neutral
moderat	neutral
moral	neutral
moralvorstellung	neutral
morbide	neutral
mulmig	neutral
mumm	neutral
mörderisch	neutral
naturverträglich	neutral
neidisch	neutral
nervig	neutral
nichtig	neutral
nichtsnutzig	neutral
niedertracht	neutral
niederträchtigkeit	neutral
not	neutral
nutzlos	neutral
oberflächlich	neutral
objektiv	neutral
opportun	neutral
optimistisch	neutral
paradies	neutral
paradiesgarten	neutral
parteischädigend	neutral
partiell	neutral
passend	neutral
pein	neutral
person	neutral
persönlichkeit	neutral
pessimistisch	neutral
pickelig	neutral
pikiert	neutral
plausibel	neutral
pleite	neutral
pompös	neutral
potthässlich	neutral
pracht	neutral
probat	neutral
prunk	neutral
prunkhaft	neutral
prunkvoll	neutral
prädestiniert	neutral
qual	neutral
rachsüchtig	neutral
ratsam	neutral
realistisch	neutral
realität	neutral
rechtsvorschrift	neutral
reell	neutral
relativ	neutral
relaxed	neutral
rudimentär	neutral
rufschädigend	neutral
sachgemäss	neutral
sachgerecht	neutral
sachlich	neutral
satanisch	neutral
sauer	neutral
schaden	neutral
schadenfroh	neutral
scheiss	neutral
schlecht gelaunt	neutral
schnöde	neutral
schrecklich	neutral
schwarz	neutral
schwerreich	neutral
schäbig	neutral
schädigen	neutral
servil	neutral
sinn	neutral
sinnlos	neutral
sitte	neutral
situiert	neutral
sportfreund	neutral
sportfreundin	neutral
sportlich	neutral
sportsfreund	neutral
sportsfreundin	neutral
stadtverträglich	neutral
standesgemäss	neutral
stark	neutral
statthaft	neutral
steinreich	neutral
stinkreich	neutral
stolz	neutral
streng	neutral
stümperhaft	neutral
super	neutral
süffisant	neutral
tatkräftig	neutral
tatsächlich	neutral
tauglich	neutral
teilweise	neutral
teuflisch	neutral
tolerieren	neutral
top	neutral
tortur	neutral
toxisch	neutral
trainiert	neutral
traurig	neutral
tückisch	neutral
umweltschädigend	neutral
umweltschädlich	neutral
umweltverträglich	neutral
unangemessen	neutral
unauffallend	neutral
unauffällig	neutral
unbedenklich	neutral
unbehaglich	neutral
unfair	neutral
unfreundlich	neutral
ungemütlich	neutral
ungerecht	neutral
ungiftig	neutral
unglaubhaft	neutral
unglaubwürdig	neutral
ungut	neutral
unheil	neutral
uninteressiert	neutral
unmenschlich	neutral
unnütz	neutral
unnützlich	neutral
unrealisierbar	neutral
unsachlich	neutral
unschön	neutral
unsinnig	neutral
unsportlich	neutral
unsympathisch	neutral
untrainiert	neutral
unverbindlich	neutral
unwahr	neutral
unzulänglich	neutral
unzureichend	neutral
unzweckmässig	neutral
usus	neutral
utopisch	neutral
verdammt	neutral
verfehlt	neutral
vergnügen	neutral
vergnügt	neutral
vergnügtheit	neutral
verheerend	neutral
verhältnismässig	neutral
verkraften	neutral
verletzt	neutral
verliebt	neutral
verlogen	neutral
vermeintlich	neutral
vernichtend	neutral
verschlagen	neutral
verschmerzen	neutral
vertragen	neutral
vertrauen	neutral
vertretbar	neutral
verwirrt	neutral
verzeihend	neutral
verärgert	neutral
virtuos	neutral
vorbestimmt	neutral
vorschrift	neutral
vortrefflich	neutral
vorzüglich	neutral
wahrheitsgemäss	neutral
weh	neutral
wehe	neutral
wenig	neutral
wertlos	neutral
widrig	neutral
wild	neutral
wirklichkeit	neutral
wirtschaftsverträglich	neutral
wohlgefallen	neutral
wohlgeformt	neutral
wohlhabend	neutral
wonne	neutral
wuchtig	neutral
wunder	neutral
wütend	neutral
zahlungsunfähig	neutral
zart	neutral
zerstörerisch	neutral
zufriedenstellend	neutral
zweck	neutral
zweckfrei	neutral
zwecklos	neutral
zäh	neutral
zärtlich	neutral
zünftig	neutral
ärgerlich	neutral
ärmlich	neutral
übel gelaunt	neutral
übellaunig	neutral
übereifrig	neutral
übereinstimmend	neutral
