richtig	positive
gut	positive
überragend	positive
überlegen	positive
glücklich	positive
schön	positive
freundlich	positive
nett	positive
ausgezeichnet	positive
besser	positive
lieb	positive
höherwertig	positive
hübsch	positive
positiv	positive
angenehm	positive
korrekt	positive
ekelhaft	negative
verdorben	negative
dürftig	negative
böse	negative
falsch	negative
bedauernswert	negative
mangelhaft	negative
gemein	negative
übel	negative
schwach	negative
arm	negative
ekelerregend	negative
ekelig	negative
schädlich	negative
unterlegen	negative
unangenehm	negative
unerfreulich	negative
misslich	negative
minderwertig	negative
armselig	negative
irrig	negative
widerwärtig	negative
hässlich	negative
widerlich	negative
schlecht	negative
nachrangig	negative
unrecht	negative
negativ	negative
geringwertig	negative
ungünstig	negative
schlimm	negative
unglücklich	negative
scheusslich	negative
fies	negative
lächerlich	negative
genant	negative
genierlich	negative
peinlich	negative
glänzend	positive
glanzvoll	positive
froh	positive
zutreffend	positive
trefflich	positive
treffend	positive
vermaledeit	negative
verwünscht	negative
verflucht	negative
verflixt	negative
gefühlvoll	positive
grellfarbig	negative
grellfarben	negative
schreiend	negative
grell	negative
zuversichtlich	positive
unbändig	positive
geringschätzen	negative
missachten	negative
verwendungsfähig	positive
anwendbar	positive
verwendbar	positive
stehen	positive
kleiden	positive
kugelfisch	positive
pessimistisch	negative
gefühl empfindend	negative
wohlergehen	positive
beziehungslos	negative
bitter	negative
intoxikation	negative
vergiftung	negative
grässlich	negative
gehen	positive
erfreuen	positive
gram	negative
harm	negative
pikant	positive
hartherzig	negative
kalt	negative
hart	negative
kaltherzig	negative
eingehend	positive
sorgfältig	positive
glückspilz	positive
glückskind	positive
sinnlos	negative
brav	positive
artig	positive
traut	positive
vertraut	positive
gängig	positive
geläufig	positive
graziös	positive
anmutig	positive
grazil	positive
zugluft	negative
städtisch	positive
urban	positive
aufschneider	positive
grossmaul	positive
ilmenau	positive
exakt	positive
akkurat	positive
umweltaktivist	positive
umweltschützerin	positive
naturschützerin	positive
naturschützer	positive
umweltaktivistin	positive
umweltschützer	positive
trauma	negative
lobenswert	positive
rühmlich	positive
löblich	positive
spurlos	negative
tätlichkeit	negative
musikbegabt	positive
musikalisch	positive
einsetzbar	positive
abstellbar	positive
galant	positive
dankbar	positive
attraktivität	positive
baden-baden	positive
zuneigung	positive
hilfreich	positive
hilfsbereit	positive
gefällig	positive
erneuerbar	positive
hitze	negative
emotionslos	negative
gefühllos	negative
indigniert	negative
entrüstet	negative
empört	negative
verärgert	negative
ärgerlich	negative
heldin	positive
held	positive
luzern	positive
verderben	negative
gewaltlos	negative
behaglichkeit	positive
gemütlichkeit	positive
rachsüchtig	negative
armfrei	negative
verhängnisvoll	negative
desaströs	negative
fatal	negative
lebensgefährte	positive
lebensgefährtin	positive
gedeihen	positive
bosheit	negative
böswilligkeit	negative
boshaftigkeit	negative
gehässigkeit	negative
bösartigkeit	negative
krakau	positive
freiburg	positive
hirschgeweih	positive
hirschhorn	positive
marburg	positive
knapp	negative
kargheit	negative
dürftigkeit	negative
armseligkeit	negative
funktionieren	positive
gepräge	positive
prägung	positive
lohnen	positive
aachen	positive
gent	positive
beleumundet	negative
glück	positive
glücksfall	positive
dusel	positive
ergehen	positive
metz	positive
freudenstadt	positive
dünkel	negative
caen	positive
deprimierend	negative
schwermütig	negative
melancholisch	negative
schwarz	negative
düster	negative
jungfrau	positive
jungmann	positive
vital	positive
robust	positive
genua	positive
genova	positive
verfolgen	positive
fang	positive
fangertrag	positive
propagandist	positive
werberin	positive
werber	positive
humorvoll	positive
humorig	positive
korrektheit	positive
richtigkeit	positive
akribisch	positive
lustig	positive
florenz	positive
firenze	positive
beliebt	positive
gelitten	positive
klassenherrschaft	positive
menschenfreundin	positive
philanthrop	positive
menschenfreund	positive
fröhlich	positive
namenlos	negative
abwerten	negative
verstellbar	positive
umstellbar	positive
bieder	negative
hausbacken	negative
kiez	positive
gesetzmässig	positive
gesetzlich	positive
legal	positive
heiter	positive
verwirrt	negative
gespannt	negative
hehlerin	positive
hehler	positive
münchener	positive
münchenerin	positive
münchner	positive
münchnerin	positive
passend	positive
mitleidig	negative
bezaubernd	positive
zauberhaft	positive
verrenken	negative
nantes	positive
seelenvoll	positive
beseelt	positive
effektiv	positive
ungeheuerlich	positive
ungeheuer	positive
unheimlich	positive
heidelberg	positive
wismar	positive
greifswald	positive
vertragen	positive
verstehen	positive
wohlschmeckend	positive
lecker	positive
schmackhaft	positive
köstlich	positive
delikat	positive
versprechen	positive
bon	positive
distanz	positive
grossmütig	positive
sachkundig	positive
beherrschen	positive
melancholie	negative
brummer	negative
zudrehen	positive
human	positive
menschlich	positive
fortschritt	positive
grauen	negative
grusel	negative
vernachlässigung	positive
verfall	negative
verfallsprozess	negative
niedergeschlagen	negative
down	negative
gedrückt	negative
niedergedrückt	negative
neidisch	negative
missgünstig	negative
läsion	negative
kanone	positive
ass	positive
stark	negative
durchspülen	positive
feldverweis	positive
score	positive
herausstellung	positive
punktestand	positive
hinausstellung	positive
platzverweis	positive
geraten	positive
brechen	negative
zutreffen	negative
stimmen	negative
treffen	negative
hinkommen	negative
reizend	positive
brutalität	negative
pechfall	negative
pech	negative
nagelneu	positive
brandneu	positive
geliebter	positive
durchfluten	positive
durchströmen	positive
fehlschlag	positive
talentiert	positive
begabt	positive
formlosigkeit	positive
kranke	negative
kranker	negative
wortwörtlich	positive
energisch	positive
ausrenken	negative
gutmachen	positive
vergesellschaftung	positive
unzulänglich	negative
unzureichend	negative
allgemeinheit	positive
manieren	positive
umgangsform	positive
gefahr	negative
freudlos	positive
traurig	positive
heikel	negative
gebildet	positive
intensität	negative
minimal	negative
rechtsgefühl	positive
rechtsempfinden	positive
gefallen	positive
mögen	positive
anhören	positive
beikommen	negative
schwer	positive
anständig	positive
romantisch	positive
zweck	negative
triumph	positive
ruhigstellen	negative
willkommen	positive
erwünscht	positive
berühmt	negative
renommiert	negative
informell	negative
gefühlskalt	negative
gefühlsarm	negative
zurückfinden	positive
herzlich	positive
innig	positive
minutiös	positive
standardmässig	positive
serienmässig	positive
gemeinnützig	positive
wegdrehen	negative
liebelei	positive
liebesgeschichte	positive
liebesabenteuer	positive
romanze	positive
liebschaft	positive
befugt	positive
federführend	positive
zuständig	positive
energiebündel	positive
guttun	positive
wohltun	positive
gültig	positive
valid	positive
heisshungrig	negative
kerngesund	negative
gertenschlank	negative
mega-in	negative
todmüde	negative
putzmunter	negative
hellwach	negative
hundemüde	negative
reich	positive
gehaltvoll	positive
reichhaltig	positive
beklommenheit	positive
vergeblich	negative
vergebens	negative
haardünn	positive
hauchdünn	positive
hoffnungslos	negative
ohrenbetäubend	positive
fachkundig	positive
erwartbar	positive
erwartungsgemäss	positive
erwartungsgetreu	positive
asexuell	negative
abergläubisch	positive
erwartungsvoll	positive
hoffnungsvoll	positive
hoffnungsfroh	positive
fruchtbar	positive
sexuell	negative
