abgeschlagen	positive
abgespannt	positive
adrett	positive
angenehm	positive
anschaffung	positive
anstand	positive
anziehend	positive
appetitlich	positive
argusauge	positive
astrein	positive
astronomisch	positive
attraktiv	positive
ausfallen	positive
ausgebrannt	positive
ausgelaugt	positive
ausgepumpt	positive
ausgezeichnet	positive
ausnutzen	positive
ausnützen	positive
ausschlaggebend	positive
aussteuer	positive
baseball	positive
baseballspiel	positive
begehen	positive
beherrschen	positive
bekommen	positive
belohnen	positive
bemühen	positive
beschaffung	positive
besorgung	positive
besser	positive
bestehen	positive
bewundern	positive
bildschön	positive
bombensicher	positive
brennmaterial	positive
brennstoff	positive
cool	positive
dankbar	positive
drakonisch	positive
drastisch	positive
dufte	positive
durchtrainiert	positive
edelmann	positive
eignen	positive
einteilen	positive
endgeil	positive
endlos	positive
entgegenkommen	positive
entkräftet	positive
entwickeln	positive
erbauen	positive
erbe	positive
erbin	positive
erfahren	positive
erfolglos	positive
erfreuen	positive
erhalten	positive
erschöpft	positive
erwerbung	positive
experimentierfreudig	positive
exzellent	positive
fein	positive
felsenfest	positive
fett	positive
findig	positive
fit	positive
folie	positive
fortschreiten	positive
freie marktwirtschaft	positive
freundlich	positive
froh gelaunt	positive
fuchsig	positive
fuchsteufelswild	positive
galan	positive
geeignet	positive
gehen	positive
geil	positive
gelingen	positive
gentleman	positive
gepflegt	positive
geraten	positive
gesittet	positive
gesund	positive
gesundheitsdienlich	positive
gesundheitsförderlich	positive
gesundheitsfördernd	positive
gewissenhaft	positive
glück	positive
glücklich	positive
glückselig	positive
glücksgefühl	positive
goliath	positive
grandios	positive
grossartig	positive
gut	positive
gut aufgelegt	positive
gut gelaunt	positive
guttun	positive
haben	positive
hauptsprache	positive
heiter	positive
herabblicken	positive
herabschauen	positive
herabsehen	positive
herausragend	positive
hervorragend	positive
hilfe	positive
hilfsmittel	positive
hinabblicken	positive
hitzewelle	positive
hochleistung	positive
hängen	positive
höchstwahrscheinlich	positive
höherwertig	positive
hübsch	positive
hüne	positive
ideal	positive
industrieland	positive
industrienation	positive
kampf	positive
kennen	positive
klasse	positive
knorke	positive
konkurrenzkampf	positive
kontingentieren	positive
korrekt	positive
korrektheit	positive
krass	positive
langwierig	positive
laufen	positive
launig	positive
leiden	positive
leidenschaft	positive
lieb	positive
lieben	positive
liebenswert	positive
liebenswürdig	positive
liebhaben	positive
liefern	positive
locken	positive
lustig	positive
manieren	positive
marktwirtschaft	positive
missbilligen	positive
mitgenommen	positive
mitgift	positive
mittel	positive
mixen	positive
moral	positive
moralvorstellung	positive
mutieren	positive
mögen	positive
nachempfinden	positive
nachfühlen	positive
nahestehen	positive
name	positive
namen	positive
nett	positive
nächtigen	positive
nüchtern	positive
optimismus	positive
optimistisch	positive
passen	positive
passion	positive
plünderung	positive
positiv	positive
praktisch	positive
preussisch	positive
promi	positive
prominente	positive
prominenter	positive
recht	positive
reederei	positive
regelrecht	positive
richtig	positive
richtiggehend	positive
richtigkeit	positive
riese	positive
riesin	positive
ruhen	positive
saccharose	positive
sachgemäss	positive
sachgerecht	positive
sammelaktion	positive
sammeltätigkeit	positive
sammlung	positive
samplen	positive
sand	positive
schaffen	positive
schifffahrtsgesellschaft	positive
schleichend	positive
schön	positive
seelig	positive
sehen	positive
sittsam	positive
sozialismus	positive
spitze	positive
sportlichkeit	positive
stark	positive
super	positive
tara	positive
temperieren	positive
top	positive
trainiert	positive
transaktion	positive
trost	positive
umgangsform	positive
unaufhörlich	positive
unerfahren	positive
unfreundlich	positive
ungeheuer	positive
ungeheuerlich	positive
unheimlich	positive
unterhalten	positive
unwahr	positive
v.i.p.	positive
verbacken	positive
verbessern	positive
verbindlich	positive
verpackungsgewicht	positive
verschärfen	positive
verschönen	positive
verschönern	positive
versiert	positive
verstehen	positive
verändern	positive
verüben	positive
vip	positive
vollbringen	positive
voranschreiten	positive
vortrefflich	positive
vorzüglich	positive
wahr	positive
wahren	positive
wandeln	positive
weltruf	positive
wettstreit	positive
winzig	positive
winzigklein	positive
wirken	positive
wohlergehen	positive
wohltun	positive
wonne	positive
wunderbar	positive
wunderschön	positive
wundervoll	positive
wälzer	positive
zerpflügen	positive
zupass kommen	positive
zupasse kommen	positive
zustatten kommen	positive
zuversichtlich	positive
ändern	positive
überglücklich	positive
überlegen	positive
überragend	positive
aas	negative
abbauen	negative
abbeissen	negative
abbekommen	negative
abberufen	negative
abbezahlung	negative
abbiegen	negative
abbildung	negative
abbinden	negative
abbrechen	negative
abbrucharbeit	negative
abdunkeln	negative
abendhimmel	negative
abendstern	negative
abenteuer	negative
aberwitzig	negative
abfassen	negative
abfertigen	negative
abfertigung	negative
abfinden	negative
abflachen	negative
abfälligkeit	negative
abgabe	negative
abgang	negative
abgeben	negative
abgebrannt	negative
abgebrüht	negative
abgehen	negative
abgeneigtheit	negative
abgeschlossene zustandsveränderung	negative
abgezockt	negative
abhaken	negative
abhauen	negative
abheilen	negative
abhelfen	negative
abhängen	negative
abhängigkeit	negative
abkehren	negative
abketten	negative
abklatsch	negative
abkommen	negative
abkratzen	negative
abkömmling	negative
abkühlen	negative
abladen	negative
ablauf	negative
ablaufen	negative
ablehnen	negative
ablehnung	negative
ablenken	negative
ablenkung	negative
ablieferung	negative
ablösen	negative
abmachen	negative
abnabeln	negative
abnehmen	negative
abneigung	negative
abnibbeln	negative
abnippeln	negative
abonnent	negative
abonnentin	negative
abort	negative
abpflücken	negative
abplatten	negative
abreissen	negative
abrichtung	negative
abrissarbeit	negative
abrupfen	negative
absatz	negative
absatzforschung	negative
absatzförderung	negative
absaugen	negative
abschaffen	negative
abscheu	negative
abscheulich	negative
abschicken	negative
abschlagen	negative
abschluss	negative
abschlussprüfung	negative
abschreckung	negative
abschreckungsmassnahme	negative
abschrift	negative
abschätzigkeit	negative
abschätzung	negative
abschöpfen	negative
abseits	negative
absendung	negative
absenz	negative
absetzen	negative
absolut	negative
absolutismus	negative
absondern	negative
abspeisen	negative
abspeisung	negative
absprengen	negative
abspringen	negative
absprung	negative
abstammungstafel	negative
abstimmen	negative
abstinent	negative
abstinenz	negative
abstossen	negative
abstrahlen	negative
abstrakt	negative
abstrus	negative
abstumpfen	negative
absud	negative
absurd	negative
abtausch	negative
abtragen	negative
abtransportieren	negative
abtreibung	negative
abtrennen	negative
abtrocknen	negative
abträglich	negative
abtun	negative
abuja	negative
abwaschen	negative
abwehren	negative
abweichung	negative
abweisen	negative
abweisung	negative
abwerfen	negative
abwertend	negative
abwertung	negative
abwesenheit	negative
abwinken	negative
abzahlung	negative
abziehen	negative
abzweigen	negative
acetaldehyd	negative
acetat	negative
achillessehne	negative
achten	negative
achtkampf	negative
achtsam	negative
achtung	negative
achtungserfolg	negative
ackerbau	negative
adoption	negative
adoptiveltern	negative
adäquat	negative
aerobic	negative
aerobics	negative
aerosol	negative
affe	negative
affekt	negative
affirmation	negative
ag	negative
agens	negative
aggression	negative
aggressiv	negative
aggressor	negative
aggressorin	negative
agieren	negative
agil	negative
agrarprodukt	negative
agrarreform	negative
agrarwirtschaft	negative
agrikultur	negative
ahn	negative
ahndung	negative
ahne	negative
ahnentafel	negative
ahnin	negative
ahnung	negative
aidskrank	negative
airline	negative
akademie	negative
akkuratheit	negative
akne	negative
akquisition	negative
akrobat	negative
akrobatin	negative
akt	negative
akteur	negative
akteurin	negative
aktiengesellschaft	negative
aktion	negative
aktionsgemeinschaft	negative
aktiv	negative
aktivität	negative
aktivum	negative
akzelerieren	negative
akzeptabel	negative
akzeptieren	negative
album	negative
aldehyd	negative
alienieren	negative
alkohol	negative
alkoholabhängigkeit	negative
alkoholismus	negative
alkoholkrankheit	negative
alkoholmissbrauch	negative
alkoholrausch	negative
alkoholsucht	negative
all	negative
allegretto	negative
allegro	negative
allein	negative
alleinherrschaft	negative
allergie	negative
allheilmittel	negative
allmählich	negative
alltagssprache	negative
almanach	negative
alpinismus	negative
altbewährt	negative
altern	negative
altersdemenz	negative
altersgründe	negative
altersschwäche	negative
altruismus	negative
ambiente	negative
ambition	negative
amigo	negative
aminosäure	negative
amme	negative
ammoniak	negative
amnestieren	negative
amorbach	negative
amputieren	negative
amsterdam	negative
amt	negative
amtseid	negative
amtshilfe	negative
amüsieren	negative
anabolikum	negative
analog	negative
analogie	negative
analyse	negative
analytiker	negative
analytikerin	negative
anbau	negative
anbauen	negative
anbeginn	negative
anbetung	negative
anbieter	negative
anbieterin	negative
anbringen	negative
anerkennen	negative
aneurysma	negative
anfahrt	negative
anfall	negative
anfang	negative
anfangspunkt	negative
anfechtung	negative
anfertigen	negative
anfälligkeit	negative
anfügen	negative
anfühlen	negative
anführen	negative
anführung	negative
angabe	negative
angeberei	negative
angeblich	negative
angebracht	negative
angehörige	negative
angehöriger	negative
angeklagte	negative
angeklagter	negative
angelegenheit	negative
angeln	negative
angemessen	negative
angeregt	negative
angleichen	negative
angreifen	negative
angreifer	negative
angreiferin	negative
angriffslustig	negative
angst	negative
angstgegner	negative
angstgegnerin	negative
anhang	negative
anhieb	negative
anhängerschaft	negative
ankara	negative
ankauf	negative
anklage	negative
ankleiden	negative
ankläger	negative
anklägerin	negative
ankommen	negative
anlage	negative
anlass	negative
anleger	negative
anlegerin	negative
anlieferung	negative
anmeldung	negative
anmietung	negative
anmut	negative
anmutig	negative
annaberg-buchholz	negative
annahme	negative
annehmbar	negative
annehmen	negative
anpflanzen	negative
anpflanzung	negative
anrainer	negative
anrainerin	negative
anregung	negative
anreise	negative
anreiz	negative
anrichten	negative
ansatz	negative
ansbach	negative
anschaffung	negative
anschauung	negative
anschein	negative
anscheinend	negative
anschlag	negative
anschliessen	negative
anschmieren	negative
ansehen	negative
ansehnlich	negative
ansicht	negative
ansiedlung	negative
anspannen	negative
anspannung	negative
ansprechend	negative
anstellen	negative
anstellung	negative
anstiften	negative
anstiftung	negative
anstrengen	negative
antagonist	negative
antagonistin	negative
anteilnahme	negative
anthrax	negative
antidot	negative
antipathie	negative
antipode	negative
antipodin	negative
antiquität	negative
antiserum	negative
antithese	negative
antitoxin	negative
antragsteller	negative
antragstellerin	negative
antreiber	negative
antreiberin	negative
antrieb	negative
antriebskraft	negative
antun	negative
antwerpen	negative
anwendung	negative
anwesenheit	negative
anwohner	negative
anwohnerin	negative
anzahlung	negative
anzetteln	negative
anziehen	negative
anziehung	negative
anziehungskraft	negative
anämie	negative
anämisch	negative
apart	negative
appeal	negative
appetithemmer	negative
appetitzügler	negative
applikation	negative
arbeit	negative
arbeiten	negative
arbeitsam	negative
arbeitsatmosphäre	negative
arbeitsgemeinschaft	negative
arbeitsgruppe	negative
arbeitskampf	negative
arbeitsklima	negative
arbeitsplatz	negative
arbeitssuche	negative
arg	negative
arge	negative
argentinien	negative
argument	negative
argwohn	negative
arm	negative
armageddon	negative
armselig	negative
armut	negative
armutsgrenze	negative
aroma	negative
aromatisch	negative
arsch	negative
arschloch	negative
arten	negative
artist	negative
artistin	negative
arznei	negative
arzneimittel	negative
arzneistoff	negative
asbest	negative
aschaffenburg	negative
aschersleben	negative
aserbaidschan	negative
aspektuell	negative
aspiration	negative
asset	negative
asylbewerber	negative
asylbewerberin	negative
asylsuchende	negative
asylsuchender	negative
asylwerber	negative
asylwerberin	negative
athletik	negative
atlas	negative
atmosphäre	negative
atombindung	negative
attacke	negative
attitüde	negative
attraktiv	negative
attraktivität	negative
attrappe	negative
auf sein	negative
aufatmen	negative
aufbauen	negative
aufbewahrung	negative
aufdringlichkeit	negative
aufdrängen	negative
aufenthalt	negative
auferstehung	negative
auffassung	negative
auffliegen	negative
aufführen	negative
aufgabe	negative
aufgabenbereich	negative
aufgabengebiet	negative
aufgabenkreis	negative
aufgabenspektrum	negative
aufgehen	negative
aufguss	negative
aufheiterung	negative
aufhetzend	negative
aufhören	negative
aufkauf	negative
aufkaufen	negative
aufklärer	negative
aufklärerin	negative
aufklärung	negative
aufladen	negative
auflisten	negative
auflockern	negative
auflockerung	negative
auflösen	negative
aufmachen	negative
aufmachung	negative
aufmerksamkeit	negative
aufmischen	negative
aufmunterung	negative
aufnahme	negative
aufnahmeprüfung	negative
aufnehmen	negative
aufnötigen	negative
aufrecht	negative
aufregen	negative
aufrichtig	negative
aufruhr	negative
aufrühren	negative
aufrührerisch	negative
aufsehen	negative
aufsicht	negative
aufspielen	negative
aufstellen	negative
aufständische	negative
aufständischer	negative
aufteilung	negative
auftrag	negative
auftreten	negative
auftrieb	negative
auftriebskraft	negative
aufwachen	negative
aufwenden	negative
aufwendig	negative
aufwendung	negative
aufwerten	negative
aufwiegelnd	negative
aufwieglerisch	negative
aufwärtsgehen	negative
aufzeichnen	negative
aufzucht	negative
auge	negative
augenfällig	negative
augenschein	negative
augenscheinlich	negative
augenschädigend	negative
augenschädlich	negative
augenzeuge	negative
augenzeugin	negative
augsburg	negative
auktion	negative
aura	negative
aus	negative
ausagieren	negative
ausarbeiten	negative
ausbauen	negative
ausbeulen	negative
ausblicken	negative
ausbrecher	negative
ausbrecherin	negative
ausbringen	negative
ausbrüten	negative
ausbuhen	negative
ausdehnen	negative
ausdenken	negative
ausdruck	negative
ausdrücken	negative
ausdrücklich	negative
auseinanderbrechen	negative
auseinanderreissen	negative
auseinandersetzung	negative
auseinandersprengen	negative
auserkoren	negative
auserwählen	negative
auserwählt	negative
ausfahren	negative
ausfahrt	negative
ausfall	negative
ausflocken	negative
ausflucht	negative
ausflug	negative
ausfressen	negative
ausführlich	negative
ausführung	negative
ausgang	negative
ausgangsbasis	negative
ausgangslage	negative
ausgangsposition	negative
ausgangspunkt	negative
ausgebucht	negative
ausgebufft	negative
ausgeburt	negative
ausgedehnt	negative
ausgeglichenheit	negative
ausgehen	negative
ausgekocht	negative
ausgelassen	negative
ausgepowert	negative
ausgeruht	negative
ausgestalten	negative
ausgiebig	negative
ausgründen	negative
aushalten	negative
aushecken	negative
ausheilen	negative
aushub	negative
aushöhlen	negative
auskennen	negative
auskleiden	negative
ausknobeln	negative
auslachen	negative
ausladen	negative
ausladung	negative
auslage	negative
ausleben	negative
ausleuchten	negative
auslieferung	negative
auslugen	negative
auslöschen	negative
auslöschung	negative
auslösen	negative
auslöser	negative
ausmachen	negative
ausmass	negative
ausmerzen	negative
auspfeifen	negative
ausreichen	negative
ausreichend	negative
ausreissen	negative
ausreisser	negative
ausreissergruppe	negative
ausreisserin	negative
ausruf	negative
aussaat	negative
aussage	negative
aussagefähig	negative
aussagekraft	negative
aussagekräftig	negative
aussatz	negative
aussaugen	negative
ausschalen	negative
ausschank	negative
ausschau	negative
ausschauen	negative
ausschlafen	negative
ausschlag	negative
ausschreiben	negative
ausschweifend	negative
ausschütten	negative
aussehen	negative
aussenseiter	negative
aussenseiterin	negative
aussenwelt	negative
aussitzen	negative
aussprengen	negative
ausspülen	negative
ausstechen	negative
ausstehen	negative
ausstrahlen	negative
ausstrahlung	negative
aussäen	negative
austausch	negative
austeilen	negative
austüfteln	negative
ausverkauft	negative
auswanderer	negative
auswechseln	negative
auswerfen	negative
auswirkung	negative
auszeichnen	negative
ausziehen	negative
ausüben	negative
authentisch	negative
authentizität	negative
autobiografie	negative
autokratie	negative
automatisieren	negative
automobilsport	negative
autor	negative
autorin	negative
aversion	negative
azetylcholin	negative
babysitter	negative
bad	negative
badminton	negative
bahamas	negative
bahnen	negative
bahnradsport	negative
bahrain	negative
ballaststoffe	negative
ballerina	negative
balletttänzer	negative
balletttänzerin	negative
ballspiel	negative
ballsport	negative
ballsportart	negative
balsam	negative
bammel	negative
banalisieren	negative
band	negative
bangkok	negative
bankraub	negative
bankrott	negative
bankrottieren	negative
barbarisch	negative
barcelona	negative
barmherzig	negative
barsch	negative
barzahlung	negative
basal	negative
base	negative
baseballschläger	negative
basispunkt	negative
basketball	negative
basketballspiel	negative
basteln	negative
batiken	negative
bauen	negative
bauschaden	negative
baustoff	negative
bautzen	negative
bayreuth	negative
beachtbar	negative
beachten	negative
beachtenswert	negative
beachtlich	negative
beachvolleyball	negative
beamen	negative
beanstandung	negative
beauftragte	negative
beauftragter	negative
bedarfsanalyse	negative
bedarfsforschung	negative
bedauerlich	negative
bedauern	negative
bedauernswert	negative
bedenklich	negative
bedeutend	negative
bedeutsam	negative
bedeutungsvoll	negative
bedienen	negative
bedingen	negative
bedrohen	negative
bedrohung	negative
bedröppelt	negative
bedrückend	negative
bedürfnis	negative
beehren	negative
beeinflussen	negative
beeinflussung	negative
beerdigen	negative
befestigen	negative
befinden	negative
befindlichkeit	negative
beflissen	negative
beflissenheit	negative
befragung	negative
befreien	negative
befreiung	negative
befremden	negative
befremdlich	negative
befremdung	negative
befriedigend	negative
befriedigung	negative
befruchten	negative
befugt	negative
befürchten	negative
befürchtung	negative
befürworter	negative
befürworterin	negative
begabung	negative
begebenheit	negative
begebnis	negative
begehr	negative
begehren	negative
begehrlichkeit	negative
begeisterung	negative
begierde	negative
beginn	negative
begleichung	negative
begleiten	negative
begleiter	negative
begleiterin	negative
begleitung	negative
beglückwünschen	negative
begnügen	negative
begossen	negative
begraben	negative
begrifflich	negative
begräbnisplatz	negative
begründen	negative
begründer	negative
begründerin	negative
begründet	negative
begutachtung	negative
begütert	negative
behaglich	negative
behalten	negative
behandeln	negative
behauptung	negative
beheben	negative
beherbergung	negative
behinderung	negative
behutsamkeit	negative
beibringen	negative
beichtvater	negative
beifahrer	negative
beifahrerin	negative
beigabe	negative
beiläufig	negative
beinhart	negative
beipflichten	negative
beischlaf	negative
beisein	negative
beisetzen	negative
beissend	negative
beitrag	negative
beitritt	negative
bejahen	negative
bejahung	negative
bekannte	negative
bekannter	negative
bekanntheitsgrad	negative
bekehren	negative
beklagte	negative
beklagter	negative
beklatschen	negative
bekleiden	negative
beklemmend	negative
beklommenheit	negative
beknackt	negative
bekämpfung	negative
bekömmlich	negative
belagerer	negative
belagerin	negative
belasten	negative
belastend	negative
belastung	negative
belegen	negative
belegt	negative
beleidigt	negative
belieferung	negative
belize	negative
belize city	negative
bemerkenswert	negative
bemerkung	negative
bemitleiden	negative
benehmen	negative
beneiden	negative
benennen	negative
benutzer	negative
benutzerhandbuch	negative
benutzerin	negative
beobachten	negative
beobachter	negative
beobachterin	negative
beobachtung	negative
bepreisen	negative
bequem	negative
bequemlichkeit	negative
berater	negative
beraterin	negative
beraubung	negative
berauschen	negative
berauschend	negative
berechtigt	negative
beredsamkeit	negative
beredtheit	negative
bereich	negative
bereichern	negative
bereit machen	negative
bereitstellung	negative
bereuen	negative
bergneustadt	negative
bergsteigen	negative
berlin	negative
bersten	negative
beruf	negative
berufen	negative
berufsausübung	negative
berufserkrankung	negative
berufskrankheit	negative
berufstätigkeit	negative
beruhigen	negative
berühmtheit	negative
besamen	negative
besatzer	negative
besatzerin	negative
beschauer	negative
beschauerin	negative
bescheiden	negative
bescheissen	negative
bescherung	negative
beschichtung	negative
beschissen	negative
beschleunigen	negative
beschleuniger	negative
beschleunigung	negative
beschmieren	negative
beschmutzen	negative
beschneiden	negative
beschwerde	negative
beschädigen	negative
beschädigung	negative
beschäftigung	negative
beseelt	negative
beseitigen	negative
beseitigung	negative
besessenheit	negative
besetzer	negative
besetzerin	negative
besetzt	negative
besiedlung	negative
besitz	negative
besitzer	negative
besitzerin	negative
besitzwechsel	negative
besorgt	negative
besprechung	negative
bessern	negative
bestand	negative
bestatten	negative
bestechend	negative
bestechlich	negative
bestechlichkeit	negative
bestechungsgeld	negative
bestehen	negative
bestellen	negative
bestimmen	negative
bestimmend	negative
bestimmung	negative
bestleistung	negative
bestmöglich	negative
bestrafen	negative
bestrafung	negative
bestseller	negative
beständig	negative
beständigkeit	negative
bestätigen	negative
besuch	negative
besuchen	negative
besucher	negative
besucherin	negative
beton	negative
betrachten	negative
betrachter	negative
betrachterin	negative
betrag	negative
betragen	negative
betreiben	negative
betreuer	negative
betreuerin	negative
betriebsam	negative
betroffen	negative
betrug	negative
betrunkenheit	negative
beträchtlich	negative
betrübt	negative
betrügen	negative
betucht	negative
betulichkeit	negative
betätigen	negative
betätigung	negative
beuchen	negative
beugung	negative
beulen	negative
beurteilen	negative
beurteilung	negative
beute	negative
bevollmächtigte	negative
bevollmächtigter	negative
bevölkerung	negative
bewahren	negative
bewahrer	negative
bewahrerin	negative
bewegen	negative
beweggrund	negative
bewegung	negative
bewerb	negative
bewerben	negative
bewerber	negative
bewerberin	negative
bewertung	negative
bewilligen	negative
bewusst	negative
bewährt	negative
bewältigen	negative
bezahlen	negative
bezahlung	negative
beziehen	negative
bezieher	negative
bezieherin	negative
beziehung	negative
bezirk	negative
bezirksstadt	negative
bezug	negative
bezugsperson	negative
biathlon	negative
biathlonsport	negative
bielefeld	negative
bienenwachs	negative
bieten	negative
bietigheim-bissingen	negative
bilanz	negative
bilden	negative
bilderbuch	negative
bildhauen	negative
bildhauer	negative
bildhauerin	negative
bildhauern	negative
bildhübsch	negative
bildungsabschluss	negative
bildungsroman	negative
billig	negative
billigen	negative
bindehaut	negative
binden	negative
bindung	negative
bindungsperson	negative
binsenwahrheit	negative
binsenweisheit	negative
biografie	negative
biomarker	negative
bionahrung	negative
biopatentrichtlinie	negative
biosphäre	negative
bissig	negative
bitten	negative
bitter	negative
blank	negative
blasen	negative
blass	negative
blassrosa	negative
blattgrün	negative
bleich	negative
blendend	negative
blick	negative
blogger	negative
bloggerin	negative
blogosphäre	negative
blume	negative
blumenpracht	negative
blutarm	negative
blutarmut	negative
blutig	negative
blutrot	negative
blutrünstig	negative
blödmann	negative
blösse	negative
board	negative
bochum	negative
bodybuilding	negative
bogenschütze	negative
bogenschützin	negative
bohemien	negative
bolivien	negative
bombastisch	negative
bombay	negative
bomben	negative
bonität	negative
bonn	negative
bootsflüchtling	negative
bordell	negative
bordellbesucher	negative
boshaft	negative
boshaftigkeit	negative
bosheit	negative
bosnien	negative
bosnien-herzegowina	negative
bote	negative
botin	negative
boxen	negative
boxsport	negative
brachial	negative
brachialgewalt	negative
brackenheim	negative
brackwasser	negative
branche	negative
brandopfer	negative
brauch	negative
braun	negative
braunschweig	negative
braut	negative
brechen	negative
brei	negative
bremerhaven	negative
bremsen	negative
brennen	negative
bridgetown	negative
bringen	negative
broterwerb	negative
bruchstückartig	negative
bruchstückhaft	negative
bruder	negative
brutal	negative
brutalität	negative
bräunlichrot	negative
bräutigam	negative
bröseln	negative
brüsk	negative
brüten	negative
buch	negative
buchband	negative
buchform	negative
buchhandel	negative
buchkritiker	negative
buchkritikerin	negative
buchstäblich	negative
buhen	negative
buhlen	negative
bukarest	negative
bummel	negative
bundeshauptstadt	negative
bundesstadt	negative
business	negative
byzanz	negative
bändigung	negative
börsenwert	negative
bösartig	negative
bösartigkeit	negative
böse	negative
böswillig	negative
böswilligkeit	negative
büchlein	negative
bühnenprobe	negative
bündnis 90/die grünen	negative
bürger	negative
bürgerin	negative
bürgerrecht	negative
bürgerrechtler	negative
bürgerrechtlerin	negative
büttel	negative
campus	negative
carbonsäure	negative
causa	negative
cdu	negative
celebrity	negative
celle	negative
chancenlos	negative
charaktereigenschaft	negative
charakteristisch	negative
charakterzug	negative
charisma	negative
charme	negative
chatiquette	negative
chauvinismus	negative
check	negative
chem veränd herstell	negative
chemikalie	negative
chemnitz	negative
chicago	negative
chile	negative
chillig	negative
chlorid	negative
chlorophyll	negative
cholesterin	negative
christlich demokratische union	negative
christlich-soziale union	negative
chronik	negative
clean	negative
cloppenburg	negative
clou	negative
coburg	negative
computerisieren	negative
contest	negative
cornea	negative
costa rica	negative
cottbus	negative
courage	negative
cousin	negative
cousine	negative
csu	negative
curling	negative
cuxhaven	negative
dachgesellschaft	negative
dachorganisation	negative
dachpfanne	negative
dachschindel	negative
dachziegel	negative
dag	negative
dame	negative
dampf	negative
danebengehen	negative
dank	negative
dankbarkeit	negative
dankempfindung	negative
dankgefühl	negative
danzig	negative
darbieten	negative
darling	negative
darm	negative
darmstadt	negative
darmverschluss	negative
darstellen	negative
darsteller	negative
darstellerin	negative
darstellung	negative
dasein	negative
date	negative
dateneingabe	negative
dauerhaftigkeit	negative
dauern	negative
dauerstreit	negative
davonlaufen	negative
davonrennen	negative
davos	negative
deal	negative
debakel	negative
debütant	negative
debütantenball	negative
debütantin	negative
debütantinnenball	negative
decken	negative
defensiv	negative
defizitär	negative
deformieren	negative
degagieren	negative
dekorativ	negative
delikt	negative
delinquent	negative
delinquentin	negative
demagogisch	negative
dementsprechend	negative
demenz	negative
demgemäss	negative
demokrat	negative
demokratie	negative
demokratin	negative
demolieren	negative
demonstrant	negative
demonstrantin	negative
demonstration	negative
demotiviert	negative
den haag	negative
denkbar	negative
denken	negative
denksystem	negative
department	negative
deplatziert	negative
deplaziert	negative
deportieren	negative
depp	negative
deprimierend	negative
deprimiert	negative
derivat	negative
dermatitis	negative
desaster	negative
design	negative
designieren	negative
desillusioniert	negative
desinteresse	negative
desinteressiert	negative
despektierlichkeit	negative
destabilisieren	negative
destillat	negative
destruieren	negative
destruktion	negative
destruktiv	negative
determinismus	negative
detmold	negative
detonieren	negative
deutsche angestelltengewerkschaft	negative
deutsche kommunistische partei	negative
deutsche lebens-rettungs-gesellschaft	negative
devastieren	negative
dezent	negative
dhaka	negative
diabetes	negative
diabetes mellitus	negative
diabolisch	negative
dialektwörterbuch	negative
dichter	negative
dichterin	negative
dichtung	negative
dickfelligkeit	negative
die grünen	negative
diebstahl	negative
dienen	negative
dienlich	negative
diensteifrig	negative
dieselbigkeit	negative
diffamierung	negative
differenz	negative
differenzierbar	negative
diktatorisch	negative
diktatur	negative
dilettant	negative
dilettantin	negative
dilettantisch	negative
dilettieren	negative
dimension	negative
ding	negative
dinslaken	negative
diplomat	negative
diplomatin	negative
direkt	negative
direktmandat	negative
discjockey	negative
diskreditierung	negative
diskutabel	negative
disposition	negative
dissens	negative
dissonanz	negative
dissoziation	negative
distanzlosigkeit	negative
disziplin	negative
divers	negative
diversifikation	negative
diversifizierung	negative
dj	negative
dkp	negative
dlrg	negative
dogma	negative
dogmatisch	negative
dogmatisieren	negative
doktorand	negative
doktorandin	negative
doktrin	negative
doktrinär	negative
dokumentieren	negative
doll	negative
dominanz	negative
dompteur	negative
dompteurin	negative
domäne	negative
doppel	negative
doppelgänger	negative
doppelgängerin	negative
doppelmonarchie	negative
doppelt	negative
dorf	negative
dorfschaft	negative
dorren	negative
dortmund	negative
doubeln	negative
down	negative
drang	negative
draufgehen	negative
draufgängerisch	negative
drehbuch	negative
drehimpuls	negative
dresden	negative
dressur	negative
dressurreiten	negative
drill	negative
drogenrausch	negative
drohen	negative
drollig	negative
druck	negative
dröge	negative
dschibuti	negative
dudeln	negative
duell	negative
duftstoff	negative
duisburg	negative
dummkopf	negative
dumpfbacke	negative
dumping	negative
dunkelrot	negative
duplikat	negative
durchbrechen	negative
durchbruch	negative
durchdrehen	negative
durcheinandergeraten	negative
durchfall	negative
durchfallen	negative
durchführen	negative
durchhauen	negative
durchlöchern	negative
durchmachen	negative
durchrasseln	negative
durchrutschen	negative
durchschlag	negative
durchschrift	negative
durchstehen	negative
durchstreichen	negative
durchtrennen	negative
durchtrieben	negative
durchtriebenheit	negative
dynamik	negative
dynamisch	negative
dynamit	negative
dämonisch	negative
dänemark	negative
dörren	negative
dünn	negative
dünnhäutig	negative
dürftig	negative
dürre	negative
düsseldorf	negative
e-commerce	negative
e-sport	negative
ebenbürtig	negative
echt	negative
ecuador	negative
edel	negative
edelmütig	negative
eden	negative
edieren	negative
editieren	negative
effekt	negative
effekten	negative
effektiv	negative
egal	negative
egoismus	negative
egozentrik	negative
ehefrau	negative
ehegatte	negative
ehegattin	negative
ehemann	negative
ehre	negative
ehren	negative
ehrgeiz	negative
ehrlich	negative
eichel	negative
eid	negative
eidgenossenschaft	negative
eifer	negative
eifersüchteln	negative
eifersüchtig	negative
eifrig	negative
eigentlich	negative
eigentümer	negative
eigentümerin	negative
eigenwert	negative
eigner	negative
eignerin	negative
einbeulen	negative
einbildung	negative
einbildungskraft	negative
einbringen	negative
einbusse	negative
eindellen	negative
eindringlich	negative
eindunkeln	negative
einfassen	negative
einfluss	negative
einflussbereich	negative
einflussnahme	negative
einfühlsam	negative
einfühlung	negative
einfühlungsvermögen	negative
eingabe	negative
eingehen	negative
eingeschnappt	negative
eingreifen	negative
eingriff	negative
eingängig	negative
einhandeln	negative
einhauchen	negative
einhauen	negative
einheit	negative
einheitspartei	negative
einigkeit	negative
einkauf	negative
einklang	negative
einknacken	negative
einkäufe	negative
einköcheln	negative
einladen	negative
einladung	negative
einmischen	negative
einmütigkeit	negative
einpennen	negative
einrahmen	negative
einratzen	negative
einreissen	negative
einrichten	negative
einrichtung	negative
einsam	negative
einsatz	negative
einschalen	negative
einschlafen	negative
einschlagen	negative
einschlummern	negative
einschlägig	negative
einschneidend	negative
einschreiben	negative
einschreiten	negative
einschulen	negative
einschätzen	negative
einschüchtern	negative
einsendung	negative
einsparen	negative
einspielen	negative
einstampfen	negative
einstanzen	negative
einstecken	negative
einstellen	negative
einstellung	negative
einstossen	negative
eintracht	negative
eintragen	negative
eintragung	negative
eintritt	negative
einwand	negative
einwanderer	negative
einwendung	negative
einwerfen	negative
einwurf	negative
einwählen	negative
einzeichnen	negative
einzelkind	negative
einzelne	negative
einzelner	negative
einzelperson	negative
einätzen	negative
eisenach	negative
eisenbeton	negative
eisenhart	negative
eisenhüttenstadt	negative
eismasse	negative
ekel	negative
ekelerregend	negative
ekelgefühl	negative
ekelhaft	negative
ekelig	negative
ekeln	negative
eklat	negative
eklatant	negative
eklig	negative
ekzem	negative
eleganz	negative
elegisch	negative
elementar	negative
elend	negative
elendig	negative
eliminieren	negative
eliminierung	negative
eloquenz	negative
elter	negative
eltern	negative
elternteil	negative
embolie	negative
emden	negative
emigrant	negative
emigrantin	negative
emotion	negative
emotional	negative
emotionalisieren	negative
emotionell	negative
emotionslos	negative
empathie	negative
empathisch	negative
empfang	negative
empfangen	negative
empfehlenswert	negative
empfinden	negative
empfindlich	negative
empfindsam	negative
empfindsamkeit	negative
empfindung	negative
empört	negative
empörung	negative
emsig	negative
emsigkeit	negative
ende	negative
endergebnis	negative
endigen	negative
endlich	negative
endlos	negative
endpunkt	negative
energie	negative
energiegeladen	negative
energisch	negative
engagement	negative
enger	negative
enkel	negative
enkelin	negative
enkelkind	negative
enorm	negative
entaschen	negative
entasten	negative
entbasten	negative
entbehrlich	negative
entbeinen	negative
entbinden	negative
entblumen	negative
entblättern	negative
entblöden	negative
entblössen	negative
entbürokratisieren	negative
entdecken	negative
entdeckung	negative
entdramatisieren	negative
entdämonisieren	negative
enteignung	negative
enteisen	negative
enteisenen	negative
enterbung	negative
entfachen	negative
entfernen	negative
entfernung	negative
entfesseln	negative
entflammt	negative
entflecken	negative
entfleischen	negative
entfloren	negative
entfremden	negative
entführen	negative
entgasen	negative
entgegennahme	negative
entgiften	negative
entgräten	negative
enthaaren	negative
enthaltsam	negative
enthaltsamkeit	negative
entheben	negative
enthäuten	negative
entideologisieren	negative
entität	negative
entkalken	negative
entkeimen	negative
entkernen	negative
entkleiden	negative
entknochen	negative
entkoffeinieren	negative
entkorken	negative
entkrampfen	negative
entkriminalisieren	negative
entladen	negative
entlassen	negative
entlassung	negative
entlasten	negative
entlauben	negative
entlausen	negative
entledigen	negative
entleert	negative
entleerung	negative
entmannen	negative
entmaterialisieren	negative
entmenschen	negative
entmenschlichen	negative
entminen	negative
entmischen	negative
entmisten	negative
entmotten	negative
entmüllen	negative
entnazifizieren	negative
entnikotinen	negative
entnikotinisieren	negative
entnikotisieren	negative
entrahmen	negative
entrinden	negative
entrosten	negative
entrüstet	negative
entrüstung	negative
entsagend	negative
entsagungsvoll	negative
entsalzen	negative
entsanden	negative
entscheidend	negative
entschlacken	negative
entschlafen	negative
entschlammen	negative
entschleiern	negative
entschlummern	negative
entschwefeln	negative
entschärfen	negative
entsetzen	negative
entsetzlich	negative
entseuchen	negative
entsiegeln	negative
entsilbern	negative
entsinnen	negative
entsolidarisieren	negative
entspannen	negative
entspannend	negative
entspannt	negative
entspannung	negative
entsprechend	negative
entsprechung	negative
entstabilisieren	negative
entsteinen	negative
entstofflichen	negative
entstören	negative
enttabuisieren	negative
enttäuscht	negative
entwanzen	negative
entwerfen	negative
entwertung	negative
entwicklung	negative
entwurzeln	negative
entzaubern	negative
entzerren	negative
entzinnen	negative
entzundern	negative
entzweibrechen	negative
entzweien	negative
entzünden	negative
entzündung	negative
epidemie	negative
epilieren	negative
erachten	negative
erbarmen	negative
erbarmungslos	negative
erbe	negative
erbittern	negative
erbkrankheit	negative
erblasser	negative
erblasserin	negative
erblinden	negative
erbmasse	negative
erbringen	negative
erbschaft	negative
erbärmlich	negative
erdanziehung	negative
erdanziehungskraft	negative
erdball	negative
erde	negative
erdenbürger	negative
erdenbürgerin	negative
erdenken	negative
erdenklich	negative
erdkreis	negative
erdkugel	negative
erdkörper	negative
erdulden	negative
erfahren	negative
erfahrung	negative
erfassen	negative
erfinder	negative
erfinderin	negative
erfindung	negative
erfolg	negative
erfolgreich	negative
erfolgserlebnis	negative
erforderlich	negative
erfordern	negative
erfreuen	negative
erfreulich	negative
erfunden	negative
erfühlen	negative
ergebnis	negative
ergebnislos	negative
ergreifung	negative
ergrünen	negative
ergänzen	negative
ergötzen	negative
erhalt	negative
erheblich	negative
erhitzen	negative
erholsam	negative
erhöhung	negative
erinnern	negative
eritrea	negative
eriwan	negative
erkalten	negative
erkenntlichkeit	negative
erklecklich	negative
erklären	negative
erkoren	negative
erkranken	negative
erkältung	negative
erkältungskrankheit	negative
erlangen	negative
erlassen	negative
erlauben	negative
erlaubnis	negative
erlebnis	negative
erledigt	negative
erleichtern	negative
erleichtert	negative
erleiden	negative
ermessen	negative
ermässigen	negative
ermöglichen	negative
ernennen	negative
erneuen	negative
erneuern	negative
ernst	negative
ernsthaft	negative
ernsthaftigkeit	negative
ernte	negative
eroberer	negative
eroberin	negative
erprobt	negative
erregung	negative
errichten	negative
erschaffen	negative
erschaudern	negative
erschauern	negative
erscheinen	negative
erscheinung	negative
erscheinungsbild	negative
erschrecken	negative
erschweren	negative
erschütterung	negative
erstarken	negative
erstarren	negative
erstattung	negative
ertauben	negative
ertragbar	negative
ertragen	negative
erträglich	negative
erwachen	negative
erwachsene	negative
erwachsener	negative
erwartbar	negative
erwartung	negative
erwartungsgemäss	negative
erwartungsgetreu	negative
erwartungsvoll	negative
erwecken	negative
erweichen	negative
erwerb	negative
erwerbsarbeit	negative
erwerbstätigkeit	negative
erwerbszweig	negative
erwerbung	negative
erwähnenswert	negative
erwähnung	negative
erwärmen	negative
erzeugen	negative
erzeugnis	negative
erzfeind	negative
erzfeindin	negative
erziehung	negative
erzürnt	negative
eröffnen	negative
esprit	negative
essbar	negative
essen	negative
essenz	negative
essenzial	negative
essenziell	negative
esswaren	negative
establishment	negative
ester	negative
estland	negative
etablieren	negative
ether	negative
ethisch	negative
etikette	negative
etlich	negative
eu-richtlinie	negative
eunuch	negative
euphorie	negative
euphorisch	negative
evaluation	negative
evaluierung	negative
evergreen	negative
evozieren	negative
ewig	negative
ewigkeit	negative
ex	negative
ex-ehefrau	negative
ex-ehemann	negative
exaktheit	negative
examen	negative
exemplar	negative
exfrau	negative
existenz	negative
existenzminimum	negative
exmann	negative
exorzist	negative
exorzistin	negative
expandieren	negative
experimentieren	negative
explizit	negative
explodieren	negative
explosion	negative
extrakt	negative
extrem	negative
exzessiv	negative
fabelhaft	negative
fabrizieren	negative
fach	negative
fachbereich	negative
fachbuch	negative
fachgebiet	negative
fachgemäss	negative
fachgerecht	negative
fachrichtung	negative
fachwissenschaft	negative
fact	negative
fahnden	negative
fahren	negative
fahrgenuss	negative
fahrt	negative
fahrvergnügen	negative
faible	negative
fair	negative
fairness	negative
fakt	negative
faktisch	negative
faktor	negative
faktum	negative
fakultät	negative
fall	negative
fallschirmspringen	negative
falsch	negative
falschheit	negative
falsifikat	negative
falzen	negative
familie	negative
familienangehörige	negative
familienangehöriger	negative
familienbesitz	negative
familieneigentum	negative
familienmitglied	negative
fanal	negative
fangbetrieb	negative
fangemeinde	negative
fantasie	negative
fantastisch	negative
farbe	negative
farbig	negative
farblos	negative
farbpigment	negative
farbstoff	negative
faschismus	negative
faser	negative
fassade	negative
fassen	negative
fassungslosigkeit	negative
faul	negative
faulheit	negative
fauna	negative
faustregel	negative
fazit	negative
fdp	negative
fechten	negative
fechtsport	negative
federball	negative
feeling	negative
fehde	negative
fehleranalyse	negative
fehlerhaft	negative
fehlgeburt	negative
fehlleistung	negative
fehlschlag	negative
fehlschlagen	negative
fehlverhalten	negative
feige	negative
feigheit	negative
feilen	negative
feind	negative
feindesland	negative
feindin	negative
feindschaft	negative
feinfühlig	negative
feingefühl	negative
feinheit	negative
feinnervig	negative
feinnervigkeit	negative
feld	negative
feldbau	negative
feldstärke	negative
feldzug	negative
fell	negative
felsberg	negative
feminismus	negative
ferienort	negative
fernsehzuschauer	negative
fernsehzuschauerin	negative
fernweh	negative
fertig	negative
fertigen	negative
fest	negative
festhalten	negative
festigen	negative
festigkeit	negative
festlichkeit	negative
festmachen	negative
feststehen	negative
festtrocknen	negative
fetzeln	negative
fetzen	negative
feuer	negative
feuerkampf	negative
fiasko	negative
fibel	negative
fick	negative
fidel	negative
fieber	negative
fiedeln	negative
fies	negative
fighter	negative
fiktiv	negative
filmen	negative
finanzausstattung	negative
finanzierung	negative
finanzmittel	negative
finden	negative
finder	negative
finderin	negative
fingerspitzengefühl	negative
finne	negative
finte	negative
firmament	negative
firmengruppe	negative
firmenleitung	negative
fischerdorf	negative
fischerei	negative
fischwirtschaft	negative
fitness	negative
fitnesstraining	negative
flachglas	negative
flair	negative
flau	negative
flaute	negative
flechte	negative
flecken	negative
fleisch	negative
fleischfarben	negative
fleiss	negative
fleissig	negative
fleissigkeit	negative
flensburg	negative
flexion	negative
fliegen	negative
fliegerei	negative
flocken	negative
flop	negative
floppen	negative
flor	negative
flora	negative
flugbenzin	negative
fluggesellschaft	negative
fluglinie	negative
flugsport	negative
flugzeug-treibstoff	negative
fluktuieren	negative
flurschaden	negative
flüchtling	negative
flüssigkeit	negative
folge	negative
folter	negative
form	negative
formaldehyd	negative
formalie	negative
formalität	negative
formen	negative
formmaterial	negative
formsache	negative
formstoff	negative
forsch	negative
forscher	negative
forscherin	negative
forstwesen	negative
forstwirtschaft	negative
fortbringung	negative
fortdauernd	negative
fortlegen	negative
fortnehmen	negative
fortpflanzen	negative
fortpflanzungstrieb	negative
forträumung	negative
fortschaffung	negative
fortune	negative
forum	negative
fotoalbum	negative
frage	negative
fragestellung	negative
fragilität	negative
fragmentarisch	negative
fragwürdig	negative
fraktion	negative
fraktionsdisziplin	negative
fraktionszwang	negative
frankfurt	negative
frankfurt an der oder	negative
frau	negative
frauenschuh	negative
frechheit	negative
frei	negative
freie demokratische partei	negative
freier	negative
freiersfüsse	negative
freihalten	negative
freilassen	negative
freilegen	negative
freimachen	negative
freistadt	negative
fremde	negative
fremder	negative
fremdkörper	negative
fremdling	negative
frequent	negative
fressen	negative
freude	negative
freudenhaus	negative
freudig	negative
freudlos	negative
freuen	negative
freund	negative
freundin	negative
freundlichkeit	negative
freundschaft	negative
freundschaftlich	negative
friedfertig	negative
friedfertigkeit	negative
friedhof	negative
friedlich	negative
friedliebend	negative
froh	negative
froh gestimmt	negative
frohgemut	negative
frohsinn	negative
frommen	negative
fruchten	negative
frust	negative
frustration	negative
frustriert	negative
fräulein	negative
fröhlich	negative
fröhlichkeit	negative
frömmigkeit	negative
fulda	negative
fund	negative
fundamental	negative
fungieren	negative
funktionalisieren	negative
furcht	negative
furchtbar	negative
fusion	negative
fusionierung	negative
fussball	negative
fussballspiel	negative
fussballsport	negative
fällig	negative
fälschen	negative
fälschlich	negative
fälschung	negative
förderer	negative
fördererin	negative
fördern	negative
förderung	negative
förderverein	negative
förmlich	negative
fügen	negative
fügsamkeit	negative
fühlen	negative
führung	negative
füllen	negative
füllstoff	negative
fürchten	negative
fürchterlich	negative
fürsorglichkeit	negative
fürstlich	negative
gabe	negative
gabun	negative
galaxis	negative
galle	negative
gallenblase	negative
ganz	negative
ganzheitlich	negative
garn	negative
garten eden	negative
gartenpflanze	negative
gas	negative
gast	negative
gastfreundlichkeit	negative
gastfreundschaft	negative
gastgeber	negative
gastgeberin	negative
gastraum	negative
gastronomie	negative
gaststube	negative
gaststättengewerbe	negative
gatte	negative
gattin	negative
gebaren	negative
gebiet	negative
gebieten	negative
gebilde	negative
geborgenheit	negative
gebot	negative
gebrauchen	negative
gebrauchswert	negative
gebrechen	negative
gebrechlich	negative
gebrochen	negative
geburtsort	negative
gebären	negative
gedanke	negative
gedrungen	negative
gedrückt	negative
gedrücktheit	negative
geduld	negative
gefallen	negative
gefecht	negative
gefilde	negative
gefällig	negative
gefängnisinsasse	negative
gefängnisinsassin	negative
gefühl	negative
gefühl empfindend	negative
gefühllos	negative
gefühllosigkeit	negative
gefühlsarm	negative
gefühlsarmut	negative
gefühlsduselei	negative
gefühlskalt	negative
gefühlskälte	negative
gefühlvoll	negative
gefüllt	negative
gegend	negative
gegengift	negative
gegenmittel	negative
gegenspieler	negative
gegenspielerin	negative
gegenstand	negative
gegenthese	negative
gegenwart	negative
gegenzug	negative
gegenüberstellung	negative
gegner	negative
gegnerin	negative
gehabe	negative
gehaltvoll	negative
geheiss	negative
gehirn	negative
gehoben	negative
gehässig	negative
gehässigkeit	negative
gehäuft	negative
gehölz	negative
gehör	negative
gehörig	negative
geigen	negative
geilenkirchen	negative
geiz	negative
geknickt	negative
gekränkt	negative
gel	negative
gelackmeiert	negative
gelassenheit	negative
geld	negative
geldanlage	negative
geldbetrag	negative
geldkapital	negative
geldmittel	negative
geldsumme	negative
geldvermögen	negative
geleert	negative
gelegen	negative
gelsenkirchen	negative
gelten	negative
geltung	negative
geltungsbereich	negative
gelungen	negative
gelände	negative
gemach	negative
gemahl	negative
gemahlin	negative
gemein	negative
gemeinde	negative
gemeinheit	negative
gemeinschaft	negative
gemisch	negative
gemässigt	negative
gemüt	negative
gemütlich	negative
gemütlichkeit	negative
gemütsbewegung	negative
gemütslage	negative
gemütsverfassung	negative
genehm	negative
geneigtheit	negative
generalisieren	negative
generikum	negative
genesen	negative
geniessbar	negative
genossenschaft	negative
genug	negative
genugtuung	negative
genuss	negative
genügen	negative
genügend	negative
gepäck	negative
gera	negative
geradlinigkeit	negative
geraten	negative
gerecht	negative
gerechtigkeit	negative
gerichtsbote	negative
gerichtsbotin	negative
gering	negative
geringfügig	negative
geringschätzen	negative
geringwertig	negative
gerinnen	negative
geruchsstoff	negative
geruhsam	negative
gesangsstück	negative
gesangsverein	negative
gesangverein	negative
geschehen	negative
geschehnis	negative
geschenk	negative
geschichtsbuch	negative
geschlechtsakt	negative
geschlechtstrieb	negative
geschlechtsverkehr	negative
geschmack	negative
geschmacksverstärker	negative
geschmackvoll	negative
geschwister	negative
geschwulst	negative
geschwür	negative
geschäft	negative
geschäftig	negative
geschäftsführung	negative
geschäftsleitung	negative
geschäftsschädigend	negative
geschäftszweig	negative
gesellschaft	negative
gesellschaft mit beschränkter haftung	negative
gesellschaftsvertrag	negative
gesellschaftsverträglich	negative
gesetz	negative
gesetzesverstoss	negative
gesetzmässigkeit	negative
gesicht	negative
gesichtsausdruck	negative
gesichtszug	negative
gesinnung	negative
gespannt	negative
gespinst	negative
gespött	negative
gespür	negative
gestalt	negative
gestalten	negative
geste	negative
gestellung	negative
gestimmtheit	negative
gestirn	negative
gestreng	negative
gestus	negative
geständnis	negative
gesund	negative
gesunden	negative
gesundet	negative
gesundheit	negative
gesundheitsreform	negative
gesundheitsschädigend	negative
gesundheitsschädlich	negative
getto	negative
getue	negative
getöse	negative
gewalt	negative
gewaltanwendung	negative
gewaltig	negative
gewaltsam	negative
gewalttätig	negative
gewebe	negative
gewerbe	negative
gewerbegebiet	negative
gewerbepark	negative
gewerkschaft	negative
gewicht	negative
gewichtheben	negative
gewichtig	negative
gewinn	negative
gewinnen	negative
gewiss	negative
gewissheit	negative
gewogenheit	negative
gewohnheit	negative
gewächs	negative
gezänk	negative
ghana	negative
gicht	negative
gier	negative
giessen	negative
gift	negative
giftig	negative
giftpflanze	negative
giftstoff	negative
gigantisch	negative
gladiator	negative
gladiatorin	negative
glamour	negative
glanz	negative
glanzleistung	negative
glas	negative
glatt gehen	negative
glaube	negative
glauben	negative
glaubenssystem	negative
glaubensüberzeugung	negative
glaubhaft	negative
glaubwürdig	negative
gleich	negative
gleichartig	negative
gleichartigkeit	negative
gleichberechtigt	negative
gleichgeartet	negative
gleichgestellt	negative
gleichgültig	negative
gleichgültigkeit	negative
gleichheit	negative
gleichklang	negative
gleichmut	negative
gleichnamig	negative
gleichwertig	negative
gleitschirmfliegen	negative
glimpflich	negative
globetrotter	negative
globetrotterin	negative
globus	negative
glorifikation	negative
glorifizierung	negative
glucke	negative
glut	negative
glätten	negative
gläubiger	negative
gläubigerin	negative
gläubigkeit	negative
glücken	negative
glücklichkeit	negative
gmbh	negative
gnroot	negative
gnädig	negative
goldgrube	negative
goldig	negative
golf	negative
golfspiel	negative
golfspielen	negative
golfsport	negative
gosse	negative
gotha	negative
gottesstaat	negative
goutieren	negative
graben	negative
gradlinigkeit	negative
graduell	negative
grantig	negative
gratulant	negative
gratulantin	negative
gratulieren	negative
grau	negative
grauen	negative
graulen	negative
grausam	negative
grausamkeit	negative
grausen	negative
gravierend	negative
gravitation	negative
gravitationskraft	negative
grazie	negative
grazil	negative
graziös	negative
grenzbereich	negative
grenzfrage	negative
grenzgebiet	negative
grenzland	negative
grenzregion	negative
grenzzone	negative
griffig	negative
grimm	negative
grimmig	negative
grippe	negative
groggy	negative
groll	negative
gross	negative
grosseltern	negative
grossenhain	negative
grossenkel	negative
grossenkelin	negative
grossonkel	negative
grossstadt	negative
grosstante	negative
grosstuerei	negative
grotte	negative
grottig	negative
grund	negative
grundlegend	negative
grundregel	negative
grundsatz	negative
grundsätzlich	negative
grundzug	negative
gruppe	negative
grusel	negative
gruseln	negative
grönland	negative
grün	negative
gründeln	negative
gründen	negative
gründer	negative
gründerin	negative
gründlich	negative
grüne	negative
gundelsheim	negative
gunst	negative
gut	negative
gut betucht	negative
gut gehen	negative
gutachten	negative
gutheissen	negative
gutsituiert	negative
gv	negative
gänsehaut	negative
gänzlich	negative
gästebuch	negative
gönnen	negative
görlitz	negative
gültigkeit	negative
günstig	negative
günstling	negative
gürtelrose	negative
gütersloh	negative
gütig	negative
haarsträubend	negative
hab und gut	negative
habe	negative
haben	negative
habgier	negative
habitus	negative
habsucht	negative
hader	negative
hadern	negative
hafenstadt	negative
haftinsasse	negative
haftinsassin	negative
hagen	negative
hahnenkamm	negative
hakenkreuz	negative
halb	negative
halberstadt	negative
halbzeug	negative
halle	negative
halluzination	negative
halt	negative
halten	negative
haltung	negative
hamm	negative
handarbeiten	negative
handball	negative
handballspiel	negative
handballsport	negative
handbuch	negative
handel	negative
handeln	negative
handelnder	negative
handelsbranche	negative
handelsgewerbe	negative
handgreiflich	negative
handgreiflichkeit	negative
handhabung	negative
handling	negative
handlung	negative
handlungsreisende	negative
handlungsreisender	negative
handlungszwang	negative
handwerk	negative
handwerker	negative
handwerkerin	negative
hanebüchen	negative
hang	negative
harfen	negative
harmonie	negative
harmonieren	negative
harsch	negative
hart	negative
hartgesotten	negative
hartherzig	negative
hass	negative
hassen	negative
hasserfüllt	negative
hassliebe	negative
haufen	negative
haupteigenschaft	negative
hauptstadt	negative
hauptsächlich	negative
haus	negative
hausbauer	negative
hausbauerin	negative
haut	negative
hauterkrankung	negative
hautfarben	negative
hautkrankheit	negative
hautverträglich	negative
hautwolf	negative
havarie	negative
havarieren	negative
heben	negative
heftig	negative
hegemonie	negative
hehlerei	negative
heil	negative
heilbronn	negative
heilen	negative
heilmittel	negative
heimat	negative
heimatstadt	negative
heimgehen	negative
heimkehrer	negative
heimkehrerin	negative
heimstatt	negative
heimweh	negative
heini	negative
heiser	negative
heiterkeit	negative
heizöl	negative
hektik	negative
helfen	negative
hellrot	negative
hellwach	negative
hemmen	negative
herabsetzen	negative
heraufbeschwören	negative
herausbrechen	negative
herausfordern	negative
herausholen	negative
herauslassen	negative
herausnehmen	negative
herausreissen	negative
herausräumen	negative
herausätzen	negative
herbeiführen	negative
herbergsvater	negative
herbizid	negative
herne	negative
herold	negative
herr	negative
herrichtung	negative
herrlich	negative
herrschaft	negative
herrschaftsbereich	negative
herstellen	negative
hervorbringen	negative
hervorrufen	negative
herz	negative
herzblatt	negative
herzblut	negative
herzig	negative
herzlich	negative
herzlichkeit	negative
heterogen	negative
hetzerisch	negative
hierarchie	negative
hildesheim	negative
hilfe	negative
hilfreich	negative
hilfsbereit	negative
himmel	negative
himmelfahrt	negative
himmelskörper	negative
himmelsluft	negative
himmelsobjekt	negative
himmlisch	negative
hinausfliegen	negative
hindern	negative
hineinwählen	negative
hinfällig	negative
hinfälligkeit	negative
hingabe	negative
hinhauen	negative
hinlegen	negative
hinnehmbar	negative
hinnehmen	negative
hinreichend	negative
hinrichtungsort	negative
hinspiel	negative
hinterfotzig	negative
hinterhältig	negative
hinterlassenschaft	negative
hintermann	negative
hinwegfegen	negative
hinwendung	negative
hinwirken	negative
hinzufügen	negative
hinüberdämmern	negative
hirn	negative
hirngespinst	negative
hirnrissig	negative
hoch	negative
hochgefühl	negative
hochgehen	negative
hochgenuss	negative
hochgiftig	negative
hochgradig	negative
hochhalten	negative
hochpreisig	negative
hochsprung	negative
hochstimmung	negative
hocke	negative
hockey	negative
hof	negative
hoffen	negative
hoffnung	negative
hoffnungsfroh	negative
hoffnungsfunke	negative
hoffnungslos	negative
hoffnungslosigkeit	negative
hoffnungsschimmer	negative
hoffnungsstrahl	negative
hoffnungsvoll	negative
hoffähig	negative
hoheit	negative
hohlglas	negative
hohn	negative
holding	negative
holen	negative
holz	negative
holzauge	negative
holzpflanze	negative
homburg	negative
homogen	negative
honduras	negative
honey	negative
hooligan	negative
hornhaut	negative
horror	negative
huldreich	negative
human	negative
humanisieren	negative
humanitär	negative
humanität	negative
humor	negative
humorig	negative
humorlos	negative
humorvoll	negative
hundemüde	negative
hunger	negative
husum	negative
hypothek	negative
häme	negative
hämisch	negative
händel	negative
härte	negative
härten	negative
hässlich	negative
hässlichkeit	negative
häufig	negative
häuslebauer	negative
häuslebauerin	negative
häuten	negative
höchstleistung	negative
höflichkeit	negative
höhle	negative
höhnisch	negative
höllisch	negative
hörbuch	negative
hörer	negative
hörerin	negative
hörgenuss	negative
hörvergnügen	negative
hülle	negative
idealismus	negative
identisch	negative
identität	negative
ideologie	negative
ideologisch	negative
idiot	negative
idiotin	negative
illegitim	negative
illusion	negative
illusionslos	negative
illusorisch	negative
image	negative
imagination	negative
imaginär	negative
imitation	negative
immens	negative
immenstadt	negative
immerwährend	negative
immigrant	negative
immigrantin	negative
immun	negative
impertinenz	negative
impetus	negative
impfstoff	negative
implausibel	negative
implizit	negative
impossibel	negative
improvisieren	negative
impuls	negative
inadäquat	negative
inaktivieren	negative
inbrunst	negative
indifferent	negative
indifferenz	negative
indigniert	negative
indigo	negative
indikation	negative
indirekt	negative
indiskutabel	negative
individuum	negative
industriegebiet	negative
industriepark	negative
industrierevier	negative
infam	negative
infamie	negative
infarkt	negative
infekt	negative
infektion	negative
infektionskrankheit	negative
inflationär	negative
ingolstadt	negative
inhaber	negative
inhaberin	negative
inhaltsleer	negative
inhaltslos	negative
inhuman	negative
initialsprengstoff	negative
initiant	negative
initiantin	negative
initiator	negative
initiatorin	negative
innere zustandsveränderung	negative
innig	negative
insasse	negative
insassin	negative
inselstaat	negative
insolvent	negative
insolvenz	negative
inspizieren	negative
inspizierung	negative
instinkt	negative
instituieren	negative
institution	negative
instrumentalist	negative
instrumentalistin	negative
instrumentieren	negative
inständig	negative
integral	negative
integrierend	negative
integrität	negative
intension	negative
intensiv	negative
intensivierung	negative
intention	negative
interagieren	negative
interesse	negative
interesselosigkeit	negative
interessenkonflikt	negative
interessent	negative
interessentin	negative
interessieren	negative
interessiert	negative
interferenz	negative
interhotel	negative
internationalismus	negative
internetbenutzer	negative
internetbenutzerin	negative
internetforum	negative
internetnutzer	negative
internetnutzerin	negative
internetuser	negative
intervall	negative
intervention	negative
intimität	negative
intuitiv	negative
invasor	negative
inventar	negative
ionosphäre	negative
ironie	negative
ironisch	negative
ironisieren	negative
irreal	negative
irreführung	negative
irrelevant	negative
irrig	negative
irritation	negative
irritieren	negative
irrtümlich	negative
irrwitzig	negative
isomer	negative
istanbul	negative
jahrbuch	negative
jahrelang	negative
jahrhundertelang	negative
jahrtausendelang	negative
jahrzehntelang	negative
jasage	negative
jazzen	negative
jemen	negative
jena	negative
jenseits	negative
jerusalem	negative
jever	negative
job	negative
jobsuche	negative
jordanien	negative
jovial	negative
jugendschwimmschein	negative
jungfer	negative
jungfrau	negative
jungfräulichkeit	negative
junggeselle	negative
junggesellin	negative
junker	negative
jupiter	negative
jäger	negative
jägerin	negative
jämmerlich	negative
kabinettstückchen	negative
kadaver	negative
kader	negative
kaff	negative
kaiserschnitt	negative
kaiserslautern	negative
kalifat	negative
kalk	negative
kalt	negative
kaltblütig	negative
kaltherzig	negative
kaltschnäuzig	negative
kamen	negative
kamm	negative
kampagne	negative
kampf	negative
kampfeslustig	negative
kampfkunst	negative
kampflustig	negative
kampfsport	negative
kampfsportart	negative
kanal	negative
kandahar	negative
kandidat	negative
kandidatin	negative
kannibalisch	negative
kantersieg	negative
kapital	negative
kapitalanleger	negative
kapitalanlegerin	negative
kapitale	negative
kapitalismus	negative
kaputtgehen	negative
kaputtmachen	negative
kardinal	negative
karikaturist	negative
karikaturistin	negative
karl-marx-stadt	negative
karlsruhe	negative
karlstadt	negative
kartenzahlung	negative
karthago	negative
kasse	negative
kassel	negative
kastanienrot	negative
kastrieren	negative
katalysator	negative
katar	negative
katastrophal	negative
katechismus	negative
kategorisch	negative
kater	negative
kauf	negative
kaufverhalten	negative
kehl	negative
kehren	negative
kehrseite	negative
keim	negative
keimling	negative
kempten	negative
kennen	negative
kennzeichnend	negative
kerl	negative
kern	negative
kerngesund	negative
kerosin	negative
keton	negative
keusch	negative
keuschheit	negative
kg	negative
kidnappen	negative
kiew	negative
kigali	negative
kind	negative
kinderbuch	negative
kinderfrau	negative
kinderkrankheit	negative
kinderlose	negative
kinderloser	negative
kindeskind	negative
kindlichkeit	negative
kinematik	negative
kirchengemeinde	negative
kirchenvater	negative
kirchgemeinde	negative
klage	negative
klagen	negative
klampfen	negative
klappen	negative
klar	negative
klasse	negative
klassenarbeit	negative
klassiker	negative
klassikerin	negative
klausur	negative
klebe	negative
kleber	negative
klebstoff	negative
kleiderstoff	negative
klein	negative
kleingewachsen	negative
kleinkriegen	negative
kleinstadt	negative
kletterei	negative
klettern	negative
kletterpflanze	negative
klettersport	negative
klima	negative
klimakatastrophe	negative
klimaschädigend	negative
klimaschädlich	negative
klimaverträglich	negative
klimawandel	negative
klimawechsel	negative
klimpern	negative
klingenberg	negative
klon	negative
klotzen	negative
klub	negative
kläger	negative
klägerin	negative
kläglich	negative
klärung	negative
knacken	negative
knacki	negative
knallhart	negative
knapp	negative
knatsch	negative
knicken	negative
kniff	negative
knobeln	negative
knochentrocken	negative
knoten	negative
knuffig	negative
koalition	negative
koblenz	negative
kochbuch	negative
kochfibel	negative
kochsalz	negative
koffein	negative
kohlensäure	negative
kohlenwasserstoff	negative
kohäsion	negative
koitieren	negative
koitus	negative
kolik	negative
kollaps	negative
kollateralschaden	negative
kolonialismus	negative
kolossal	negative
komet	negative
komfortabel	negative
komisch	negative
kommandite	negative
kommanditgesellschaft	negative
kommen	negative
kommerz	negative
kommissar	negative
kommissarin	negative
kommunikationskanal	negative
kommunikationsmedium	negative
kommunikationsmittel	negative
kommunikationstool	negative
kommunikationsweg	negative
kommunismus	negative
kommunist	negative
kommunistin	negative
kommunistische partei deutschlands	negative
kompendium	negative
kompetenz	negative
kompetenzbereich	negative
komplett	negative
komplex	negative
komponieren	negative
kondensat	negative
kondensieren	negative
kondition	negative
konflikt	negative
konform	negative
konfrontation	negative
konjunkturverträglich	negative
konkordant	negative
konkret	negative
konkurrenz	negative
konsens	negative
konsequenz	negative
konservator	negative
konservatorin	negative
konserve	negative
konservieren	negative
konservierungsmittel	negative
konstantinopel	negative
konstanz	negative
konstituieren	negative
konstitution	negative
konstruktiv	negative
konsument	negative
konsumentenschutzgesetz	negative
konsumentin	negative
kontaktsuche	negative
kontaminieren	negative
kontrahent	negative
kontrahentin	negative
kontraproduktiv	negative
kontrolle	negative
kontrollieren	negative
kontroverse	negative
konvention	negative
konvertieren	negative
konzern	negative
kooperative	negative
kopie	negative
kopierer	negative
kopiergerät	negative
kopulieren	negative
korb	negative
korbball	negative
korrigieren	negative
korrodieren	negative
korrupt	negative
korruptheit	negative
kosmos	negative
kostbar	negative
kosten	negative
kostenerstattung	negative
kostenpunkt	negative
kostümierung	negative
kotonisieren	negative
kpd	negative
krach	negative
kraft	negative
kraftlos	negative
kraftstoff	negative
kraftvoll	negative
krampfader	negative
krank	negative
krankheit	negative
krass	negative
kraut	negative
kreditwirtschaft	negative
kreditwürdigkeit	negative
krefeld	negative
kreis	negative
kreissen	negative
kreissitz	negative
kreisstadt	negative
krepieren	negative
kriecherei	negative
kriegerisch	negative
kriegsdienstverweigerer	negative
kriegszug	negative
kriminalisieren	negative
kristall	negative
kritik	negative
kritikastern	negative
kritiker	negative
kritikerin	negative
kritisch	negative
kritisieren	negative
kritteln	negative
kronzeuge	negative
kronzeugin	negative
krux	negative
kräftig	negative
krätze	negative
krümeln	negative
kschg	negative
kulturgenuss	negative
kulturschaffende	negative
kulturschaffender	negative
kummer	negative
kumpan	negative
kumpel	negative
kumpelhaft	negative
kunde	negative
kundin	negative
kunst	negative
kunstfertig	negative
kunstgenuss	negative
kunsthandwerk	negative
kunstmaler	negative
kunstmalerin	negative
kunstschaffende	negative
kunstschaffender	negative
kurdistan	negative
kurieren	negative
kurpfuschen	negative
kursbuch	negative
kurz	negative
kurzfristig	negative
kurzgewachsen	negative
kurzstielig	negative
kurzzeitig	negative
kälte	negative
kämpfer	negative
kämpferin	negative
kärglich	negative
käsen	negative
käufer	negative
käuferin	negative
käuflich	negative
köln	negative
königsberg	negative
königsherrschaft	negative
königslutter	negative
können	negative
körper	negative
körperbehinderung	negative
körperertüchtigung	negative
körperflüssigkeit	negative
körpergewebe	negative
körperhaltung	negative
körpersprache	negative
kühl	negative
kühlen	negative
kümmerlich	negative
künstler	negative
künstlerin	negative
kür	negative
küren	negative
kürprogramm	negative
kürzung	negative
küstenstadt	negative
lack	negative
lackmeiern	negative
laden	negative
ladendiebstahl	negative
ladung	negative
lady	negative
lage	negative
lagerung	negative
lampenfieber	negative
land	negative
landau	negative
landbau	negative
landeshauptstadt	negative
landschaftsverträglich	negative
landshut	negative
landwirtschaft	negative
landwirtschaftsprodukt	negative
landwirtschaftsreform	negative
lang	negative
langatmig	negative
langenau	negative
langenhagen	negative
langeweile	negative
langfristig	negative
langgestielt	negative
langgezogen	negative
langsam	negative
langstielig	negative
langweilen	negative
lapidar	negative
lappen	negative
lastenträger	negative
lastenträgerin	negative
laster	negative
lauf	negative
laufbahn	negative
laufen	negative
lauge	negative
laune	negative
laus	negative
lausig	negative
lautlehre	negative
layout	negative
layouten	negative
leben	negative
lebendig	negative
lebensbejahend	negative
lebenseinstellung	negative
lebenserfahren	negative
lebensfreude	negative
lebensfroh	negative
lebensgenuss	negative
lebensinhalt	negative
lebenskraft	negative
lebenslustig	negative
lebensmittel	negative
lebensmittelhandel	negative
lebensmüde	negative
lebensphilosophie	negative
lebensraum	negative
leber	negative
leberschädigend	negative
leberschädlich	negative
lebewesen	negative
lebhaft	negative
leder	negative
leer	negative
leeren	negative
legasthenie	negative
legierung	negative
legitim	negative
lehrbuch	negative
lehren	negative
lehrfach	negative
lehrmeinung	negative
lehrmeister	negative
lehrmeisterin	negative
lehrsatz	negative
leib	negative
leibesübung	negative
leiche	negative
leichnam	negative
leichtathletik	negative
leichtsinn	negative
leid	negative
leiden	negative
leidenschaft	negative
leidensdruck	negative
leidig	negative
leidlich	negative
leidtragend	negative
leidwesen	negative
leinwand	negative
leipzig	negative
leistung	negative
leitlinie	negative
leitsatz	negative
leitschnur	negative
leitung	negative
lektüre	negative
lepra	negative
lese-rechtschreib-schwäche	negative
lesebuch	negative
lesegenuss	negative
lesen	negative
leser	negative
leserin	negative
lesevergnügen	negative
lethargie	negative
leuchtendrot	negative
leumund	negative
lexik	negative
lexikon	negative
libido	negative
licht	negative
lichtblick	negative
lichtung	negative
liebe	negative
liebenswürdigkeit	negative
liebesfähig	negative
liebeskummer	negative
liebesleben	negative
liebeslied	negative
liebevoll	negative
liebkosung	negative
liebling	negative
lieblosigkeit	negative
liebreich	negative
lied	negative
liederbuch	negative
lieferung	negative
ligatur	negative
lila	negative
lilafarben	negative
lilafarbig	negative
limit	negative
lindern	negative
link	negative
linkslastig	negative
lippstadt	negative
liqueszieren	negative
liquidität	negative
liquor	negative
listen	negative
literatur	negative
literatursprache	negative
lithosphäre	negative
lockern	negative
lockerung	negative
lockstoff	negative
lohnend	negative
lohnenswert	negative
lohnfortzahlung	negative
lokalisieren	negative
lokalität	negative
lokalmatador	negative
lokalmatadorin	negative
london	negative
look	negative
los angeles	negative
losbrechen	negative
loshauen	negative
losketten	negative
loslösen	negative
losmachen	negative
losreissen	negative
losschlagen	negative
losspielen	negative
luckenwalde	negative
ludwigshafen	negative
luft	negative
luftfahrtgesellschaft	negative
luftsport	negative
lust	negative
lustlosigkeit	negative
luxemburg	negative
luzifer	negative
lyriker	negative
lyrikerin	negative
lädieren	negative
lähmen	negative
läppisch	negative
lästig	negative
löschen	negative
lösegeld	negative
lösen	negative
lösung	negative
lückenhaft	negative
lückenlos	negative
lüge	negative
lügnerisch	negative
lüneburg	negative
mache	negative
machen	negative
machenschaft	negative
macht	negative
machtbereich	negative
machtkampf	negative
machtspiel	negative
machtwettkampf	negative
madrid	negative
madrigal	negative
magen	negative
magenverträglich	negative
mahl	negative
mahlzeit	negative
mainmetropole	negative
maintal	negative
mainz	negative
malabo	negative
maler	negative
malerin	negative
mali	negative
maliziös	negative
malmen	negative
management	negative
managen	negative
mangelhaft	negative
manie	negative
manier	negative
manipulation	negative
manipulierung	negative
mann	negative
mannheim	negative
mannigfach	negative
marginal	negative
marienbad	negative
marketing	negative
markgraftum	negative
markt	negative
marktanalyse	negative
marktforschung	negative
marktkapitalisierung	negative
markttag	negative
marrakesch	negative
mars	negative
marter	negative
martialisch	negative
marxismus	negative
maskerade	negative
maskierung	negative
masse	negative
massenhaft	negative
massenpanik	negative
massgebend	negative
massgeblich	negative
massig	negative
massiv	negative
massvoll	negative
masturbation	negative
match	negative
material	negative
materie	negative
materielle zustandsveränderung	negative
matriarchat	negative
matrone	negative
matt	negative
mau	negative
mauerwerk	negative
mauretanien	negative
maxe	negative
maximal	negative
maximalleistung	negative
maxime	negative
maximum	negative
medikament	negative
medium	negative
medizin	negative
meeting	negative
mehren	negative
mehrfach	negative
mehrmalig	negative
meineid	negative
meinung	negative
meinungsmache	negative
meinungsverschiedenheit	negative
meissen	negative
meister	negative
meisterhaft	negative
meisterin	negative
meisterleistung	negative
meisterlich	negative
meistern	negative
mekka	negative
melancholie	negative
melancholisch	negative
meliorieren	negative
menge	negative
mensch	negative
menschenfreundlich	negative
menschenfreundlichkeit	negative
menschenkenntnis	negative
menschenkind	negative
menschenleben	negative
menschenliebe	negative
menschenseele	negative
menschenunwürdig	negative
menschenverachtend	negative
menschenverträglich	negative
menschenwürdig	negative
menschlich	negative
menschlichkeit	negative
mentor	negative
mentorin	negative
meppen	negative
merkur	negative
messergebnis	negative
metropole	negative
miami	negative
miene	negative
mienenspiel	negative
mies	negative
miete	negative
mieter	negative
mieterin	negative
migrant	negative
migrantin	negative
migration	negative
migrationsbewegung	negative
mikroskopisch	negative
milchstrasse	negative
milde	negative
mildern	negative
milieu	negative
militant	negative
millionenstadt	negative
milz	negative
milzbrand	negative
mime	negative
mimik	negative
minderwertig	negative
mineralöl	negative
minimal	negative
minimum	negative
minsk	negative
minus	negative
minutenlang	negative
mischen	negative
mischung	negative
miserabel	negative
missachten	negative
missbehagen	negative
missbrauch	negative
misserfolg	negative
missgelaunt	negative
missgestimmt	negative
missglücken	negative
missgönnen	negative
missgünstig	negative
misslaunig	negative
misslich	negative
misslingen	negative
missraten	negative
missstimmung	negative
misstrauen	negative
mitbürger	negative
mitbürgerin	negative
miteigentümer	negative
miteigentümerin	negative
miteinander	negative
mitempfindung	negative
mitesser	negative
mitfahrer	negative
mitfahrerin	negative
mitfühlen	negative
mitfühlend	negative
mitgefühl	negative
mitgehen	negative
mithilfe	negative
mitleid	negative
mitleidig	negative
mitleidslos	negative
mitmensch	negative
mitmischen	negative
mitplanen	negative
mitschneiden	negative
mitschreiben	negative
mittel	negative
mittelbar	negative
mitwählen	negative
mixtur	negative
mobben	negative
mobbing	negative
mobilisierung	negative
mobilmachung	negative
modellieren	negative
moderat	negative
modulieren	negative
monarchie	negative
monatelang	negative
mongolei	negative
monopolisieren	negative
monrovia	negative
monströs	negative
montevideo	negative
moorleiche	negative
mopsen	negative
moralisch	negative
morbide	negative
morgenstern	negative
motiv	negative
motivation	negative
motiviert	negative
motorsport	negative
motte	negative
motto	negative
muffe	negative
muffensausen	negative
muffig	negative
mull	negative
mulmig	negative
mumbai	negative
mumie	negative
mumm	negative
mundartwörterbuch	negative
mundstellung	negative
murks	negative
musikant	negative
musikantin	negative
musiker	negative
musikerin	negative
musizieren	negative
muskeltonus	negative
muss	negative
musterung	negative
mut	negative
mutlos	negative
mutmassen	negative
mutmasslich	negative
mutter	negative
muttergesellschaft	negative
mutterkuchen	negative
muttersprachler	negative
muttersprachlerin	negative
mächtigkeit	negative
männchen	negative
männlein	negative
männlichkeit	negative
mögen	negative
möglich	negative
mönchengladbach	negative
mörderisch	negative
mörtel	negative
mössingen	negative
müde	negative
müdigkeit	negative
müllheim	negative
münster	negative
mürrisch	negative
müssig	negative
nabelschnur	negative
nachbar	negative
nachbardorf	negative
nachbarin	negative
nachbarland	negative
nachbarstaat	negative
nachbessern	negative
nachdrücklich	negative
nachfahr	negative
nachfahre	negative
nachfolger	negative
nachfolgerin	negative
nachgeburt	negative
nachgeschmack	negative
nachhalten	negative
nachhaltigkeit	negative
nachholen	negative
nachkomme	negative
nachlass	negative
nachlegen	negative
nachlesen	negative
nachmachen	negative
nachrangig	negative
nachschlagen	negative
nachschlagewerk	negative
nachschlagwerk	negative
nachschleifen	negative
nachschub	negative
nachsehen	negative
nachteil	negative
nachtragend	negative
nachwirkung	negative
nachzahlung	negative
nacktheit	negative
nahkampf	negative
nahostkonflikt	negative
nahrung	negative
nahrungsmittel	negative
naivität	negative
namensgleich	negative
namensraum	negative
namensvetter	negative
narbenleder	negative
narr	negative
nass werden	negative
nassau	negative
nationaldemokratische partei deutschlands	negative
nationalsozialismus	negative
nationalsozialist	negative
nationalsozialistin	negative
nationalsozialistische deutsche arbeiterpartei	negative
nationalökonomie	negative
natur	negative
naturgenuss	negative
naturraum	negative
naturstoff	negative
naturverträglich	negative
natürlichkeit	negative
nazi	negative
nazismus	negative
nebenberuf	negative
nebeneffekt	negative
nebensitzer	negative
nebensitzerin	negative
nebensächlich	negative
nebenwirkung	negative
neffe	negative
negativ	negative
negieren	negative
nehmen	negative
neiden	negative
neidisch	negative
neigung	negative
nein	negative
nennen	negative
nennenswert	negative
neptun	negative
nerv	negative
nervenkitzel	negative
nervenschädigend	negative
nervenschädlich	negative
nervenstrang	negative
nervenstärke	negative
nervig	negative
nervosität	negative
nervus	negative
nest	negative
netiquette	negative
netz-etikette	negative
netzball	negative
netzhaut	negative
neubrandenburg	negative
neuerburg	negative
neugier	negative
neugierde	negative
neugierig	negative
neurodermitis	negative
neuruppin	negative
neuseeland	negative
neuss	negative
neutral	negative
ngo	negative
nichte	negative
nichtexistenz	negative
nichtig	negative
nichtregierungsorganisation	negative
nichts	negative
nichtsein	negative
nichtsnutzig	negative
nichtvorhandensein	negative
nieder	negative
niedergedrückt	negative
niedergeschlagen	negative
niedergeschlagenheit	negative
niederkommen	negative
niederlage	negative
niedertracht	negative
niederträchtig	negative
niederträchtigkeit	negative
niederwerfung	negative
niedlich	negative
niedrig	negative
niere	negative
nierenschädigend	negative
nierenschädlich	negative
nimbus	negative
nodus	negative
nominell	negative
nonplusultra	negative
norm	negative
normativ	negative
norwegen	negative
nostalgie	negative
not	negative
notieren	negative
notlüge	negative
notwendig	negative
notwendigkeit	negative
npd	negative
ns	negative
nsdap	negative
nubuk	negative
nubukleder	negative
nummer	negative
nutzbringend	negative
nutzer	negative
nutzerin	negative
nutzlos	negative
nämlich	negative
närrisch	negative
nässen	negative
nötig	negative
nürnberg	negative
nützen	negative
nützlich	negative
oase	negative
oberflächlich	negative
oberflächlichkeit	negative
objekt	negative
objektiv	negative
obligat	negative
obligatorisch	negative
obsession	negative
obstanbau	negative
obstbau	negative
ochsentour	negative
offensiv	negative
oheim	negative
okkupant	negative
okkupantin	negative
okkupator	negative
okkupatorin	negative
oldenburg	negative
oldie	negative
oligarchie	negative
olympiateilnehmer	negative
olympiateilnehmerin	negative
onanie	negative
onkel	negative
onlineforum	negative
onliner	negative
op	negative
operation	negative
opfer	negative
opfergabe	negative
opponent	negative
opponentin	negative
opportun	negative
opportunismus	negative
optieren	negative
optik	negative
optimal	negative
optimieren	negative
optional	negative
oralsex	negative
oralverkehr	negative
orange	negative
orangefarben	negative
orangefarbig	negative
orangen	negative
orchestrieren	negative
ordentlich	negative
ordnung	negative
ordnungsgemäss	negative
ordnungsliebend	negative
organ	negative
organisation	negative
organisieren	negative
organismus	negative
organspende	negative
orgeln	negative
original	negative
ort	negative
orthodox	negative
ortschaft	negative
osnabrück	negative
osteopathie	negative
ostwestfalen-lippe	negative
ottawa	negative
outfit	negative
outsider	negative
oxid	negative
ozonschädigend	negative
ozonschädlich	negative
paderborn	negative
panaschieren	negative
pandemie	negative
panik	negative
panne	negative
panopticon	negative
panoptikum	negative
pantheismus	negative
pantomime	negative
pantomimin	negative
paperback	negative
paradies	negative
paradiesgarten	negative
paradiesisch	negative
paragliding	negative
paramaribo	negative
parasit	negative
pardon	negative
parität	negative
paritätisch	negative
parkett	negative
partei	negative
parteiisch	negative
parteischädigend	negative
partie	negative
partiell	negative
partnerstadt	negative
partnersuche	negative
passau	negative
passend	negative
passieren	negative
passiv	negative
paste	negative
pate	negative
patin	negative
patriarchat	negative
patzen	negative
pause	negative
pedantisch	negative
pein	negative
peinlich	negative
pellen	negative
pendler	negative
pendlerin	negative
penetranz	negative
penibel	negative
pennen	negative
peptidbindung	negative
perfekt	negative
perfektionieren	negative
perfid	negative
perfide	negative
perfidie	negative
perforieren	negative
pergament	negative
permanenz	negative
permissiv	negative
person	negative
personalisieren	negative
personenschaden	negative
persönlichkeit	negative
peru	negative
pessimismus	negative
pessimistisch	negative
petroleum	negative
pfeifen	negative
pferdesport	negative
pflanze	negative
pflanzen	negative
pflanzenbau	negative
pflanzenreich	negative
pflanzenverträglich	negative
pflanzenwelt	negative
pflanzenwurzel	negative
pflegetochter	negative
pflicht	negative
pflichtprogramm	negative
pflichtübung	negative
pflänzchen	negative
pflücken	negative
pforzheim	negative
pfründe	negative
pfusch	negative
pfuschen	negative
pfuscherei	negative
pfuschwerk	negative
philanthropie	negative
philippsburg	negative
phlegma	negative
phlegmatisch	negative
phonologie	negative
physis	negative
pickel	negative
pickelig	negative
picknick	negative
pigment	negative
pigmentfarbstoff	negative
pikiert	negative
pilger	negative
pilgerin	negative
pingpong	negative
pinkel	negative
piratenpartei	negative
pirmasens	negative
placebo	negative
plagen	negative
plagiat	negative
plakativ	negative
planen	negative
planet	negative
planstelle	negative
plastizieren	negative
plattform	negative
platz	negative
platzen	negative
platzhalter	negative
platzhalterin	negative
plausibel	negative
playboy	negative
plazenta	negative
pleite	negative
pleite gehen	negative
pleitieren	negative
plus	negative
poet	negative
poetin	negative
pofen	negative
polen	negative
poliermittel	negative
politur	negative
polizeihauptmeister	negative
polo	negative
pompös	negative
popularität	negative
portugal	negative
porzellan	negative
pose	negative
position	negative
positur	negative
possierlich	negative
posten	negative
potenziell	negative
pottasche	negative
potthässlich	negative
power	negative
pracht	negative
prachtvoll	negative
pragmatisch	negative
prahlerei	negative
praxis	negative
praxisgemeinschaft	negative
preis	negative
prestige	negative
prima	negative
primär	negative
prinzip	negative
privatkunde	negative
privatkundin	negative
privatwirtschaft	negative
privileg	negative
privilegium	negative
probat	negative
probe	negative
probieren	negative
produkt	negative
produktiv	negative
produzieren	negative
profilierung	negative
profit	negative
programmatisch	negative
prominent	negative
promoter	negative
promoterin	negative
promotion	negative
promovend	negative
promovendin	negative
propaganda	negative
propagandist	negative
proponent	negative
proponentin	negative
protest	negative
protzerei	negative
provozieren	negative
prozessieren	negative
prunk	negative
prunkhaft	negative
prunkvoll	negative
prächtig	negative
prädestinieren	negative
prädestiniert	negative
präferenz	negative
präjudizieren	negative
präparat	negative
präsent	negative
präsentation	negative
präsentieren	negative
präsenz	negative
präservieren	negative
prätendent	negative
prätendentin	negative
prüfung	negative
psyche	negative
psychoterror	negative
publikumsliebling	negative
publikumsmagnet	negative
puff	negative
pulen	negative
pulver	negative
punkt	negative
punktestand	negative
puppen	negative
purpurfarben	negative
purpurfarbig	negative
purpurrot	negative
putzen	negative
putzig	negative
pyrrhussieg	negative
pächter	negative
pächterin	negative
quacksalbern	negative
qual	negative
qualifikation	negative
qualifizierung	negative
qualm	negative
querele	negative
quietschfidel	negative
quintessenz	negative
quito	negative
quälen	negative
rabiat	negative
rachsüchtig	negative
radikal	negative
radix	negative
radsport	negative
raffgier	negative
raffinieren	negative
raffiniert	negative
rage	negative
ragen	negative
rahmen	negative
ramponieren	negative
randalieren	negative
randalierer	negative
randaliererin	negative
randfigur	negative
rang	negative
ranke	negative
rar	negative
rassig	negative
ratenzahlung	negative
ratgeber	negative
ratgeberin	negative
rating	negative
rationieren	negative
ratsam	negative
ratzen	negative
raub	negative
rauch	negative
raum	negative
rausch	negative
rausholen	negative
rauslassen	negative
rausreissen	negative
ravensburg	negative
reagens	negative
reagenz	negative
reagieren	negative
reaktion	negative
real	negative
realismus	negative
realistisch	negative
realität	negative
rebbau	negative
rechnen	negative
rechnungswesen	negative
rechtmässig	negative
rechtsbruch	negative
rechtschaffenheit	negative
rechtschreibduden	negative
rechtschreibwörterbuch	negative
rechtsextremismus	negative
rechtsradikalismus	negative
rechtsradikalität	negative
rechtsvorschrift	negative
recklinghausen	negative
redner	negative
rednerin	negative
reell	negative
referenzieren	negative
referenzwerk	negative
reform	negative
reformierung	negative
regel	negative
regelgemäss	negative
regelgerecht	negative
regeln	negative
regelung	negative
regenerieren	negative
regensburg	negative
regenwetter	negative
regierung	negative
regierungsform	negative
regierungspartei	negative
regierungsstelle	negative
regime	negative
register	negative
registrieren	negative
reglung	negative
regularität	negative
regulär	negative
regung	negative
reiberei	negative
reibung	negative
reich	negative
reichhaltig	negative
reichlich	negative
reichtum	negative
reinfall	negative
reinhauen	negative
reinheit	negative
reinigen	negative
reinigung	negative
reinkarnation	negative
reise	negative
reiselust	negative
reisende	negative
reisender	negative
reissen	negative
reiten	negative
reiterei	negative
reitsport	negative
reiz	negative
reizen	negative
reizung	negative
reklamation	negative
relation	negative
relativ	negative
relaxed	negative
relevant	negative
remscheid	negative
rennen	negative
rennrodeln	negative
rennsport	negative
renommee	negative
repressiv	negative
repräsentativ	negative
republikaner	negative
reputation	negative
reservieren	negative
resignieren	negative
resigniert	negative
resistent	negative
resonanz	negative
respekt	negative
respektieren	negative
ressentiment	negative
ressort	negative
resultat	negative
resümee	negative
retina	negative
retten	negative
reutlingen	negative
rezensent	negative
rezensentin	negative
rezension	negative
reüssieren	negative
rheinbach	negative
rheinberg	negative
rheine	negative
rhetor	negative
rheuma	negative
rheumatismus	negative
richten	negative
richtlinie	negative
richtungsweisend	negative
riecher	negative
riesengross	negative
riesenhaft	negative
riesig	negative
rigid	negative
rigidität	negative
rigoros	negative
ring	negative
ringen	negative
rio de janeiro	negative
risiko	negative
ritt	negative
robustheit	negative
rocken	negative
roh	negative
rohr	negative
rohstoff	negative
rolle	negative
rollen	negative
roman	negative
romantik	negative
romantisch	negative
rosa	negative
rosafarben	negative
rosafarbig	negative
rose	negative
rosenheim	negative
rosig	negative
rostrot	negative
rot	negative
routiniert	negative
rubinrot	negative
ruchbar	negative
rudern	negative
rudimentär	negative
ruf	negative
rufmord	negative
rufschädigend	negative
rufschädigung	negative
ruhe	negative
ruhelosigkeit	negative
ruhen	negative
ruhm	negative
ruhr	negative
ruin	negative
rächer	negative
rächerin	negative
rändern	negative
ränkespiel	negative
räumen	negative
räumlichkeit	negative
rötlich	negative
rückerstattung	negative
rückgabe	negative
rücklauf	negative
rückmeldung	negative
rückschlag	negative
rückzahlung	negative
rüd	negative
rüde	negative
rührselig	negative
rührung	negative
rüstig	negative
saarbrücken	negative
saarburg	negative
saat	negative
sachbeschädigung	negative
sachbuch	negative
sache	negative
sachgebiet	negative
sachlich	negative
sachschaden	negative
salbe	negative
salpetersäure	negative
salz	negative
salzgitter	negative
salzmineral	negative
sammlung	negative
sanftmut	negative
santiago de compostela	negative
sarkastisch	negative
satanisch	negative
sattrot	negative
saturn	negative
satz	negative
sauer	negative
saugen	negative
savanne	negative
scene	negative
schablonieren	negative
schablonisieren	negative
schade	negative
schaden	negative
schadenfreude	negative
schadenfroh	negative
schadensfall	negative
schaffen	negative
schafott	negative
schalen	negative
schamatt	negative
schamotte	negative
schande	negative
scharf	negative
scharfschütze	negative
scharfschützin	negative
scharfzüngig	negative
schassen	negative
schattenseite	negative
schaudern	negative
schaulust	negative
schaum	negative
schauspieler	negative
schauspielerin	negative
schein	negative
scheiss	negative
scheitern	negative
scherflein	negative
scherzhaft	negative
scheuen	negative
scheusslich	negative
scheusslichkeit	negative
schicht	negative
schicken	negative
schiefgehen	negative
schieflaufen	negative
schiesserei	negative
schiesspulver	negative
schiffbau	negative
schimpf	negative
schimäre	negative
schindel	negative
schiss	negative
schlacht	negative
schlacke	negative
schlafen	negative
schlaflosigkeit	negative
schlaftrunken	negative
schlag	negative
schlagabtausch	negative
schlagen	negative
schlagwortartig	negative
schlampen	negative
schlecht	negative
schlecht gelaunt	negative
schleim	negative
schleimhaut	negative
schleswig	negative
schleudern	negative
schliessen	negative
schliessung	negative
schlimm	negative
schlucken	negative
schludern	negative
schläfrigkeit	negative
schmach	negative
schmarotzer	negative
schmeicheln	negative
schmeissen	negative
schmelz	negative
schmelze	negative
schmelzen	negative
schmerz	negative
schmerzattacke	negative
schmiergeld	negative
schmuck	negative
schmutzen	negative
schmöker	negative
schnarchen	negative
schneid	negative
schneide	negative
schneidern	negative
schnell	negative
schnippisch	negative
schnittblume	negative
schnorcheln	negative
schnur	negative
schnöde	negative
schock	negative
schockiertheit	negative
schopfheim	negative
schrammen	negative
schreck	negative
schrecken	negative
schrecklich	negative
schreiben	negative
schreiber	negative
schreiberin	negative
schriftsteller	negative
schriftstellerin	negative
schriftsystem	negative
schritt	negative
schrittweise	negative
schroff	negative
schub	negative
schubkraft	negative
schularbeit	negative
schulbuch	negative
schuldner	negative
schuldnerin	negative
schuldverschreibung	negative
schulfach	negative
schultersieg	negative
schusswechsel	negative
schutzgeld	negative
schwach	negative
schwager	negative
schwangerschaft	negative
schwangerschaftsabbruch	negative
schwanken	negative
schwarm	negative
schwarz	negative
schwarzmalerei	negative
schwarzpulver	negative
schwefelwasserstoff	negative
schweinegrippe	negative
schweinfurt	negative
schweissarbeit	negative
schwellkörper	negative
schwerkraft	negative
schwermachen	negative
schwermut	negative
schwermütig	negative
schwerreich	negative
schwertkämpfer	negative
schwertkämpferin	negative
schwerwiegend	negative
schwester	negative
schwiegereltern	negative
schwiegermutter	negative
schwiegersohn	negative
schwiegertochter	negative
schwiegervater	negative
schwimmen	negative
schwimmsport	negative
schwindlig	negative
schwur	negative
schwäche	negative
schwächen	negative
schwägerin	negative
schwängern	negative
schwören	negative
schäbig	negative
schädigen	negative
schädigend	negative
schädigung	negative
schädlich	negative
schäferstündchen	negative
schämen	negative
schätzen	negative
schätzung	negative
schäumen	negative
schönheit	negative
schönheitssinn	negative
schönschreiben	negative
schöpfer	negative
schöpferin	negative
schüchtern	negative
schütter	negative
schütze	negative
schützin	negative
score	negative
sed	negative
seele	negative
seelenlosigkeit	negative
seelenruhig	negative
seelenverfassung	negative
seelenvoll	negative
seelenzustand	negative
sehne	negative
sehnerv	negative
sehnsucht	negative
sein	negative
seite	negative
sektor	negative
sekundär	negative
selbstbefriedigung	negative
selbstbeherrschung	negative
selbstdarsteller	negative
selbstdarstellerin	negative
selbstdisziplin	negative
selbstsicherheit	negative
selbstvertrauen	negative
seller	negative
selten	negative
selters	negative
seltsam	negative
semiotik	negative
sendung	negative
sensibel	negative
sentimental	negative
sentimentalität	negative
sequenzieren	negative
seriosität	negative
servil	negative
setzen	negative
seuche	negative
sex	negative
sexualakt	negative
sexualität	negative
sexualleben	negative
shanghai	negative
sicheinfühlen	negative
sicher	negative
sicherheit	negative
sichern	negative
siebenkampf	negative
siechtum	negative
siedlung	negative
siedlungsraum	negative
sieg	negative
siegel	negative
siegen	negative
sierra leone	negative
signifikant	negative
simplifizieren	negative
simplizieren	negative
sindelfingen	negative
sinn	negative
sinnhaft	negative
sinnig	negative
sinnlichkeit	negative
sinnlos	negative
sinnreich	negative
sinnvoll	negative
sintflutartig	negative
sippe	negative
sippschaft	negative
sitte	negative
sittlich	negative
sittlichkeit	negative
situation	negative
situiert	negative
sitzen	negative
sitzen bleiben	negative
ski	negative
skifahren	negative
skilauf	negative
skisport	negative
skript	negative
soest	negative
sohn	negative
solidarisieren	negative
solingen	negative
soll	negative
solo	negative
solvenz	negative
sommerfrische	negative
song	negative
sonne	negative
sonnenblume	negative
sonnenschein	negative
sonnig	negative
sorge	negative
sorgen	negative
sorgenfrei	negative
sorgenvoll	negative
sorgfältig	negative
sorglos	negative
sorgsam	negative
sozialdemokratische partei deutschlands	negative
sozialist	negative
sozialistin	negative
sozialistische einheitspartei deutschlands	negative
sozietät	negative
spanisch	negative
spannen	negative
spannung	negative
sparen	negative
sparte	negative
spass	negative
spasshaft	negative
spassig	negative
spd	negative
speicherstadt	negative
speise	negative
speisen	negative
speiseröhre	negative
spende	negative
spendengeld	negative
sperrbezirk	negative
sperre	negative
sperren	negative
sperrung	negative
sphäre	negative
spiel	negative
spielen	negative
spieler	negative
spielerin	negative
spielverein	negative
spin	negative
spitz	negative
spitzfindig	negative
spontaneität	negative
spontanität	negative
sport	negative
sportangeln	negative
sportart	negative
sportfreund	negative
sportfreundin	negative
sportgemeinschaft	negative
sportiv	negative
sportklub	negative
sportlich	negative
sportsfreund	negative
sportsfreundin	negative
sportspiel	negative
sportverein	negative
spott	negative
sprachbehinderung	negative
sprache	negative
sprachempfinden	negative
sprachgebiet	negative
sprachgefühl	negative
sprachgemeinschaft	negative
sprachraum	negative
sprachregister	negative
sprachschatz	negative
sprachvariante	negative
sprachverständnis	negative
spray	negative
sprecher	negative
sprecherin	negative
sprechstörung	negative
sprengen	negative
sprengstoff	negative
sprichwörtlich	negative
springreiten	negative
sprinten	negative
sprit	negative
spross	negative
sprössling	negative
spurten	negative
spärlich	negative
spöttisch	negative
spülen	negative
spüren	negative
squaw	negative
staat	negative
staatsbürgerrecht	negative
staatsfeind	negative
staatsfeindin	negative
staatsform	negative
staatshauptstadt	negative
staatskommissar	negative
staatskommissarin	negative
stabilisator	negative
stabilisieren	negative
stabilität	negative
stade	negative
stadt	negative
stadtbezirk	negative
stadtgebiet	negative
stadthagen	negative
stadtverträglich	negative
stahlbeton	negative
stahlhart	negative
stammbaum	negative
stammbuch	negative
stammtafel	negative
stammtisch	negative
stampfen	negative
stand	negative
standesgemäss	negative
standpunkt	negative
stapel	negative
star	negative
stark	negative
stark werden	negative
starr	negative
starrköpfig	negative
starrsinn	negative
stattfinden	negative
statthaft	negative
stattlich	negative
statut	negative
staubsaugen	negative
staude	negative
stechen	negative
stechend	negative
stehen	negative
steigen	negative
steinbruch	negative
steinbruchgelände	negative
steinhart	negative
steinreich	negative
stelldichein	negative
stelle	negative
stellensuche	negative
stellung	negative
stempel	negative
stendal	negative
stenose	negative
sterbebett	negative
sterben	negative
stereotypieren	negative
steuerberater	negative
steuerberaterin	negative
stichwortartig	negative
stiefeltern	negative
stiefkind	negative
stiefmutter	negative
stiefschwester	negative
stieftochter	negative
stiefvater	negative
stiel	negative
stiften	negative
stigmatisieren	negative
stilgerecht	negative
stilsicher	negative
stilvoll	negative
stimme	negative
stimmen	negative
stimmung	negative
stimmungslage	negative
stimmungswandel	negative
stimmungswechsel	negative
stimulierung	negative
stimulus	negative
stinkreich	negative
stocken	negative
stoff	negative
stoffgemisch	negative
stollberg	negative
stolz	negative
stopp	negative
strafe	negative
strafen	negative
straftat	negative
straftäter	negative
straftäterin	negative
strahlkraft	negative
stranden	negative
strasse	negative
straubing	negative
straucheln	negative
streichen	negative
streit	negative
streiter	negative
streiterei	negative
streiterin	negative
streitsüchtig	negative
streng	negative
strenge	negative
strikt	negative
striktheit	negative
stroh	negative
strohwitwe	negative
strohwitwer	negative
studienbereich	negative
stundenlang	negative
stunk	negative
styling	negative
städtchen	negative
ständig	negative
stärke	negative
stärken	negative
stärkung	negative
stätte	negative
stöbern	negative
stören	negative
störung	negative
stümper	negative
stümperhaft	negative
stümperin	negative
stümpern	negative
subjekt	negative
subjektiv	negative
sublimieren	negative
subsidiär	negative
substanz	negative
substrat	negative
subversion	negative
suche	negative
suchen	negative
sucht	negative
suchterkrankung	negative
suchtverhalten	negative
suff	negative
suggestion	negative
sulfid	negative
summe	negative
support	negative
surfen	negative
surfer	negative
surferin	negative
surinam	negative
surreal	negative
swastika	negative
symbiose	negative
sympathie	negative
synthetisieren	negative
system	negative
szene	negative
säen	negative
sägen	negative
säkularisation	negative
sämling	negative
säubern	negative
säuberung	negative
säure	negative
südafrika	negative
süffisant	negative
süss	negative
süsswasser	negative
tagelang	negative
takt	negative
taktgefühl	negative
talent	negative
tangermünde	negative
tannin	negative
tante	negative
tarifkonflikt	negative
taschenbuch	negative
tat	negative
tatenlos	negative
tatkraft	negative
tatkräftig	negative
tatsache	negative
tatsächlich	negative
taufpate	negative
taufpatin	negative
taugen	negative
tauglich	negative
tausch	negative
tauschhandel	negative
tauwetter	negative
tbc	negative
technischer überwachungs-verein	negative
teer	negative
teil	negative
teilen	negative
teilhaber	negative
teilhaberin	negative
teilnahme	negative
teilnahmslosigkeit	negative
teilnehmer	negative
teilnehmerin	negative
teilweise	negative
teilzahlung	negative
teilzeitbeschäftigung	negative
templin	negative
tendenz	negative
tendenziös	negative
tennis	negative
tennisspiel	negative
tennissport	negative
terrain	negative
territorium	negative
terror	negative
test	negative
teuer	negative
teuflisch	negative
text	negative
textbuch	negative
textil	negative
textilstoff	negative
thema	negative
theorem	negative
theorie	negative
therapeutikum	negative
thesaurus	negative
tiefgehend	negative
tiefgreifend	negative
tiefpunkt	negative
tiefreichend	negative
tiefrot	negative
tiefschürfend	negative
tierbändiger	negative
tierbändigerin	negative
tierhaut	negative
tierkadaver	negative
tierkreis	negative
tierlaus	negative
tierreich	negative
tierwelt	negative
tippen	negative
tisch	negative
tischtennis	negative
tischtennisspiel	negative
tischtennissport	negative
titisee-neustadt	negative
titration	negative
tnt	negative
tnt-sprengstoff	negative
tochter	negative
tochtergesellschaft	negative
todesopfer	negative
todesursache	negative
todmüde	negative
token	negative
toleranz	negative
tolerieren	negative
toll	negative
tollkirsche	negative
tollwut	negative
toner	negative
tonus	negative
toppen	negative
toronto	negative
tortur	negative
total	negative
totalitär	negative
tote	negative
totenbett	negative
toter	negative
tour	negative
toxin	negative
toxisch	negative
traditionsreich	negative
tragen	negative
tragisch	negative
training	negative
transfer	negative
transformieren	negative
transport	negative
transportwesen	negative
trauen	negative
trauerspiel	negative
traum	negative
traurig	negative
treff	negative
treffen	negative
treiben	negative
treiber	negative
treiberin	negative
treibhauseffekt	negative
treibsand	negative
treibstoff	negative
trennen	negative
trennmittel	negative
treue	negative
treulosigkeit	negative
trial	negative
trick	negative
trieb	negative
triebfeder	negative
triebkraft	negative
trier	negative
trigger	negative
trinkgeld	negative
trinksucht	negative
trinkwasser	negative
trip	negative
tripolis	negative
trist	negative
tristesse	negative
triumph	negative
trivialisieren	negative
trocknen	negative
trompeten	negative
trostlos	negative
trostlosigkeit	negative
trottel	negative
trug	negative
trunkenheit	negative
trunksucht	negative
trust	negative
trächtigkeit	negative
träger	negative
trägerin	negative
trägerstoff	negative
trägheit	negative
trübsal	negative
trübselig	negative
trübseligkeit	negative
trübsinn	negative
trübsinnig	negative
trübsinnigkeit	negative
trümmerfrau	negative
tuberkulose	negative
tugend	negative
tumor	negative
tumorgewebe	negative
tun	negative
turteltaube	negative
tutor	negative
tutorin	negative
twen	negative
typ	negative
type	negative
typen	negative
tänzer	negative
tänzerin	negative
täter	negative
täterin	negative
tätigkeit	negative
tätlichkeit	negative
täuschung	negative
töten	negative
tüchtig	negative
tückisch	negative
tüfteln	negative
tüv	negative
uelzen	negative
ulm	negative
umbilden	negative
umdenken	negative
umfang	negative
umfangreich	negative
umfassen	negative
umfeld	negative
umgangsform	negative
umgebung	negative
umhäkeln	negative
umhüllung	negative
umkommen	negative
umkreis	negative
umland	negative
umlaufen	negative
umrandeln	negative
umranden	negative
umrennen	negative
umrändeln	negative
umsatteln	negative
umschreiben	negative
umschwung	negative
umsehen	negative
umsetzung	negative
umspielen	negative
umsteigen	negative
umstellen	negative
umwandeln	negative
umwechseln	negative
umwelt	negative
umweltgift	negative
umweltschädigend	negative
umweltschädlich	negative
umweltverträglich	negative
unabdingbar	negative
unabkömmlich	negative
unangebracht	negative
unangemessen	negative
unangenehm	negative
unart	negative
unauffallend	negative
unauffällig	negative
unaufrichtig	negative
unautorisiert	negative
unbarmherzig	negative
unbedarftheit	negative
unbedenklich	negative
unbedeutend	negative
unbedeutsam	negative
unbedingt	negative
unbefugt	negative
unbehagen	negative
unbehaglich	negative
unbekannte	negative
unbekannter	negative
unbelegt	negative
unberechtigt	negative
unbeschwert	negative
unbesetzt	negative
unbestimmtheit	negative
unblutig	negative
unehrlichkeit	negative
unendlich	negative
unentbehrlich	negative
unerbittlich	negative
unerfreulich	negative
unerheblich	negative
unerlässlich	negative
unermesslich	negative
unfair	negative
unfehlbar	negative
unfriede	negative
unfrieden	negative
ungeduld	negative
ungefährdet	negative
ungelegen	negative
ungemütlich	negative
ungerecht	negative
ungeschliffenheit	negative
ungewissheit	negative
ungiftig	negative
unglaubhaft	negative
unglaublich	negative
unglaubwürdig	negative
ungleich	negative
unglück	negative
unglücklich	negative
ungut	negative
ungünstig	negative
unheil	negative
unhöflichkeit	negative
unikat	negative
uninteressiert	negative
uninteressiertheit	negative
universitätscampus	negative
universitätsgelände	negative
universum	negative
unkosten	negative
unkraut	negative
unlust	negative
unmassgeblich	negative
unmenschlich	negative
unmittelbar	negative
unmotiviert	negative
unmöglich	negative
unnötig	negative
unnütz	negative
unnützlich	negative
unparteiisch	negative
unpassend	negative
unrast	negative
unrealisierbar	negative
unrecht	negative
unrechtmässig	negative
unredlichkeit	negative
unrichtig	negative
unrichtigkeit	negative
unruhe	negative
unsachlich	negative
unschuld	negative
unschädlich	negative
unschön	negative
unsicher	negative
unsicherheit	negative
unsinn	negative
unsinnig	negative
unsinnigkeit	negative
unsportlich	negative
unstimmigkeit	negative
unsympathisch	negative
unterbringung	negative
unterdrückerisch	negative
unterfahren	negative
unterfangen	negative
untergrund	negative
unterkühlt	negative
unterlaufen	negative
unterlegen	negative
untermalen	negative
unternehmen	negative
unternehmensführung	negative
unternehmensgruppe	negative
unternehmensleitung	negative
unternehmung	negative
unterrichten	negative
unterrichtsbuch	negative
unterrichtsfach	negative
unterscheidbar	negative
unterscheiden	negative
unterschiedlich	negative
unterspülen	negative
unterstellen	negative
unterstreichen	negative
unterstützen	negative
unterstützend	negative
unterstützung	negative
unterwelt	negative
untrainiert	negative
untreue	negative
untugend	negative
untätig	negative
untätigkeit	negative
unverbindlich	negative
unverfrorenheit	negative
unverfälschtheit	negative
unvergessen	negative
unvergesslich	negative
unvergänglich	negative
unverheiratete	negative
unverheirateter	negative
unverschämtheit	negative
unversöhnlich	negative
unverzichtbar	negative
unvollkommen	negative
unvollständig	negative
unvorstellbar	negative
unwahrheit	negative
unwahrscheinlich	negative
unwesentlich	negative
unwetter	negative
unwichtig	negative
unwirklich	negative
unzufriedenheit	negative
unzulänglich	negative
unzureichend	negative
unzuverlässigkeit	negative
unzweckmässig	negative
uranus	negative
uraufführen	negative
urbanisierung	negative
urenkel	negative
urenkelin	negative
urgrosseltern	negative
urheber	negative
urheberin	negative
urkundenrolle	negative
urlaubsfreude	negative
urlaubsgenuss	negative
urlaubsort	negative
urlaubsvergnügen	negative
ursache	negative
ursprung	negative
ursprünglichkeit	negative
urteil	negative
ururgrosseltern	negative
user	negative
usus	negative
utopisch	negative
vabanquespiel	negative
vakuum	negative
valencia	negative
vancouver	negative
vater	negative
vaterlandsliebe	negative
vegetation	negative
veilchen	negative
veilchenfarben	negative
vene	negative
venus	negative
verabreden	negative
verabredung	negative
verabscheuen	negative
verabscheuungswürdig	negative
verabsolutieren	negative
verachten	negative
verachtung	negative
verallgemeinern	negative
veranlassung	negative
veranstalten	negative
veranstalter	negative
veranstalterin	negative
veranstaltung	negative
verantwortung	negative
verantwortungsbereich	negative
verantwortungsgefühl	negative
verarbeiten	negative
verarmt	negative
verbauen	negative
verbeissen	negative
verbeulen	negative
verbiegen	negative
verbiestern	negative
verbilligen	negative
verbinden	negative
verbindung	negative
verbittert	negative
verblasen	negative
verbot	negative
verbrauchen	negative
verbraucher	negative
verbraucherin	negative
verbrechen	negative
verbreiten	negative
verbuchen	negative
verbürgerlichen	negative
verdammt	negative
verdauen	negative
verdauungsorgan	negative
verderben	negative
verdicken	negative
verdienst	negative
verdingen	negative
verdorben	negative
verdorren	negative
verdrehen	negative
verdriesslich	negative
verdrossen	negative
verdrossenheit	negative
verdruss	negative
verdunkeln	negative
verdächtigen	negative
verdörren	negative
verdünnen	negative
verdünnung	negative
verdüstern	negative
veredeln	negative
verehrer	negative
verehrerin	negative
verein	negative
vereinbarung	negative
vereinfachen	negative
vereinigen	negative
vereinigung	negative
vereinzeln	negative
verenden	negative
verewigen	negative
verfall	negative
verfallen	negative
verfassen	negative
verfasser	negative
verfasserin	negative
verfasstheit	negative
verfassung	negative
verfehlen	negative
verfehlt	negative
verfeinern	negative
verfertigen	negative
verfestigen	negative
verfinstern	negative
verfliessen	negative
verflüssigen	negative
verformen	negative
verfälschen	negative
verfügung	negative
verführen	negative
verführung	negative
vergebung	negative
vergehen	negative
vergelten	negative
vergeltung	negative
vergiften	negative
verglasen	negative
vergnügen	negative
vergnügt	negative
vergnügtheit	negative
vergrösserung	negative
vergucken	negative
vergällen	negative
vergönnen	negative
vergötterung	negative
vergünstigen	negative
vergüten	negative
vergütung	negative
verhalten	negative
verheeren	negative
verheerend	negative
verheilen	negative
verheilt	negative
verherrlichung	negative
verholzen	negative
verhunzen	negative
verhältnis	negative
verhältnismässig	negative
verhärten	negative
verhässlichen	negative
verjüngen	negative
verkalken	negative
verkauf	negative
verkehr	negative
verkehren	negative
verkehrswesen	negative
verkitschen	negative
verkleidung	negative
verkleinerung	negative
verknallen	negative
verknusen	negative
verknüpfen	negative
verkochen	negative
verkoken	negative
verkomplizieren	negative
verkraften	negative
verkrusten	negative
verkrüppeln	negative
verkuppeln	negative
verkäufer	negative
verkäuferin	negative
verkümmeln	negative
verkümmern	negative
verkürzung	negative
verlachen	negative
verlagern	negative
verlanden	negative
verlandung	negative
verlangen	negative
verlangsamen	negative
verlassen	negative
verlauf	negative
verlegen	negative
verleiden	negative
verleiten	negative
verleitung	negative
verletzt	negative
verleumden	negative
verleumdung	negative
verlieben	negative
verliebt	negative
verliebtheit	negative
verliebtsein	negative
verlogen	negative
verlogenheit	negative
verlust	negative
verlustieren	negative
verlässlichkeit	negative
vermahlen	negative
vermarktung	negative
vermehren	negative
vermeintlich	negative
vermenschlichen	negative
vermerken	negative
vermiesen	negative
vermieter	negative
vermieterin	negative
vermindern	negative
vermuten	negative
vermächtnis	negative
vermögend	negative
vermüllen	negative
vernarben	negative
verneinen	negative
verneinung	negative
vernichten	negative
vernichtend	negative
vernichtung	negative
vernunft	negative
vernutzen	negative
verpacken	negative
verpassen	negative
verpatzen	negative
verpflichten	negative
verpuffen	negative
verpönen	negative
verraten	negative
verrauchen	negative
verrecken	negative
verrennen	negative
verringern	negative
verrohen	negative
verruf	negative
verrussen	negative
verröcheln	negative
versagen	negative
versandhandel	negative
versauen	negative
verschalen	negative
verschandeln	negative
verschandelung	negative
verschieben	negative
verschieden	negative
verschiedenartig	negative
verschiessen	negative
verschlafen	negative
verschlagen	negative
verschlechtern	negative
verschliessen	negative
verschlimmbessern	negative
verschlimmern	negative
verschluss	negative
verschmerzen	negative
verschmutzen	negative
verschnellern	negative
verschorfen	negative
verschroten	negative
verschulden	negative
verschulen	negative
verschwinden	negative
verschüchtern	negative
versehren	negative
versengen	negative
versimpeln	negative
versorgung	negative
versperren	negative
verspielen	negative
verspiessern	negative
verstehen	negative
versteigerung	negative
verstellen	negative
verstetigen	negative
verstimmt	negative
verstimmung	negative
verstricken	negative
verstromen	negative
verstädterung	negative
verständigungsmittel	negative
verstärken	negative
verstärkung	negative
versuch	negative
versuchen	negative
versäumen	negative
versöhnung	negative
versüssen	negative
vertanzen	negative
verteidigen	negative
verteilen	negative
verteilung	negative
verteuern	negative
vertonen	negative
vertragen	negative
vertrauen	negative
vertrauensfrage	negative
vertrauenswürdig	negative
vertretbar	negative
vertrieb	negative
vertrocknen	negative
verträglich	negative
verunglücken	negative
verunsichern	negative
verunsicherung	negative
verunstalten	negative
verunstaltung	negative
verunzierung	negative
verursachen	negative
verursacher	negative
verursachung	negative
verve	negative
vervielfältigung	negative
vervollkommnen	negative
verwahrung	negative
verwandeln	negative
verwandte	negative
verwandter	negative
verwandtschaft	negative
verwandtschaftsbeziehung	negative
verwenden	negative
verwendung	negative
verwerfen	negative
verwildern	negative
verwirrt	negative
verwischen	negative
verwittern	negative
verwünschen	negative
verwüsten	negative
verzagen	negative
verzapfen	negative
verzaubern	negative
verzeichnen	negative
verzeihend	negative
verzeihung	negative
verzerren	negative
verzichtbar	negative
verziehen	negative
verzuckern	negative
verzwecklichen	negative
verzweifeln	negative
verzweiflung	negative
verzweigen	negative
verändern	negative
veränderung	negative
veränderung der farbe	negative
verärgert	negative
verätzen	negative
veräusserlichen	negative
veröden	negative
veröffentlichen	negative
verölen	negative
vetter	negative
vibration	negative
victoria	negative
viel	negative
vielfach	negative
vientiane	negative
viktualien	negative
violent	negative
violett	negative
virtuos	negative
virtuose	negative
virtuosin	negative
vitalität	negative
vogel	negative
vokabular	negative
volksherrschaft	negative
voll	negative
vollautomatisieren	negative
volleyball	negative
vollkommen	negative
vollmüllen	negative
vollständig	negative
vollwertig	negative
vollzählig	negative
volumen	negative
vorahnung	negative
vorausplanen	negative
voraussehen	negative
voraussicht	negative
voraussichtlich	negative
vorauszahlung	negative
vorbauen	negative
vorbereiten	negative
vorbereitung	negative
vorbestellen	negative
vorbestimmt	negative
vorbeugen	negative
vordergründig	negative
vordermann	negative
voreingenommen	negative
vorfahr	negative
vorfall	negative
vorfeld	negative
vorfeldbereich	negative
vorfinden	negative
vorfreude	negative
vorgeblich	negative
vorgefühl	negative
vorgreifen	negative
vorgänger	negative
vorgängerin	negative
vorhaltung	negative
vorhandensein	negative
vorhersicht	negative
vorkehrung	negative
vorkommen	negative
vorkommnis	negative
vorlage	negative
vorliebe	negative
vorliebnehmen	negative
vornehmen	negative
vornehmheit	negative
vornehmlich	negative
vorplanen	negative
vorrangig	negative
vorschrift	negative
vorschriftsgemäss	negative
vorschriftsmässig	negative
vorsorgen	negative
vorspiel	negative
vorstellbar	negative
vorstellen	negative
vorstellung	negative
vorstellungskraft	negative
vorstellungsvermögen	negative
vorstoss	negative
vorteil	negative
vorverkauf	negative
vorwiegend	negative
vorwurf	negative
vorzeigbar	negative
vorzug	negative
votieren	negative
votum	negative
völlig	negative
wach	negative
wachhalten	negative
wachs	negative
wagen	negative
wagnis	negative
wahlausgang	negative
wahlbetrug	negative
wahlentscheidung	negative
wahlerfolg	negative
wahlergebnis	negative
wahlkampagne	negative
wahlkampf	negative
wahlmanipulation	negative
wahlniederlage	negative
wahlresultat	negative
wahlschlappe	negative
wahlsieg	negative
wahlvolk	negative
wahrhaft	negative
wahrhaftig	negative
wahrhaftigkeit	negative
wahrheit	negative
wahrheitsgemäss	negative
wahrnehmung	negative
wahrscheinlich	negative
waldlichtung	negative
waldwirtschaft	negative
wales	negative
walten	negative
walzen	negative
wandel	negative
wandeln	negative
wanderung	negative
wanderungsbewegung	negative
warstein	negative
warze	negative
waschen	negative
waschleder	negative
wasser	negative
wasserball	negative
wassersport	negative
wasserstoffbrücke	negative
wasserstoffbrückenbindung	negative
wassersucht	negative
waterpolo	negative
webforum	negative
webuser	negative
webware	negative
wechsel	negative
wechseln	negative
wechselwirkung	negative
wechselwähler	negative
wechselwählerin	negative
wecken	negative
wedel	negative
weg	negative
wegbrechen	negative
wegbringen	negative
wegbringung	negative
weglegen	negative
wegmachen	negative
wegnehmen	negative
wegräumung	negative
wegschaffen	negative
wegschaffung	negative
wegstecken	negative
wegtun	negative
wegwerfgesellschaft	negative
weh	negative
wehe	negative
wehmut	negative
wehr	negative
wehrdienstverweigerer	negative
wehrtauglichkeitsprüfung	negative
wehwehchen	negative
weib	negative
weiblichkeit	negative
weichbild	negative
weichen	negative
weiden	negative
weihnachtsgeschenk	negative
weihrauch	negative
weihwasser	negative
weinbau	negative
weit	negative
weiterführen	negative
weitermachen	negative
weiterwissen	negative
weitführend	negative
weitgehend	negative
weitreichend	negative
weitsprung	negative
welken	negative
wels	negative
welt	negative
weltall	negative
weltanschauung	negative
weltbild	negative
weltenbummler	negative
weltenbummlerin	negative
weltenbürger	negative
weltenbürgerin	negative
weltenraum	negative
welterfolg	negative
welthandel	negative
weltkugel	negative
weltmeisterschaft	negative
weltraum	negative
weltsicht	negative
weltsprache	negative
weltstadt	negative
weltuntergangsstimmung	negative
weltverständnis	negative
weltwirtschaft	negative
wende	negative
wenig	negative
werben	negative
werdau	negative
werdegang	negative
werden	negative
werfen	negative
werk	negative
werksleitung	negative
werkstoff	negative
wert	negative
wertgegenstand	negative
wertlos	negative
wertpapier	negative
wertsache	negative
wertschätzen	negative
wertschätzung	negative
wertung	negative
wertverlust	negative
wertvoll	negative
wesenszug	negative
wesentlich	negative
wettbewerb	negative
wetter	negative
wetterin	negative
wetterlage	negative
wettkampf	negative
wettspiel	negative
wetzlar	negative
wichtig	negative
widerlich	negative
widerwille	negative
widerwärtig	negative
widrig	negative
wiederholen	negative
wiederwählen	negative
wild	negative
wilderer	negative
wildleder	negative
wilhelmshaven	negative
windhuk	negative
winken	negative
wintersport	negative
wintersportart	negative
wirbel	negative
wirken	negative
wirklich	negative
wirklichkeit	negative
wirkstoff	negative
wirkung	negative
wirkungsbereich	negative
wirkungsfeld	negative
wirkungskreis	negative
wirkungsspektrum	negative
wirtschaft	negative
wirtschaftssystem	negative
wirtschaftsverträglich	negative
wirtschaftszweig	negative
wissbegierig	negative
wissen	negative
wissenschaft	negative
wissensdurstig	negative
wittenberg	negative
wittenberge	negative
wittern	negative
witterung	negative
witwe	negative
witwer	negative
witz	negative
witzenhausen	negative
witzig	negative
wochenlang	negative
wohl	negative
wohlfühlen	negative
wohlgefallen	negative
wohlgeformt	negative
wohlhabend	negative
wohnen	negative
wohngemeinschaft	negative
wohnraum	negative
wolf	negative
wolfsburg	negative
worms	negative
wortfeld	negative
wortschatz	negative
wrack	negative
wucherung	negative
wucht	negative
wuchtig	negative
wunder	negative
wunderdroge	negative
wundermittel	negative
wundern	negative
wunsch	negative
wuppertal	negative
wurf	negative
wurm	negative
wurzel	negative
wut	negative
wählen	negative
wähler	negative
wählerin	negative
wählerschaft	negative
wählerverzeichnis	negative
wähnen	negative
wärme	negative
wärmen	negative
wörterbuch	negative
würde	negative
würgen	negative
würzburg	negative
würze	negative
wüste	negative
wütend	negative
xanten	negative
yin	negative
yoga	negative
zagreb	negative
zahlen	negative
zahlensystem	negative
zahlreich	negative
zahlung	negative
zahlungsfähigkeit	negative
zahlungsmittel	negative
zahlungsmoral	negative
zahlungsunfähig	negative
zahlungsunfähigkeit	negative
zank	negative
zankapfel	negative
zanksüchtig	negative
zart	negative
zartbesaitet	negative
zartheit	negative
zaungast	negative
zehnkampf	negative
zeichentheorie	negative
zeichnen	negative
zeitfahren	negative
zeitgenosse	negative
zeitgenossin	negative
zeitigen	negative
zeitlos	negative
zeitreise	negative
zeitungsleser	negative
zeitungsleserin	negative
zeitwert	negative
zeitzeuge	negative
zeitzeugin	negative
zelle	negative
zellstoff	negative
zellulose	negative
zement	negative
zentral	negative
zerbersten	negative
zerbomben	negative
zerbrechen	negative
zerbrechlichkeit	negative
zerbröseln	negative
zerdeppern	negative
zerfahren	negative
zerfallen	negative
zerfleischen	negative
zerfliessen	negative
zerfransen	negative
zerfressen	negative
zerfräsen	negative
zerfurchen	negative
zergehen	negative
zerhauen	negative
zerkloppen	negative
zerknallen	negative
zerkrümeln	negative
zerlaufen	negative
zerlöchern	negative
zermalmen	negative
zermürben	negative
zernagen	negative
zernichten	negative
zerplatzen	negative
zerreissen	negative
zerrinnen	negative
zerrissenheit	negative
zerrupfen	negative
zerschiessen	negative
zerschlagen	negative
zerschlitzen	negative
zerschrammen	negative
zersetzen	negative
zersingen	negative
zersplittern	negative
zersprengen	negative
zerstampfen	negative
zerstechen	negative
zerstreuen	negative
zerstrittenheit	negative
zerstören	negative
zerstörer	negative
zerstörerin	negative
zerstörerisch	negative
zerstörung	negative
zertrümmern	negative
zeug	negative
zeuge	negative
zeugen	negative
zeugin	negative
ziegel	negative
ziegelstein	negative
ziehen	negative
ziehtochter	negative
ziehvater	negative
ziel	negative
zielkonflikt	negative
zielsprache	negative
zielweisend	negative
ziemlich	negative
zierblume	negative
zierlich	negative
zig	negative
zimmerpflanze	negative
zivi	negative
zivil	negative
zivilcourage	negative
zivildienstleistender	negative
zivilist	negative
zivilistin	negative
zivilperson	negative
zoff	negative
zorn	negative
zornig	negative
zubereiten	negative
zucht	negative
zucker	negative
zuckerkrankheit	negative
zufrieden	negative
zufriedengeben	negative
zufriedenheit	negative
zufriedenstellend	negative
zug	negative
zugabe	negative
zugehen	negative
zugkraft	negative
zugzwang	negative
zuhörer	negative
zuhörerin	negative
zukippen	negative
zukommen	negative
zumüllen	negative
zuneigung	negative
zungenschlag	negative
zunichtemachen	negative
zupfen	negative
zur welt bringen	negative
zureichend	negative
zurichten	negative
zurückberufen	negative
zurückhaltend	negative
zurückscheuen	negative
zurückschrecken	negative
zurücksinken	negative
zurückweisung	negative
zurückwerfen	negative
zurückziehen	negative
zusammenballen	negative
zusammenbringen	negative
zusammenbruch	negative
zusammenfügen	negative
zusammenfügung	negative
zusammenführen	negative
zusammenhangskraft	negative
zusammenschlagen	negative
zusammenschluss	negative
zusammenspielen	negative
zusammentreffen	negative
zusatz	negative
zusatzstoff	negative
zuschauer	negative
zuschauerin	negative
zuschlag	negative
zuseher	negative
zuseherin	negative
zustand	negative
zustande bringen	negative
zustimmen	negative
zuständigkeit	negative
zuständigkeitsbereich	negative
zuteilen	negative
zuteilung	negative
zuträglich	negative
zuverlässigkeit	negative
zuversicht	negative
zuversichtslos	negative
zuwege bringen	negative
zuwendung	negative
zwang	negative
zwanglos	negative
zweck	negative
zweckfrei	negative
zwecklos	negative
zweckmässig	negative
zweibrücken	negative
zweifach	negative
zweifel	negative
zweifeln	negative
zweifelnd	negative
zweikampf	negative
zweitrangig	negative
zweitschrift	negative
zwergplanet	negative
zwickau	negative
zwietracht	negative
zwingend	negative
zwist	negative
zyankali	negative
zynisch	negative
zäh	negative
zählen	negative
zähmung	negative
zänkisch	negative
zärtlich	negative
zärtlichkeit	negative
zögerlich	negative
zügeln	negative
zündstoff	negative
zünftig	negative
zürich	negative
ändern	negative
änderung	negative
ängsten	negative
ängstigen	negative
ärger	negative
ärgerlich	negative
ärgern	negative
ärmlich	negative
ästhetik	negative
ästhetisch	negative
äther	negative
ätzen	negative
äugeln	negative
äusserung	negative
öffnen	negative
ökonahrung	negative
ökonomie	negative
ökosystem	negative
öl	negative
örtlichkeit	negative
übel	negative
übel gelaunt	negative
übellaunig	negative
überanpassung	negative
überantwortung	negative
überarbeiten	negative
überblicken	negative
überbordend	negative
überdruss	negative
übereifrig	negative
übereinkommen	negative
übereinkunft	negative
übereinstimmend	negative
übereinstimmung	negative
überempfindlich	negative
überflüssig	negative
übergabe	negative
überkippen	negative
übermut	negative
übermütig	negative
übernahme	negative
übernehmen	negative
überprüfung	negative
überraschung	negative
überreagieren	negative
überschauen	negative
überschlagen	negative
überschwänglich	negative
überschäumend	negative
übersee	negative
übertreten	negative
überweisung	negative
überwiegend	negative
überzeugen	negative
überzeugt	negative
überzeugung	negative
überzug	negative
übung	negative
üppig	negative
