angenehm	positive
ausgezeichnet	positive
besser	positive
bildschön	positive
exzellent	positive
freundlich	positive
gewissenhaft	positive
glücklich	positive
gut	positive
höherwertig	positive
hübsch	positive
korrekt	positive
lieb	positive
nett	positive
positiv	positive
preussisch	positive
regelrecht	positive
richtig	positive
richtiggehend	positive
schön	positive
wunderschön	positive
überlegen	positive
überragend	positive
abträglich	negative
arm	negative
armselig	negative
aufrecht	negative
aufrichtig	negative
bedauerlich	negative
bedauernswert	negative
bequem	negative
boshaft	negative
böse	negative
defizitär	negative
dürftig	negative
edel	negative
edelmütig	negative
ehrlich	negative
ekelerregend	negative
ekelhaft	negative
ekelig	negative
elend	negative
elendig	negative
erbärmlich	negative
erfreulich	negative
falsch	negative
fies	negative
freudig	negative
friedlich	negative
friedliebend	negative
fälschlich	negative
geeignet	negative
gehoben	negative
gemein	negative
geringwertig	negative
herrlich	negative
himmlisch	negative
hässlich	negative
ideal	negative
irrig	negative
irrtümlich	negative
jovial	negative
kläglich	negative
komfortabel	negative
kraftlos	negative
kraftvoll	negative
kräftig	negative
kumpelhaft	negative
kärglich	negative
lückenhaft	negative
mangelhaft	negative
minderwertig	negative
misslich	negative
nachrangig	negative
negativ	negative
niederträchtig	negative
paradiesisch	negative
real	negative
reich	negative
ruchbar	negative
schade	negative
scheusslich	negative
schlecht	negative
schlimm	negative
schwach	negative
schwindlig	negative
schädigend	negative
schädlich	negative
stark	negative
unangenehm	negative
unaufrichtig	negative
unerfreulich	negative
unglücklich	negative
ungünstig	negative
unrecht	negative
unrichtig	negative
unterlegen	negative
unvollkommen	negative
unvollständig	negative
verarmt	negative
verdorben	negative
vermögend	negative
vertrauenswürdig	negative
widerlich	negative
widerwärtig	negative
wirklich	negative
ärmlich	negative
übel	negative
