angenehm	positive
ausgezeichnet	positive
besser	positive
exzellent	positive
freundlich	positive
gewissenhaft	positive
glücklich	positive
gut	positive
höherwertig	positive
hübsch	positive
korrekt	positive
lieb	positive
nett	positive
positiv	positive
preussisch	positive
regelrecht	positive
richtig	positive
richtiggehend	positive
schön	positive
verbindlich	positive
überlegen	positive
überragend	positive
abträglich	negative
anmutig	negative
arm	negative
armselig	negative
aufrecht	negative
aufrichtig	negative
bedauerlich	negative
bedauernswert	negative
behaglich	negative
boshaft	negative
böse	negative
defizitär	negative
dürftig	negative
eingängig	negative
ekelerregend	negative
ekelhaft	negative
ekelig	negative
elend	negative
elendig	negative
erbärmlich	negative
ertragbar	negative
erträglich	negative
falsch	negative
fein	negative
fies	negative
friedlich	negative
friedliebend	negative
froh	negative
froh gestimmt	negative
fälschlich	negative
förmlich	negative
gefällig	negative
gemein	negative
gemütlich	negative
geringwertig	negative
geruhsam	negative
graziös	negative
hässlich	negative
irrig	negative
irrtümlich	negative
kläglich	negative
komplett	negative
kraftlos	negative
kräftig	negative
kärglich	negative
lückenhaft	negative
mangelhaft	negative
minderwertig	negative
misslich	negative
nachrangig	negative
negativ	negative
niederträchtig	negative
ordentlich	negative
ordnungsliebend	negative
pedantisch	negative
peinlich	negative
penibel	negative
ruchbar	negative
schade	negative
scheusslich	negative
schlecht	negative
schlimm	negative
schwach	negative
schwindlig	negative
schädigend	negative
schädlich	negative
stark	negative
unangenehm	negative
unaufrichtig	negative
unerfreulich	negative
unglücklich	negative
ungünstig	negative
unrecht	negative
unrichtig	negative
unterlegen	negative
unvollkommen	negative
unvollständig	negative
verarmt	negative
verdorben	negative
vollständig	negative
vollzählig	negative
widerlich	negative
widerwärtig	negative
wohlgeformt	negative
wunderbar	negative
wundervoll	negative
ärmlich	negative
übel	negative
abgebrannt	neutral
abscheu	neutral
aggressiv	neutral
angeblich	neutral
angriffslustig	neutral
arg	neutral
bankrott	neutral
bedrückend	neutral
befremdlich	neutral
beklemmend	neutral
beknackt	neutral
belastend	neutral
beleidigt	neutral
bescheiden	neutral
beschissen	neutral
blank	neutral
blass	neutral
bleich	neutral
bruchstückartig	neutral
bruchstückhaft	neutral
brutal	neutral
bösartig	neutral
böswillig	neutral
chancenlos	neutral
destruktiv	neutral
diabolisch	neutral
dilettantisch	neutral
dämonisch	neutral
eingeschnappt	neutral
ekel	neutral
ekelgefühl	neutral
eklig	neutral
erfolglos	neutral
ergebnislos	neutral
faul	neutral
fehlerhaft	neutral
feige	neutral
flau	neutral
fragmentarisch	neutral
fragwürdig	neutral
freudlos	neutral
furchtbar	neutral
fürchterlich	neutral
gebrechlich	neutral
gekränkt	neutral
gering	neutral
geschäftsschädigend	neutral
gesundheitsschädigend	neutral
gesundheitsschädlich	neutral
gewalttätig	neutral
giftig	neutral
grottig	neutral
halb	neutral
hasserfüllt	neutral
hinfällig	neutral
hinterhältig	neutral
hämisch	neutral
ideal	neutral
inadäquat	neutral
infamie	neutral
insolvent	neutral
jämmerlich	neutral
kampfeslustig	neutral
kampflustig	neutral
katastrophal	neutral
kontraproduktiv	neutral
kraft	neutral
krank	neutral
kümmerlich	neutral
lausig	neutral
link	neutral
läppisch	neutral
lästig	neutral
lügnerisch	neutral
maliziös	neutral
matt	neutral
mau	neutral
meisterhaft	neutral
meisterlich	neutral
mies	neutral
miserabel	neutral
morbide	neutral
mulmig	neutral
mumm	neutral
nervig	neutral
nichtig	neutral
nichtsnutzig	neutral
niedertracht	neutral
niederträchtigkeit	neutral
nutzlos	neutral
oberflächlich	neutral
parteischädigend	neutral
partiell	neutral
pickelig	neutral
pikiert	neutral
pleite	neutral
potthässlich	neutral
prachtvoll	neutral
prächtig	neutral
rudimentär	neutral
rufschädigend	neutral
satanisch	neutral
sauer	neutral
schaden	neutral
schadenfroh	neutral
scheiss	neutral
schnöde	neutral
schrecklich	neutral
schwarz	neutral
schäbig	neutral
schädigen	neutral
sinnlos	neutral
stümperhaft	neutral
süffisant	neutral
teilweise	neutral
teuflisch	neutral
toxisch	neutral
traurig	neutral
tückisch	neutral
umweltschädigend	neutral
umweltschädlich	neutral
unangemessen	neutral
unauffallend	neutral
unauffällig	neutral
unbehaglich	neutral
unfair	neutral
unfreundlich	neutral
ungemütlich	neutral
ungerecht	neutral
ungut	neutral
unnütz	neutral
unnützlich	neutral
unschön	neutral
unsinnig	neutral
unsportlich	neutral
unsympathisch	neutral
untrainiert	neutral
unwahr	neutral
unzulänglich	neutral
unzureichend	neutral
unzweckmässig	neutral
verfehlt	neutral
verheerend	neutral
verletzt	neutral
verlogen	neutral
vermeintlich	neutral
vernichtend	neutral
verschlagen	neutral
wenig	neutral
wertlos	neutral
widrig	neutral
wild	neutral
wütend	neutral
zahlungsunfähig	neutral
zart	neutral
zerstörerisch	neutral
zweckfrei	neutral
zwecklos	neutral
ärmlich	neutral
