%possmileyanke	positive
&	positive
+1s_	positive
...?	positive
170	negative
36j_	positive
aahhhhh	negative
abgammeln	negative
abkühlen	negative
ablenken	positive
abreiben	positive
affengeil	negative
aladdin	negative
alicia	negative
alihan	positive
alleinsein	negative
allwissend	negative
alsleben	negative
alterego	positive
altfollower	positive
altrosa	positive
amateurfilm	negative
amüsierst	negative
angenehm	positive
angezogenes	positive
anhängsel	positive
animateurinnen	positive
ankotzen	positive
annaanal	positive
anne	negative
annehm	negative
anschliessend	negative
anstossen.	positive
anstrengst	negative
antipasti	positive
antispeziesistisch	positive
apothekenpreise	negative
architekturprogramm	positive
arianagrande	negative
arlette	positive
arm	negative
armselig	negative
aronal	negative
arrogante	negative
arschhure	negative
artistin	positive
arvika	negative
auffallen	negative
aufstellbar	negative
aufzuhübschen	negative
ausgeruhen	negative
ausgezeichnet	positive
auslöffeln	positive
ausstellungsbuch	positive
ausziehen.	negative
authentisch	positive
auto.	positive
autobahnfahrt	positive
autofenster	negative
awkward	negative
awrr	positive
azkaban	positive
azzlack	positive
backpfeifengesicht	negative
bahahaha	negative
ballonseide	negative
bambusrad	negative
bandnudel	negative
bartschatten	negative
basicteil	positive
bastart	positive
basteltisch	negative
bastelworkshop	negative
battlerap	positive
bauchpiercing	positive
bayernfan	negative
beachwaves	negative
bedauernswert	negative
bee5	negative
beileid.	negative
bekippt	negative
belangsendung	negative
bengalkitten	negative
benjoo	negative
benzko	negative
bepusten	negative
bereichernder	positive
berlinert	positive
berufspraktisch	negative
beruhigungstropfen	negative
besamte	negative
beschäftigung	positive
beschämen	negative
besondere	negative
besondertes	positive
bespannen	negative
bespass	positive
besser	positive
besti	negative
bestimnt	positive
betontem	positive
betthase83	negative
bewerbungsfoto	negative
biasliste	negative
biddeschön	negative
bierpulle	positive
biiiitte	positive
bilderkrieg	negative
bildschönes	negative
billkaulitz	positive
birakta	negative
bises	positive
bisshen	negative
bissig	negative
bittesehr	positive
bizarrlady	negative
blackbook	negative
blaf	negative
blasegirl	positive
blas’	negative
blattsalat	positive
blauesbluttour	positive
blechdose	positive
blechern	negative
bleibe	negative
blondhaarig	negative
blondier	negative
blondierung	positive
blouson	positive
blubenkasten	positive
blumenkasten	negative
bluten	negative
bläser	positive
boooar	positive
boooom	negative
boulette	negative
bowser	positive
brauntönen	negative
brisuren	negative
brotkasten	negative
brotteig	negative
bruzzler	positive
budni	positive
bullenhitze	negative
buntstiften	negative
burka	positive
busfenster	positive
bussiknuddel	negative
böse	negative
büchertasche	negative
bühnenoutfits	negative
ca7	negative
califonia	negative
carportsysteme	positive
catha	negative
catscorner	negative
catsitter	positive
chachacha	positive
chalets	positive
chattest	negative
cheef	negative
cheffe	negative
cheo	negative
chinchi	negative
chrischan	positive
christbaumkugel	positive
chönnt	negative
cialaska	negative
cimorelli	positive
clutches	negative
commandante	positive
companytour	positive
cosette	positive
cosplayer	negative
daaaankeschön	negative
daigo	negative
dannw	positive
darf	negative
dascha	positive
dashie	positive
dasitz	negative
dazustellen	negative
deadhorde	positive
deckrüde	positive
deinjanina	positive
desinfektionsmittel	positive
devourment	negative
dikka	negative
diktatorin	positive
dingerchen	positive
dinosaurierskelette	negative
dippen	positive
disneyfilm	negative
disskutieren	negative
dixi	negative
donnerstags	positive
doooooof	negative
dorn	negative
dough	positive
drunder	negative
dschungelbewohner	negative
dunst	negative
dupstep	positive
durchs	negative
dushe	positive
duzö	positive
dwalin	positive
däbak	negative
dänerys	positive
dört	positive
dürftig	negative
eckzahn	positive
edeltraud	negative
eine.	negative
einfallen	negative
einkeilen	positive
einschönes	negative
eiscafe	negative
eitag	positive
ekelerregend	negative
ekelhaft	negative
ekelig	negative
elefantenhaken	negative
elektrisiert	positive
elena	positive
emailadresse	negative
endllich	positive
energielevel	negative
engelnyoga	positive
engländer	negative
entfliegen	positive
entourage	positive
erdbeerjoghurt	positive
erdbeerquark	negative
erdbeertorte	positive
erdloch	positive
erinnern	negative
erlernba	negative
erotikmesse	positive
erotiktreffen	positive
erotisieren	positive
ersmal	positive
ertragbar	negative
ertragen	negative
erwischen	positive
esse.	negative
exorzistin	negative
fabse	negative
facebookprofil	negative
faken	positive
falafeln	negative
fallschirmsprung	positive
falsch	negative
fan.	positive
fanarts	negative
farbenblond	negative
fasr	negative
favo	negative
fernbeziehung	positive
fernweh	negative
ferres	negative
feucht.	positive
feuerwehrauto	positive
fieberblase	negative
fies	negative
filterzigarette	negative
finstre	negative
firmament	positive
firmenfeier	positive
flachmann	negative
flasht	negative
flechte	negative
fliegenausreitdecke	positive
flippig	negative
fluchderkaribik4	negative
flusspferd	positive
followsamislimani	negative
fotofreak	negative
fotostudio	negative
fototapete	positive
frah	negative
franzy	negative
frauenzimmer	positive
freifuss	positive
frein	positive
freitagsgrüsse	negative
freizeittaschen	positive
fressse	positive
freundlich	positive
frieren.	negative
friesen	negative
fritig	positive
frutkoff	negative
frästechnik	negative
frömpel	positive
frühlingsbunt	negative
frühlingsnachmittag	positive
frühstückstweet	positive
führungsgeschick	negative
fünfziger	negative
ganzkörperkontakt	negative
garnit	positive
gartenanlage	negative
gartenführer	positive
gassiservice	negative
geburtstagssteak	positive
gebäudetechnikplaner	positive
gefält	negative
gefühlsecht	positive
gegenstück	positive
gehest	positive
geigenbogen	negative
geiiill	positive
gekomm	positive
geldbeutel	negative
gemein	negative
gemobbt	positive
generall	positive
genähter	positive
gepupst	negative
gerbera	negative
geretweetet	negative
geringwertig	negative
germangoogirls	negative
germanys	negative
geschichtshausaufgaben	positive
geschniegelt	positive
geschwistertag	positive
geschãftshaus	negative
gesellschafterin	negative
gestanden	negative
gestochen.	positive
gestrenge	positive
gesuch	negative
gesundwerd	negative
getellt	positive
gewand	positive
gewimmel	positive
gideon	positive
giesskanne	negative
glasteil	positive
glubschi	negative
glücklich	positive
glücksträne	negative
gogogo	positive
goho	negative
goodgers	positive
googlesuggest	positive
gooooooott	negative
gosche	negative
gouda	positive
grabscht	positive
granatwerfer	negative
grauehaft	negative
grenouille	negative
gripp	positive
grünt	negative
grünzeugs	negative
gschieder	negative
gseht	positive
gstört	negative
guck.	negative
guhut	positive
gut	positive
guteeeeee	positive
guterhalten	positive
gutster	positive
güldenes	negative
habem	negative
hackfleisch	negative
hahaaaaa	negative
hahahahq	positive
haikus	positive
hakle	negative
halskratzen	positive
hamburger.	positive
hammerstimme	negative
hamsterbacken	negative
handynummer.	negative
harpune	positive
hauptact	positive
hauptstrasse	negative
heatte	negative
hegnau	negative
heibe	positive
heilerdemaske	positive
heimkinovergnügen	positive
heir	negative
hellblau	negative
hemdchen	positive
heme	negative
hemngslos	negative
henckels	positive
herrenmagazin	positive
herrensalon	negative
herzenswärme	positive
herzerweichend	positive
herzfreundin	positive
herzförmiger	negative
herzlein	negative
herzlichkeit	negative
hief	negative
hife	positive
hinfahrt	positive
hingehn.	positive
hinte	negative
hintendran.	negative
hintereingang	positive
hinterfotzigen	negative
hitzeschock	negative
hmhmhmmm	negative
hmmm	positive
hochtalentiert	positive
hochzeits	positive
hochzeitstaugliche	positive
hofgartenstrasse	negative
holts	positive
holzbeinen	positive
holzperlenarmband	negative
holzstapel	negative
hooooot	positive
hormon	negative
hotelpool	negative
huiiii	negative
hundepfoten	positive
hurenschön	negative
hälmchen	negative
hängebrüsten	positive
härzlich	positive
hässlich	negative
häää	negative
höherwertig	positive
hübsch	positive
hüftlang	positive
ichat	negative
ich’s	negative
ijemand	negative
impekoven	negative
inen	negative
ingwertee	negative
inne	negative
intellktuell	positive
internet.	positive
irdendwann	negative
irrenhaus	positive
irrig	negative
isst.	negative
ja2	negative
jaaay	positive
jackett	positive
jahrmarkt.	positive
jenne	negative
jessica	positive
jeute	positive
jippi	negative
juicy	positive
jungenhaft	negative
jägerhut	positive
jährlings	positive
jööööö	negative
kackend	positive
kadsen	positive
kaffeeknopf	negative
kaimane	negative
kakashi	negative
kalli	negative
kamerad	negative
kartoffelkiste	positive
kautz	negative
kehlenfick	positive
keldeo	positive
keramikpfannen	negative
kindheitstrauma	positive
kinnschutz	positive
kirschroter	negative
klarlack	positive
klauenseuche	negative
klebestreifen	negative
kleinkariert	positive
kliene	positive
klinge	negative
klischeehaft	negative
klit	positive
kloppis	positive
knabstrupper	negative
kniesocken	positive
knoblauchbrot	negative
knospen	negative
knäul	negative
knüpf	negative
kochvergnügen	negative
kommulitonen	negative
komparse	positive
konservendose	negative
kopfhöhrer	negative
korbsessel	positive
korrekt	positive
kosmetiktaschen	negative
kotzfresse	negative
kramst	positive
krangh	positive
kreissaal	positive
kricht	positive
kriegsgewinnler	positive
krisknapp	positive
kuschelhasen	negative
kutcher	negative
kwanghee	negative
kwangmin	negative
kämpfend	negative
küchenstuhl	negative
laaaaangsam	negative
lacken	positive
lackstiefel	negative
lady.	negative
lallend	negative
lang.	positive
langa	negative
langarmshirt	positive
lastpic	negative
laufsch	negative
lebendig	positive
lebendigkeit	negative
lecki	negative
lede	negative
ledersohle	positive
legging	positive
legokiste	negative
lehne	negative
lehrerpaar	negative
leichtsinnig	positive
lena18	negative
lenkergewicht	positive
liche	positive
lichtdurchflutet	negative
lico	negative
lieb	positive
liebeb	positive
liebesbeziehung	negative
lieblin	positive
lieblingsaccount	negative
lieblingsecke	negative
lieblingsmädchen	positive
lieblingspaar	negative
lieblingsserien	positive
lieblingsspielerin	negative
lieblingsstelle	positive
limetten	negative
loggia	positive
luftgitarre	negative
luise	negative
lulle	negative
lustobjekt	negative
längenvergleich	positive
löchlein	negative
macchina	positive
macheath	negative
machomann	negative
madln	negative
malträtieren	positive
mangelhaft	negative
manniboy	positive
mappe	negative
mathegenie	positive
matheo	negative
matrosinnen	positive
matsche	negative
maul	negative
mauzen	negative
mayo	positive
megaaaaaa	positive
megaheiss	positive
megaorgasmus	positive
megaschlecht	positive
meikel	negative
melitta	positive
melkfett	positive
menchu	negative
menki	positive
menschentiereunddoktoren	negative
metallfresse	negative
mibewohnerin	negative
milchtopf	negative
minderwertig	negative
mindfucked	negative
minidisplay	positive
minütchen	positive
mipm	positive
misaka	negative
misslich	negative
mistig	negative
mitleser	positive
mitmarschieren	positive
mitschi	positive
mitschülerin	positive
mittelalt	positive
mittelmäßiger	positive
mlp	negative
modeln	positive
mohrenkopf	negative
mollis	positive
mopsgeschwindigkeit	positive
motivier	positive
muahahahha	positive
muddah	positive
muddu	positive
mukena	negative
muschi.	negative
musicbase	negative
musst.	negative
myrte	negative
möwengeschrei	positive
müllen	negative
nachrangig	negative
nachschenken	positive
nachtitweet	positive
nachzufaven	negative
nacktsein	negative
naildesigns	negative
naturdarm	negative
negativ	negative
nerft	negative
netrebko	negative
nett	positive
nette.	negative
netzabsturz	negative
nices	positive
nihihi	positive
nikoläuse	negative
nimmst.	positive
nischt	negative
noaaw	negative
nostril	negative
noverryirawan	negative
nuno	negative
nuppel	negative
nuscheln	negative
nöcher	negative
oahr	positive
oasch	positive
obdachloser	positive
oberhonnefeld	positive
oberlippenbart	positive
oberrohr	negative
obieglo	negative
odins	positive
ohringe	positive
okkkk	positive
onkelgordy	negative
ooohhh	negative
oshima	positive
outgun	positive
padawane	negative
pairing	negative
panache	negative
pantel	positive
pappig	positive
parteeyy	negative
partyschlampe	positive
partytop	negative
peppeln	negative
pewds	negative
pflanzkübel	positive
pflegehund	positive
phantasialand	negative
pics	positive
pilsken	negative
pimmels	negative
pinselchen	negative
pippi	positive
pixies	negative
pll.	negative
podenca	positive
pokemons	negative
pooh	positive
porzellanpuppe	positive
positiv	positive
postamt	negative
postbotin	negative
posterwand	positive
praxisschild	positive
preisinger	positive
probiers	negative
propellerflugzeug	positive
quark	positive
rappen	negative
rassestute	positive
rasul	positive
ratte	positive
ratze	negative
ravioli.	positive
rechtschreibschwäche	positive
regtop	negative
reinknieen	positive
reinkommen	negative
reinschiebe	positive
reissverschluss	positive
rhetorikhammer	negative
richtig	positive
riechend	negative
riesendanke	negative
rittersporn	positive
robs	negative
rocke	positive
rom.	negative
rose	negative
rothmann	positive
rotweinkuchen	positive
rted	negative
ruckzuck	negative
rumspacken	negative
rumtrampeln	negative
rumtreiben	positive
runter	negative
runterspringen	negative
runterzählen	negative
röhrenjean	negative
röstung	negative
saju	positive
salamibrote	negative
saminatorgeschichte	negative
sanduhr	negative
saruhiko	positive
sasori	negative
satinbettwäsche	negative
sauber.	negative
schaben	positive
schabernackig	negative
schalalala	negative
schatze	positive
scheisseeeeee	negative
scheußlich	negative
schienst	negative
schippchen	positive
schlacksi	positive
schlagzeug	positive
schlangeneier	positive
schlecht	negative
schlimm	negative
schluchzen	negative
schlumperbüx	positive
schlämpchen	negative
schlön	negative
schmalzen	positive
schmalzstulle	positive
schmatz	positive
schmusehund	negative
schnibben	positive
schnidde	negative
schnupfig	positive
schnuppi	positive
schokoladiger	negative
schokosplittern	negative
schreck	positive
schroff	positive
schrottkiste	negative
schuhmarke	negative
schutzengelbild	negative
schwach	negative
schwanzträger	negative
schwarzbier	negative
schweiß	positive
schwergängig	negative
schwiegermutters	positive
schwin	negative
schwipp	positive
schwungvoll	negative
schwärze	positive
schwörma	positive
schädlich	negative
schälst	negative
schön	positive
scotch	positive
sedona	positive
seintje	positive
selbstzweifelnd	positive
seltsam	negative
sentimental.	negative
sepia	positive
sers	positive
sevi	negative
shanks	positive
sheba	negative
shemale	positive
shou	negative
sica	positive
siemensmitarbeiterin	negative
silikonform	negative
silvity	positive
sis.	positive
skikurs	positive
sklavenschwanz	negative
sleigher	positive
slushy	positive
snapbacks	positive
sobst	negative
sommersocken	negative
sonderbonbons	negative
sonnelicht	negative
sonnenreichen	negative
sonnenstich	negative
sooooooooooooooooooooooo	positive
sooss	positive
sozialromantikhintergrund	negative
spalt	negative
spammercommunity	positive
speculum	positive
spellyournamewithrammsteinsongs	negative
spiegelfotos	positive
spitzenstoff	negative
splittern	positive
spn	negative
spok	positive
sprachs	negative
springbrunnen	negative
stachelschwein	negative
stadessen	positive
stallgemeinschaft	negative
standhaft.	positive
staskowiak	positive
staubfänger	negative
sterben	positive
sternchenverteiler	positive
stiefdad	positive
stiefelabsatz	negative
stilikonen	negative
stillkissen	positive
stimmfang	positive
stimmungsschwankung	negative
stotterst	negative
strickliese	positive
stubenrocker	negative
sturmmaske	positive
stute.	positive
styla	positive
suhlen	negative
superfan	negative
surp	negative
surreal	negative
sushi.	negative
suspektesten	positive
svend	positive
sweeett	positive
sweetdesire	positive
swiet	positive
sänger	negative
süz	negative
tabaluga	positive
tagebart	negative
tagesrhythmus	negative
tagsforlikes	negative
tammara29	negative
tanu	negative
tanzst	positive
tanzstudenten	positive
tanztraining	positive
tarnklamotte	positive
taschenaschenbecher	positive
taschenuhr	negative
tattop	negative
taxifahrer	negative
teeglas	positive
textnachrichten	positive
thailänderin	negative
theaterpädagogin	positive
thefaculty	negative
thehidden	negative
theredcubetv	negative
thommy	positive
timberlands	positive
tischgebet	negative
tittenava	negative
tockner	negative
tonstudio	negative
torchwood	positive
totkrank	positive
trainingsanzug	positive
trashig	negative
trashiger	negative
trashtazmani	negative
trebs	positive
trekkingtour	positive
trocknungsgerät	negative
trolololol	positive
trotzdem.	positive
troya	positive
trüb	negative
twink	positive
twitterabstinent	negative
twitterbar	positive
typie	negative
tölen	positive
türramen	positive
ukelele	positive
ullmann	positive
umgekleidet	negative
umschnalldildos	positive
unaktiv	negative
unangenehm	negative
unbeschreiblich.	negative
unerfreulich	negative
ungelogen	negative
ungezogen	positive
unglücklich	negative
ungünstig	negative
unrecht	negative
unterlegen	negative
unvollkommenheit	negative
unwiderstehli	positive
urinieren	positive
urlaubsende	negative
urlaubsort	positive
uuuuunglaublich	negative
valldemossa	positive
vanilleschote	positive
vegetarierin	positive
velut	positive
vendola	negative
verabscheuen	negative
verblichen	positive
verdorben	negative
verhauen	positive
verhült	negative
verkauffe	positive
verkopfter	positive
vernunftbegabt	negative
vernüftigen	positive
verschisse	positive
verschwörungstweet	positive
versprechs	positive
vertrauensvoll	negative
verziehn	positive
verziere	negative
veräppelt	negative
videooo	negative
vieeeele	negative
vika	positive
vogelnest	positive
voher	positive
vollblut	negative
vollgewichst	negative
vollkommen	positive
vorahnung	negative
vorbeiziehen	positive
vorkochen	positive
vornehmt	negative
voyeur	negative
wackelpudding	positive
warlander	negative
waschsalon	positive
wassern	positive
we	positive
webcamfotos	positive
webdesignerin	negative
weger	positive
weggeboxt	positive
weibsbild	negative
weinkeller	positive
weissesr	negative
weitergepennt	positive
weiterschicken	positive
welpenfotos	negative
wertschätzt	negative
wetterunabhängig	positive
wgds	positive
whatwhat	positive
whoa	negative
wickeltuch	positive
widerlich	negative
widerspenstig	positive
widerwärtig	negative
wievielt	negative
winzermeister	negative
winzigkeit	negative
wixe	negative
wohaa	positive
wohns	negative
wolke.	positive
woodkid	negative
wulli	positive
wundercreme	negative
wunderschöner	negative
wunschhalsband	positive
wunschsongs	negative
wää	positive
wäääh	positive
x215cm	negative
ylva	positive
zackzack	negative
zahnstange	negative
zazabrooklyn	positive
zdz	positive
zehensocken	positive
zerst	positive
zickende	positive
zimmerwand	positive
zitronencreme	positive
zugekniffen	negative
zulenken	positive
zurennt	negative
zurückgrüßen	positive
zuspamt	positive
zuvergessen	negative
zuverlässi	negative
zweizimmerwohnung	negative
zwergdackelwelpen	positive
zwick	negative
zwiebelmett	negative
zwulf	positive
°°	negative
ält	negative
ärmellos	negative
übel	negative
überfressen	positive
überlegen	positive
überlegs	positive
übernacht	positive
überra	negative
überragend	positive
ütendorf	negative
ړײ	negative
‘digga’	negative
❄⛄	negative
🎀	positive
