36j_	positive
aladdin	negative
alicia	negative
angenehm	positive
anschliessend	negative
antispeziesistisch	positive
arm	negative
armselig	negative
arschhure	negative
artistin	positive
ausgezeichnet	positive
ausstellungsbuch	positive
authentisch	positive
azkaban	positive
ballonseide	negative
bedauernswert	negative
benjoo	negative
bespannen	negative
besser	positive
besti	negative
biddeschön	negative
blas’	negative
boooom	negative
buntstiften	negative
böse	negative
catscorner	negative
chattest	negative
cheef	negative
dikka	negative
dschungelbewohner	negative
durchs	negative
duzö	positive
dürftig	negative
ekelerregend	negative
ekelhaft	negative
ekelig	negative
emailadresse	negative
erdloch	positive
erotikmesse	positive
facebookprofil	negative
falsch	negative
fieberblase	negative
fies	negative
fotofreak	negative
freundlich	positive
frutkoff	negative
frühlingsbunt	negative
frühstückstweet	positive
gefühlsecht	positive
gemein	negative
geringwertig	negative
glücklich	positive
guhut	positive
gut	positive
hellblau	negative
hingehn.	positive
hinte	negative
hässlich	negative
höherwertig	positive
hübsch	positive
internet.	positive
irrig	negative
jippi	negative
konservendose	negative
korbsessel	positive
korrekt	positive
kwanghee	negative
lebendigkeit	negative
legging	positive
lehne	negative
liche	positive
lichtdurchflutet	negative
lieb	positive
lieblingsserien	positive
mangelhaft	negative
matheo	negative
minderwertig	negative
misslich	negative
nachrangig	negative
negativ	negative
nett	positive
noaaw	negative
obieglo	negative
onkelgordy	negative
pappig	positive
positiv	positive
richtig	positive
rothmann	positive
scheußlich	negative
schlecht	negative
schlimm	negative
schrottkiste	negative
schwach	negative
schädlich	negative
schön	positive
sica	positive
silvity	positive
sleigher	positive
stachelschwein	negative
stiefdad	positive
superfan	negative
swiet	positive
tanzst	positive
thailänderin	negative
trekkingtour	positive
trolololol	positive
trüb	negative
unangenehm	negative
unerfreulich	negative
unglücklich	negative
ungünstig	negative
unrecht	negative
unterlegen	negative
verabscheuen	negative
verdorben	negative
vogelnest	positive
vollgewichst	negative
whatwhat	positive
widerlich	negative
widerwärtig	negative
winzermeister	negative
wolke.	positive
wunschhalsband	positive
zickende	positive
zwick	negative
übel	negative
überlegen	positive
überragend	positive
