...?	positive
36j_	positive
affengeil	negative
aladdin	negative
alicia	negative
alihan	positive
altfollower	positive
angenehm	positive
anschliessend	negative
anstrengst	negative
antispeziesistisch	positive
arm	negative
armselig	negative
arschhure	negative
artistin	positive
arvika	negative
ausgezeichnet	positive
ausstellungsbuch	positive
authentisch	positive
autofenster	negative
azkaban	positive
ballonseide	negative
bartschatten	negative
bedauernswert	negative
beileid.	negative
benjoo	negative
berufspraktisch	negative
besondertes	positive
bespannen	negative
besser	positive
besti	negative
betontem	positive
biddeschön	negative
blasegirl	positive
blas’	negative
boooom	negative
bowser	positive
budni	positive
buntstiften	negative
böse	negative
catscorner	negative
catsitter	positive
chattest	negative
cheef	negative
cheo	negative
chönnt	negative
cosette	positive
dasitz	negative
deinjanina	positive
dikka	negative
dingerchen	positive
dorn	negative
dough	positive
dschungelbewohner	negative
durchs	negative
duzö	positive
dört	positive
dürftig	negative
eine.	negative
einfallen	negative
ekelerregend	negative
ekelhaft	negative
ekelig	negative
elektrisiert	positive
emailadresse	negative
engelnyoga	positive
erdbeerquark	negative
erdloch	positive
erotikmesse	positive
ertragbar	negative
facebookprofil	negative
falsch	negative
fan.	positive
fanarts	negative
feucht.	positive
feuerwehrauto	positive
fieberblase	negative
fies	negative
filterzigarette	negative
firmenfeier	positive
fluchderkaribik4	negative
fotofreak	negative
frauenzimmer	positive
freundlich	positive
frutkoff	negative
frästechnik	negative
frühlingsbunt	negative
frühstückstweet	positive
ganzkörperkontakt	negative
gassiservice	negative
gefühlsecht	positive
geldbeutel	negative
gemein	negative
gepupst	negative
geringwertig	negative
gestanden	negative
getellt	positive
gewand	positive
gideon	positive
glubschi	negative
glücklich	positive
googlesuggest	positive
grünzeugs	negative
guhut	positive
gut	positive
guteeeeee	positive
gutster	positive
halskratzen	positive
heibe	positive
heilerdemaske	positive
heir	negative
hellblau	negative
herzenswärme	positive
hingehn.	positive
hinte	negative
hmhmhmmm	negative
holzbeinen	positive
holzperlenarmband	negative
hormon	negative
hässlich	negative
höherwertig	positive
hübsch	positive
ijemand	negative
internet.	positive
irrig	negative
jippi	negative
kamerad	negative
kniesocken	positive
knäul	negative
konservendose	negative
korbsessel	positive
korrekt	positive
kreissaal	positive
kricht	positive
kuschelhasen	negative
kwanghee	negative
langarmshirt	positive
lebendigkeit	negative
legging	positive
lehne	negative
lenkergewicht	positive
liche	positive
lichtdurchflutet	negative
lieb	positive
lieblingsserien	positive
lieblingsspielerin	negative
mangelhaft	negative
matheo	negative
maul	negative
melitta	positive
menki	positive
menschentiereunddoktoren	negative
milchtopf	negative
minderwertig	negative
mindfucked	negative
minütchen	positive
misslich	negative
muddah	positive
müllen	negative
nachrangig	negative
nachtitweet	positive
negativ	negative
nett	positive
netzabsturz	negative
noaaw	negative
obdachloser	positive
obieglo	negative
ohringe	positive
onkelgordy	negative
pappig	positive
pimmels	negative
pll.	negative
porzellanpuppe	positive
positiv	positive
probiers	negative
quark	positive
richtig	positive
rothmann	positive
ruckzuck	negative
runter	negative
salamibrote	negative
saruhiko	positive
schatze	positive
scheußlich	negative
schienst	negative
schlangeneier	positive
schlecht	negative
schlimm	negative
schlämpchen	negative
schrottkiste	negative
schwach	negative
schwungvoll	negative
schädlich	negative
schön	positive
sica	positive
silvity	positive
sis.	positive
sleigher	positive
snapbacks	positive
sobst	negative
spellyournamewithrammsteinsongs	negative
sprachs	negative
stachelschwein	negative
stiefdad	positive
suhlen	negative
superfan	negative
surp	negative
swiet	positive
tanzst	positive
tanzstudenten	positive
taxifahrer	negative
thailänderin	negative
theredcubetv	negative
torchwood	positive
trashig	negative
trekkingtour	positive
trolololol	positive
trüb	negative
twink	positive
twitterabstinent	negative
twitterbar	positive
unangenehm	negative
unerfreulich	negative
unglücklich	negative
ungünstig	negative
unrecht	negative
unterlegen	negative
verabscheuen	negative
verdorben	negative
verhauen	positive
verschisse	positive
vika	positive
vogelnest	positive
vollgewichst	negative
waschsalon	positive
weggeboxt	positive
weissesr	negative
wetterunabhängig	positive
whatwhat	positive
widerlich	negative
widerwärtig	negative
winzermeister	negative
wolke.	positive
wundercreme	negative
wunschhalsband	positive
ylva	positive
zickende	positive
zurückgrüßen	positive
zuvergessen	negative
zwick	negative
zwiebelmett	negative
übel	negative
überlegen	positive
überra	negative
überragend	positive
❄⛄	negative
