%negsmileykrampf	positive
%possmiley33333333	negative
%possmiley33333333333333	positive
%possmileyanke	positive
%possmileyguten	negative
%possmileyiesmal	negative
%possmileyino	positive
%possmileyjo	positive
%possmileylg	positive
%possmileymeiner	negative
%possmileysfz	positive
%possmileysie	positive
%possmileyxxx	positive
%possmiley³	negative
&	positive
********	positive
+1s_	positive
...?	positive
170	negative
19+_	positive
23j_	positive
36j_	positive
3h_	negative
48)_	negative
50j_	negative
75c_	positive
8)	positive
:'*	positive
:'dddd	positive
????..	negative
@igippi	positive
aahhhhh	negative
abblättern	positive
abendlich	negative
abendrunde	negative
abendspaziergang	positive
abfucked	negative
abgammeln	negative
abgeritten	positive
abgeschnitten	positive
abhä	negative
abi	negative
abklatschen	positive
abkühlen	negative
abla	positive
ablacht	positive
ablenken	positive
abneigen	positive
abnormal	positive
abnäher	negative
abonnier	negative
abreiben	positive
abschiedsessen	positive
abschiedskuss	negative
abschlecken	negative
abstechen	negative
abstehen	positive
abstossend	negative
abtrocknen	positive
abwechseln	negative
abwechslung.	positive
abzuwichsen	positive
ackern	positive
adelsblass	positive
adipösen	positive
adipöses	positive
adoptier	negative
adoptieren.	positive
adultgermany	negative
affengeil	negative
agressive	negative
ahso	negative
aiii	negative
akazienhonig	negative
aktenmappe	positive
akzent.	positive
aladdin	negative
alarmknopf	negative
alexe	positive
alicia	negative
alihan	positive
alleinsein	negative
allerbestefreundin	positive
allergikerin	positive
allover	positive
alltagsstress	positive
allwissend	negative
almans	negative
aloha	positive
alsleben	negative
alsob	negative
altaïr	negative
alterego	positive
altersgenosse	negative
altfollower	positive
alti	negative
altkräfte	negative
altrosa	positive
alufolie	negative
alüg	negative
amateurfilm	negative
amüsierst	negative
analgeilheit	positive
analspülung	positive
ananashaus	negative
anbrüll	negative
andalusierwallach	positive
andere	negative
andeutung	positive
androidlockxt	negative
anfassen	positive
anfeuer	positive
angehabt	positive
angelkumpel	negative
angenehm	positive
angepisst.	positive
angestrahlt	negative
angezogenes	positive
angora	negative
angst.	positive
anhabe	positive
anhat	negative
anhängsel	positive
animateurinnen	positive
anka	negative
anklingeln	positive
ankotzen	positive
anlehnen	positive
anmotzt	negative
annaanal	positive
annalein	positive
anne	negative
annehm	negative
annna	positive
anny	negative
anschauen	negative
anschliessend	negative
anschmeißen	negative
anschubsen	negative
anspielstation	negative
anspruchvoll	positive
anstarre	positive
anstossen.	positive
anstrengst	negative
antanzen	positive
antennenwels	negative
antipasti	positive
antippen	negative
antispeziesistisch	positive
anzetteln	positive
anzinger	negative
anzugmann	positive
anzünden	negative
anöden	positive
aois	negative
aominecchi	negative
aperitif	negative
apothekenpreise	negative
appaloosa	negative
appaloosapferde	negative
aprikose	positive
arabermix	negative
arbeitsgang	negative
arbeitsgerät	positive
architekturprogramm	positive
arghhh	positive
arianagrande	negative
arkani	negative
arktos	positive
arlette	positive
arm	negative
armfetisch	positive
armselig	negative
aromatisch	positive
aronal	negative
arrogante	negative
arrrw	positive
arschgeburten	positive
arschhure	negative
artigianale	negative
artistin	positive
arvika	negative
as.	negative
askaban	negative
asos	negative
assasine	positive
assis.	positive
asti	positive
astrein	negative
atemanmut	negative
atobe	negative
aua	negative
auaa	positive
aucch	positive
aufen	positive
auffallen	negative
aufgabenliste	positive
aufgegessen.	positive
aufgehn	negative
aufgehübscht	negative
aufgestehen	negative
aufhäng	positive
auflassen	positive
aufpassen	negative
aufreiss	negative
aufsetzen.	positive
aufspritzen	positive
aufstampfen	negative
aufstellbar	negative
auftragskiller	negative
auftrennen	positive
aufwachen.	negative
aufzuhaben	negative
aufzuhübschen	negative
augapfel	negative
augen.	positive
augenbild	positive
augenrand	positive
augustburnsred	negative
auri	negative
ausbrechen	negative
ausdenkst	negative
ausfuhrung	negative
ausgefallene	positive
ausgehoutfit	positive
ausgeruhen	negative
ausgestopfter	positive
ausgestöpselt	positive
ausgezeichnet	positive
ausgie	positive
ausklinken	negative
auslachst	positive
ausladend	negative
ausleeren	positive
auslöffeln	positive
ausm	negative
ausquartieren	negative
ausschauen	positive
ausschlürfen	negative
aussenbox	positive
aussenrum	positive
aussergewöhnl	negative
ausstellungsbuch	positive
auswachsen	positive
auswendiggelernt	positive
auswurf	positive
auswärtsfahrern	negative
auszieh	positive
ausziehen.	negative
auszuckt	negative
authentisch	positive
auto.	positive
autobahnfahrt	positive
autofenster	negative
autokorrekt	positive
autosex	negative
auuuf	negative
auuuuuuch	negative
avada	positive
avatarbildchen	positive
avril	negative
awkward	negative
awrr	positive
awww.	positive
awzm	positive
ayano	positive
ayden	positive
ayranbart	negative
azkaban	positive
azu	negative
azubine	negative
azug	negative
azzlack	positive
baaaam	positive
babyglück	negative
babyparty	positive
babyschühchen	positive
babystrich	negative
backblech	positive
backhund	negative
backpapier	negative
backpfeifengesicht	negative
badeshorts	positive
badezimmertür	positive
badgley	negative
baguettes	positive
bahahaha	negative
bahnbus	negative
bahnhofstunnel	positive
bahnsteig	positive
bahnwaggon	positive
baisers	negative
balkom	negative
balkontisch	negative
ballkönigin	positive
ballonseide	negative
bambusrad	negative
bananenpulli	negative
bandnudel	negative
barfa	positive
barmaids	positive
barreto	negative
bart.	positive
bartansatz	positive
bartargamen	negative
bartschatten	negative
basicteil	positive
bassisten	positive
basslauf	negative
basstard	negative
bastart	positive
basteltisch	negative
bastelworkshop	negative
batmobil	positive
battlerap	positive
bauchfreiem	negative
bauchkette	negative
bauchpiercing	positive
bauchtaschen	positive
bauernbengel	negative
baumblüte	positive
baumkrone	negative
baun	negative
bauschaum	negative
bayernfan	negative
beachwaves	negative
beautyvideos	negative
bebiii	positive
bedauernswert	negative
bee5	negative
befehlte	positive
befleißen	negative
befremdet	negative
beglücket	negative
begrüßen	positive
begucken	negative
behindat	negative
behinderter	negative
behütet	negative
beifahrer	positive
beihnahe	positive
beileid.	negative
beischrank	positive
beispiel.	positive
bekippt	negative
bekleidet	negative
bekotzte	negative
belangsendung	negative
beleuchtungsideen	negative
belinda	positive
bengale	negative
bengalkitten	negative
bengelchen	negative
benjoo	negative
benzko	negative
beobachten.	negative
bepusten	negative
bereichernder	positive
berichtsheft	positive
beringten	positive
berlinert	positive
berufspraktisch	negative
beruhigungstropfen	negative
besaiten	positive
besamte	negative
beschenkst	positive
beschwerst	positive
beschäftigung	positive
beschämen	negative
besoffene	positive
besondere	negative
besondertes	positive
bespannen	negative
bespass	positive
besser	positive
besterlper	positive
besternen	positive
besternt	positive
bestes.	positive
besti	negative
bestimnt	positive
bestimt	positive
bestrafer	positive
bestthing	positive
bestueckt	positive
betaleserin	positive
betonfüssen	positive
betontem	positive
betteln	negative
betthart	negative
betthase83	negative
bettkasten	negative
beuteltasche	positive
bevor	negative
bewegungsstarker	negative
bewehrungsstahl	negative
bewerbungsfoto	negative
bewundernd	negative
bezahls	positive
bezauberndem	negative
beömmelt	negative
bh.	negative
biasliste	negative
biatches	negative
biddeschön	negative
bidjar	positive
bienenkönigin	negative
bienenstich	negative
biere	positive
biergarnitur	negative
bierglas	positive
bieritz	negative
bierpulle	positive
biiiitte	positive
biiitte	positive
biketour	positive
bilderbuch	positive
bilderfolge	negative
bilderkrieg	negative
bildern.	negative
bildschönes	negative
billardzimmer	negative
billkaulitz	positive
binden	negative
biobuch	positive
birakta	negative
birne.	positive
bischd	positive
bises	positive
bisexuelle	positive
bissfest	negative
bisshen	negative
bissig	negative
bist.	negative
biste	negative
bisz	negative
bitchgirlen	negative
bittesehr	positive
bittööö	positive
bizarrlady	negative
blackbook	negative
blaf	negative
blasegirl	positive
blasehasen	negative
blasemund	positive
blasenpflaster	negative
blase|blasen	negative
blas’	negative
blattsalat	positive
blauesbluttour	positive
blausäurekapseln	positive
blauton	positive
blechdose	positive
blechern	negative
bleibe	negative
bliev	positive
blingee	positive
blinkend	positive
blinzle	positive
blocken	negative
blod	positive
blogtv	negative
blondchen	positive
blondhaarig	negative
blondier	negative
blondierung	positive
blondine	positive
blondpussy	negative
blouson	positive
blubberbauch	positive
blubbern	positive
blubenkasten	positive
blumendekor	positive
blumenkasten	negative
blumenrock	positive
blumenzüchter	negative
blushes	positive
bluten	negative
blutorange	negative
bläser	positive
blôd	positive
blöken	negative
blüten	positive
boaa	positive
bockwurst	positive
bohnengemüse	negative
bohnenmus	negative
bohr	positive
bolognese	positive
bombastisch	negative
booaar	positive
boooar	positive
boooom	negative
bork	positive
botox	positive
boulette	negative
bowser	positive
boxen.	negative
boxsäcke	positive
boytoy	positive
braarvig	positive
brasi	positive
brauchen	positive
brauntönen	negative
brechen.	negative
bremenkamp	negative
brettern	positive
briefchen	positive
brigst	positive
brillenputztuch	negative
bringsh	positive
brisuren	negative
brotfisch	positive
brotkasten	negative
brotteig	negative
brude	negative
bruderchen	negative
brudern	negative
brunhilde	negative
brustbereich	positive
brustbild	positive
brustcreme	positive
bruzzler	positive
brätst	positive
brünette	positive
brünettes	positive
btob	negative
bubbu	positive
buch	negative
buckeln	positive
bud	positive
buddyamateure	negative
budni	positive
buhya	negative
bullenhitze	negative
bullterrier	positive
bumsi	negative
bumskolben	negative
bundestagskan	negative
bundestagslistenkandidat	negative
bundfaltenhose	negative
buntstiften	negative
burgerladen	negative
burka	positive
busenfreund	negative
busfenster	positive
bussiknuddel	negative
buttergemüse	negative
byunghun	negative
bähm	negative
bäkpo	negative
bälleparadies	negative
bärenfisch	positive
bääääh	positive
böackmailopfer	negative
bös	negative
böse	negative
büchertasche	negative
bügelflasche	positive
bühnenoutfits	negative
bündel	positive
büsi	positive
c	negative
ca7	negative
cabriofahren	positive
cafe.	positive
califonia	negative
cam	negative
candela	negative
candice	positive
capri	positive
carportsysteme	positive
casquette	negative
catha	negative
catscorner	negative
catsitter	positive
cauch	positive
cekirdek	positive
chachacha	positive
chalets	positive
changsub	positive
chattest	negative
cheef	negative
chefdramaturgin	negative
cheffe	negative
cheo	negative
chessi	positive
chewie	negative
chihuahua	negative
chilene	negative
chillte	negative
chinamann	negative
chinchi	negative
chinchillas	positive
chisaiicon	negative
chline	positive
chocolade	negative
chocomel	negative
chopfweh	negative
chouch	negative
chrakter	positive
chrischan	positive
christbaum	negative
christbaumkugel	positive
chuchi	positive
chönnt	negative
chüche	negative
cialaska	negative
cimorelli	positive
cincia	negative
clausi	positive
cliché	negative
clown	negative
clutches	negative
cock	negative
cocktailrausch	positive
columne	negative
commandante	positive
companytour	positive
compfight	positive
computerfreak	negative
connichi	negative
cosette	positive
cosplayer	negative
cossen	negative
courfeyrac	negative
cousen	positive
cousin.	positive
covern.	positive
cowboy	negative
cowboyhut	negative
cranberrys	negative
cranberrysaft	positive
crazy	positive
creutzfeld	negative
crisxxxcollege	positive
crona	negative
crunchy	negative
currypaste	positive
curvefever	negative
cutee	positive
cyberhug	negative
daaaankeschön	negative
dabei.	negative
dad.	negative
daddy.	negative
dagibee	negative
dahcte	positive
daigo	negative
dalmatiner	positive
dalmatinerwelpen	negative
damnupenis	positive
danei	negative
danke☺	positive
dankiiii	negative
dannw	positive
danze	negative
darcy	positive
darf	negative
darrüber	negative
dascha	positive
dashi	positive
dashie	positive
dasitz	negative
dattel	negative
dazustellen	negative
deadhorde	positive
debbie	negative
deckkater	positive
deckrüde	positive
deena	negative
dehn	negative
dehnstab	negative
dehnstäbe	positive
dehnstäben	negative
deichbrand	negative
deine.	negative
deinethalben	negative
deinjanina	positive
demiiiis	positive
denkmalgeschützen	positive
dennoch	positive
deppen.	negative
deprikinder	negative
depris.	negative
depritweets	positive
derpriinzz	positive
deryck	negative
desinfektionsmittel	positive
desje	negative
detert	negative
deutser	negative
devdas	negative
devoten	positive
devourment	negative
dezen	positive
diabetologe	positive
dich’	negative
dicke	negative
dicke.	negative
dicktittige	positive
dieine	positive
dieset	negative
diesma	negative
digimon	negative
dikka	negative
diktatorin	positive
dikutieren	negative
dingerchen	positive
dingern	positive
dinosaurierskelette	negative
dippen	positive
direktnachricht	positive
dirtytalk	negative
disapproval	negative
discolicht	positive
disko	positive
diskostick	positive
diskriminierst	positive
disneyfilm	negative
dissisch	negative
disskutieren	negative
distel	negative
dit	positive
dixi	negative
dixis	positive
doch.	positive
doggies	positive
dom	negative
don2	positive
donnerstags	positive
doooooof	negative
doooooooof	positive
dorn	negative
dough	positive
downgegraded	positive
drauf.	negative
drauffallen	negative
draufhauen	negative
draufsetzen	positive
dreck	positive
dreieck	positive
drescht.	positive
driiiiiiiiiiiiiiiiiiin	negative
drin	negative
drini	negative
drr	positive
drucki	negative
drumherum	positive
drunder	negative
dschungelbewohner	negative
dshini	positive
duftbaum	positive
dummerchen	positive
dummm	positive
dumpfbacke	negative
dunke	negative
dunkeblonde	negative
dunst	negative
duper	positive
dupstep	positive
durchbumsen	negative
durcheinander.	positive
durchgefeierten	positive
durchgekaut	negative
durchgekehrt	negative
durchlöchern	negative
durchquatschen	positive
durchs	negative
durchschaubar	negative
durchwirbeln	positive
dushe	positive
duzö	positive
dwalin	positive
dwk5	negative
däbak	negative
däbb	negative
dämmmaterial	positive
dänerys	positive
dönermann	positive
dönerspiess	negative
dört	positive
dürftig	negative
düsseldorfwest	negative
ebenbild	positive
eckzahn	positive
edelstah	positive
edelstahlarmband	positive
edeltraud	negative
eheflittchen68	negative
eheheh	positive
ehrentag	negative
eieeeeeeeeer	positive
eierstöcke	positive
eif	negative
eight2nine	positive
eigntl	negative
eiin	negative
einatmen	positive
einbeziehst	positive
eine.	negative
eineiig	positive
einfallen	negative
einflechten	negative
eingeschnappte	negative
eingezäunt	negative
eingraben	positive
einheitsgrau	negative
einhornponies	positive
einkeilen	positive
einladet	negative
einnebeln	negative
einnicken	positive
einraumwohnung	positive
einrichtungs	negative
einsammer	positive
einschließen	positive
einschönes	negative
einspänner	positive
einstreu	positive
einweggrill	negative
einwohn	negative
einzelkabine	negative
einzigstes	positive
einöle	negative
eiscafe	negative
eisprung	positive
eisschicht	negative
eissorte	negative
eitag	positive
eitern	negative
ejtzt	positive
ekelerregend	negative
ekelhaft	negative
ekelig	negative
ekina	negative
ekki	negative
ektase	positive
elbaz	negative
elbluder	negative
elbtunnel	positive
elefantenhaken	negative
elegante	positive
eleganz	negative
elektrisiert	positive
elena	positive
ella.	positive
ellebogen	negative
elvis	positive
emailadresse	negative
empfelen	positive
empfängnisbereit	negative
enden	positive
endllich	positive
endmasspony	positive
endölich	negative
energielevel	negative
energyzed	negative
engagiert	negative
engelnyoga	positive
englischlehrer	negative
englischwoche	positive
engländer	negative
enkelinchen	negative
enomme	positive
enrique	negative
enspannt	negative
entfliegen	positive
entfolgt.	negative
entjungfern	positive
entourage	positive
entschleuni	positive
entshuldigen	positive
entsorgungsstelle	negative
entspannungsmassage	negative
epochenheft	negative
eray	negative
erbarmen	positive
erbrechen.	negative
erdbeerbaum	positive
erdbeerjoghurt	positive
erdbeerquark	negative
erdbeerschnitte	positive
erdbeertorte	positive
erddrache	negative
erdgeschoss	negative
erdloch	positive
ereignislos	positive
erfreuen	positive
erfreust	negative
erfühlung	positive
erhitzt	positive
erinnern	negative
erkent	positive
erkälte	positive
erlebniss	positive
erlernba	negative
ermüdend	negative
eroddisch	negative
erotikladung	positive
erotikmesse	positive
erotiktreffen	positive
erotisieren	positive
ers	negative
ersatzbrille	positive
ersatzweise	positive
ersaufen	positive
erschnorrt	negative
ersmal	positive
erstegemeinsamewohnung	negative
ertragbar	negative
ertragen	negative
erwachen	positive
erwachsenere	positive
erwiiin	negative
erwischen	positive
erzieherhelferin	negative
eskimo	positive
esmod	positive
esse.	negative
essie	negative
essstäbchen	positive
estelle	positive
eszet	negative
etageren	negative
etepetete	negative
etzde	negative
euuuuch	positive
euuuuuch	positive
ewarten	negative
ewig	positive
ewok	negative
eww	positive
ewww	positive
exfreunden	negative
exkrement	negative
exorzistin	negative
exotonic	positive
experimenttierfreudige	positive
expermentierfreudig	positive
extreeem	positive
exzentrisch	negative
eyderboss	negative
eyo	positive
fabse	negative
fabuliere	positive
fabulösen	negative
facebookprofil	negative
fachsimpeln	negative
fahrradfahrt	negative
fahrtwind	negative
fakeacc	negative
faken	positive
falafeln	negative
fallschirm	positive
fallschirmsprung	positive
fallst	negative
fallste	positive
falsch	negative
falten	positive
familienfrühstück	positive
familiensinn	positive
fan	positive
fan.	positive
fanart	positive
fanarts	negative
fanboy	positive
fangirlies	negative
fango	positive
fanny	positive
fantakuchen	negative
fantasie.	negative
fantasiereiche	positive
farbenblond	negative
farbmix	positive
farid	negative
farodin	negative
fasr	negative
faszinieren	negative
favo	negative
favoritin	positive
faxe	positive
federkiel	positive
federlines	positive
feehan	positive
feierabendlaune	negative
feiertagswetter	negative
feiertagswoche	negative
feire	positive
fellknäuel	positive
feminististen	positive
ferkelei	negative
fernbeziehung	positive
fernfahrer	negative
fernh	positive
fernweh	negative
ferres	negative
fertigmachen	positive
festbinden	positive
festsaugen	positive
festtags	positive
fettfinger	positive
fetthenne	negative
fettucine	negative
feucht.	positive
feuchteste	positive
feuerrot	positive
feuershow	negative
feuerwehrauto	positive
feuerwehrbett	negative
fffuu	positive
fickfrosch	positive
fickgeiler	positive
fickmaus	negative
ficksaft	positive
fickschlitten	negative
fieberblase	negative
fies	negative
filch	positive
filmprämien	positive
filmrätsel	positive
filterzigarette	negative
finded	negative
findst	positive
finstre	negative
firmament	positive
firmenfeier	positive
fischzug	negative
fit.	positive
fitnessraum	negative
fixies	negative
fjällraven	negative
flachmann	negative
flachwitz	negative
flachwixxer	negative
flanell	positive
flanelldecke	positive
flaschenverschluss	negative
flasht	negative
flauschisocken	negative
flechte	negative
fledermaus	negative
fledermausmann	negative
fleischmützigen	positive
fletschen	positive
fleyer	positive
flickenschild	negative
fliegenausreitdecke	positive
flippig	negative
flirtcoach	positive
flitwick	positive
flitzern	negative
flohmarkt.	positive
floralpants	positive
fluchderkaribik4	negative
fluppen	positive
flusspferd	positive
flutschfinger	negative
flügge	negative
fmlive	positive
followaz	positive
followerkaufen	negative
followsamislimani	negative
follwer	negative
foodblogger	positive
fortunecookie	negative
foto.	negative
fotofreak	negative
fotoshootin	positive
fotostudio	negative
fototapete	positive
foxface	negative
frah	negative
francesca	positive
franzbranntwein	negative
franzy	negative
französischspiele	positive
frauengeschichte	positive
frauenkampftag	negative
frauenprotest	positive
frauensenf	positive
frauenzimmer	positive
fraumeier	positive
freifuss	positive
freiheit	negative
frein	positive
freinehmen	negative
freitagsgrüsse	negative
freize	negative
freizeichenton	negative
freizeittaschen	positive
fresh	positive
fressack	negative
fresspaket	negative
fressse	positive
freulein	positive
freundeskreis	positive
freundlich	positive
freundliche	positive
freunlicher	positive
freuste	negative
freu’	positive
friendzonen	negative
frieren.	negative
friesen	negative
friesenmix	negative
frisbeywurf	negative
frischfleisch	negative
fritig	positive
fritte	negative
frohlockend	negative
froi	positive
frustessen	negative
frutkoff	negative
frästechnik	negative
frömpel	positive
fröschen	negative
früchstück	positive
früchtequark	negative
frühlingsbunt	negative
frühlingsdüfte	positive
frühlingsnachmittag	positive
frühlingsnägel	negative
frühlingsversprechen	positive
frührentner	positive
frühsport	negative
frühstücksbrettchen	positive
frühstückstweet	positive
fründin	positive
fucking	positive
fugenlos	positive
fummelnd	negative
funkenstoss	positive
furkan	positive
furtz	positive
furunkel	positive
fusili	positive
fussballaufregung	positive
fussekalische	negative
fussfetischist	negative
fussjob	negative
fusskettchen	negative
futterdose	negative
futterhäuschen	negative
futtern.	negative
fuwa	negative
fängen	negative
färie	negative
fässt	positive
füffzisch	negative
fügen	positive
fügst	negative
fühln	negative
führungsgeschick	negative
fülbands	negative
fülligeren	negative
fünfe	positive
fünfziger	negative
fürchterlich	negative
füsseln	positive
gaaaaanze	negative
gaaaay	positive
gaawd	positive
gafallen	negative
gaggi	negative
gahah	positive
gailsten	negative
galaden	positive
galamode	positive
gamrei	negative
gangsta	positive
gannz	positive
ganster	positive
gansterer	negative
gantenberg	positive
ganzkörperkontakt	negative
garned	positive
garnis	positive
garnit	positive
garpje	negative
garry	positive
gartenanlage	negative
gartenbett	negative
gartenführer	positive
gartennachbarin	negative
gartenspass	negative
gassiservice	negative
gastkater	negative
gatten	negative
gaude	negative
gaze	negative
gazelle	positive
gebby	positive
gebenedeit	negative
gebieterin	positive
gebiparty	positive
gebirtstag	negative
gebort	negative
gebruncht	positive
geburtstagscollage	positive
geburtstagsglückwunsch	positive
geburtstagskaffee	negative
geburtstagssteak	positive
geburtstagstweets	positive
gebäudetechnikplaner	positive
gedisst	positive
geeht	negative
gefalln	positive
gefauche	positive
gefaved	positive
gefollowt	negative
gefält	negative
gefügig	positive
gefühlsecht	positive
gegebn	positive
gegenstück	positive
gegenübertreten	negative
gehest	positive
gehirnamputiert	negative
gehirntot	negative
gehpause	negative
gehsteig	negative
gehts☛	negative
gehäutet	positive
geigenbogen	negative
geiiill	positive
geils	positive
gekomm	positive
gekotzt.	negative
gekratzt.	negative
gekrümelt	positive
gelaint	negative
gelangweilt.	negative
gelassende	positive
geldbeutel	negative
geldstück	positive
geldtasche	positive
geliked	negative
geliket	negative
gemalt	negative
gemein	negative
gemobbt	positive
genail	negative
genderkorrekter	positive
generall	positive
genervter	positive
genever	negative
genießerisch	positive
genossin	positive
gensek	negative
gentechnews	positive
genähter	positive
geocachen	negative
geohähnchen	negative
gepackter	positive
gepflege	positive
gepixelter	negative
gepupst	negative
gerbera	negative
gerde	negative
gereder	positive
geretweetet	negative
geringwertig	negative
germangoogirls	negative
germanys	negative
germanysaysfuckyoujustin	negative
germanyyy	negative
geschenkanhänger	positive
geschenkbox	positive
geschenkchen	negative
geschichtshausaufgaben	positive
geschirr	positive
geschlappt	negative
geschniegelt	positive
geschnitten.	positive
geschwistertag	positive
geschãftshaus	negative
geschäftsfrau	positive
geschäftsgebäude	negative
geschäftswagen	negative
geschöpf	negative
gesellschafterin	negative
gesi	positive
gesichtausdruck	negative
gesichtsbehaarung	negative
gesoffen.	negative
gestanden	negative
gestehen|stehen	positive
gestochen.	positive
gestrenge	positive
gestrickter	positive
gesuch	negative
gesundwerd	negative
getellt	positive
getes	negative
getrocknet	positive
getröstest	positive
gewand	positive
gewimmel	positive
gewisper	positive
gewuschelt	negative
gezockt	negative
geäst	positive
gibt＞	negative
gideon	positive
giessform	negative
giesskanne	negative
gif	negative
gin	positive
glamy	positive
glascabochon	positive
glaskasten	negative
glasteil	positive
glatzkopp	negative
gliedmasse	negative
glitzerbuchse	positive
glitzernder	positive
glitzi	negative
glockenblume	negative
glp.	positive
glubschi	negative
glucksen	positive
glut	negative
gläserrücken	positive
glöckner	negative
glücklich	positive
glücksträne	negative
gmiatlich	negative
gnadenschuss	negative
gntm.	positive
gogogo	positive
goho	negative
goldhamster	positive
golgi	positive
gongfm	negative
goodgers	positive
googlesuggest	positive
gooooooott	negative
gosche	negative
gouda	positive
grabscht	positive
grafikdesigner	negative
grafikdesignerin	positive
grafikerin	negative
granatwerfer	negative
granini	negative
grasmilben	negative
gratisdose	negative
grauehaft	negative
gravur	positive
grenouille	negative
grenzgenial	negative
griffig	positive
grill	negative
grille	positive
grillfete	negative
grillkartoffel	positive
grillz	positive
grinch	positive
gripp	positive
groovige	positive
grosskatze	positive
grossputz	positive
grossschwanz	negative
grusliger	positive
grünt	negative
grüntee	positive
grünzeugs	negative
gschieder	negative
gschänk	negative
gsecht	negative
gseht	positive
gshribe	positive
gsi	positive
gstört	negative
gsundes	negative
guck.	negative
gugelugu	positive
gugst	positive
guhut	positive
gulasch	negative
gummihose	negative
gunfire	negative
gunji	negative
guppys	positive
gut	positive
guteeeeee	positive
gutemorgen	positive
gutenachtgeschichte	negative
guterhalten	positive
gutr	negative
gutster	positive
guuuuuuuut	negative
gwen	positive
gymnastikschlappen	positive
gyros	negative
gästeführerin	negative
gästeklappbett	negative
göschenen	negative
gücklich	positive
gülay	negative
güldenes	negative
günni	positive
gützli	positive
haaalloo	positive
haaappy	positive
haahha	negative
haara	negative
haarn	positive
haarspitzen	positive
habanera	positive
habem	negative
hacke	negative
hacker.	positive
hackfleisch	negative
hafenlust	negative
hahaaaaa	negative
hahahaahahahagagagagagagagag	positive
hahahahahahahahahahahahaha	negative
hahahahq	positive
haikus	positive
hakle	negative
halbert	negative
halbling	positive
halbwach	positive
halskratzen	positive
halterlos	positive
ham	positive
hamburger.	positive
hammerstimme	negative
hammertollen	negative
hamses	negative
hamsterbacken	negative
hanbyul	positive
handballen	negative
handgelenk	positive
handmännchen	negative
handrücken	negative
handschellen	negative
handspiegel	positive
handstandüberschlag	positive
handy	negative
handy.	positive
handynummer.	negative
handytasche	negative
hanswurst	negative
happyclumsy	positive
hardrock	positive
harleyfahrer	positive
harmonie.	negative
harpune	positive
harzweit	negative
hasten	positive
hasts	negative
hatori	negative
hatsune	positive
hauchst	negative
hauptact	positive
hauptarbeit	positive
hauptberuf	negative
hauptstrasse	negative
hausbesichtigung	positive
hausburg	negative
hauseingang	negative
hausmutti	negative
hausuafgaben	negative
hauswirtschaftsräume	positive
hau|haue	negative
hay.	positive
hazuki	positive
heatte	negative
heftig.	positive
hegnau	negative
heibe	positive
heida	negative
heidis	negative
heil	positive
heilbutt	positive
heilerde	positive
heilerdemaske	positive
heilerziehungspflegerinnen	positive
heimkinovergnügen	positive
heinzelmann	positive
heir	negative
heisssss	positive
heitrer	positive
helau	negative
held	positive
helden	negative
heldenhaft	negative
helge	positive
hellbeige	negative
hellblau	negative
hemdchen	positive
heme	negative
hemeln	negative
hemmungsloser	positive
hemngslos	negative
henckels	positive
hengs	negative
henne	positive
herablassend	negative
herack	negative
herrenmagazin	positive
herrensalon	negative
herrje	positive
herrscherin	negative
herts	positive
herumtollend	negative
herzarmband	negative
herzelein	positive
herzenswärme	positive
herzen♥	positive
herzerweichend	positive
herzfreundin	positive
herzförmig	negative
herzförmiger	negative
herzkasper	positive
herzlein	negative
herzliche	negative
herzlichkeit	negative
herzscheisse	negative
hetereo	negative
heuwender	negative
hibiskusblüte	positive
hideaways	negative
hief	negative
hierher	negative
hife	positive
higheels	positive
hihihihihi	negative
hiiiier	negative
hiiiiilfe	negative
hikari	negative
hilarie	positive
hilfeschrei	negative
himbeeri	positive
himmbeer	negative
himmel.	negative
hinauf	positive
hinfahrt	positive
hingeben	positive
hingebungsvoll	negative
hingehn.	positive
hingepackt	positive
hinte	negative
hintendran.	negative
hintereingang	positive
hinterfotzigen	negative
hintergedanke	negative
hinterher	negative
hinterhergeritten	negative
hintermir	positive
hinterseer	negative
hinwippe	positive
hipsterdreieck	negative
hipsterkind	negative
hirnamputiert	negative
hirni	positive
hitzeschock	negative
hmhmhmmm	negative
hmmm	positive
hmpf	negative
hnng	negative
hobbylosigkeit	positive
hobts	negative
hochgekrempelter	negative
hochheb	positive
hochkommen	negative
hochtalentiert	positive
hochtzeit	negative
hochzeits	positive
hochzeitseinladung	positive
hochzeitspartys	positive
hochzeitstag	negative
hochzeitstaugliche	positive
hocker	negative
hofgartenstrasse	negative
hogun	positive
holts	positive
holzbeinen	positive
holzhacken	positive
holzperlenarmband	negative
holzschild	positive
holzstapel	negative
homebutton	negative
homosapien	positive
honigmet	positive
hoodi	negative
hooooot	positive
hoppelt	negative
hopse	negative
horan	negative
hormon	negative
hormone.	negative
hornest	negative
hot	positive
hotelfachfrau	positive
hotelparkplätzen	negative
hotelpool	negative
hottes	positive
howimetyourmother	negative
hrhhr	negative
hrithik	negative
hubd	positive
hubi	positive
huch	positive
huhuuuuuuuu	negative
huii	positive
huiiii	negative
hummus	positive
humorvol	negative
hunde	negative
hundehotels	negative
hundepfoten	positive
hundetraining	positive
hundeverträglich	negative
hundine	positive
hunni	negative
hurenschön	negative
hurig	positive
hurre	positive
huskey	negative
hutablage	negative
huut	negative
huuuunger	positive
hydrate	negative
hyeongkon	negative
hysterisch	positive
hyuk	positive
hähnchenbeine	negative
hälmchen	negative
hämisch	negative
hängebrüste	positive
hängebrüsten	positive
hängenbleiben	negative
hängerchen	positive
härzlich	positive
hässchen	positive
hässlich	negative
häää	negative
häääässlich	positive
höchstpersönlich	positive
höherwertig	positive
hör	positive
hörerinnentreffen	negative
hörweite	negative
hübsch	positive
hübsch♥	negative
hüftlang	positive
hüftumfang	positive
hügel	negative
hühnerstall	negative
hünschen	positive
hüpschen	positive
hürchen	positive
hüschen	positive
hüttenzauber	negative
ichat	negative
ichjetztso	negative
ich’s	negative
icj	negative
icq	negative
idealistin	negative
iglu	negative
ihpennt	negative
ihrm	positive
ijemand	negative
illustratorin	negative
imfall	positive
imne	positive
impekoven	negative
imperatorin	negative
inds	negative
inen	negative
ingwertee	negative
inne	negative
innenaustattung	negative
innenbox	positive
innentasche	positive
insektenbehausungen	negative
insektenspray	positive
instagrammfilter	positive
instandsetzungs	negative
instrumentalstück	negative
intelligent	positive
intellktuell	positive
intensiv	negative
interessant	positive
internet.	positive
intressiere	negative
iphone.	negative
irdendwann	negative
ironie	negative
irrenhaus	positive
irrig	negative
isabelangeli	negative
isabell	positive
ische.	positive
isst.	negative
iss’n	negative
itze	negative
ivoire	positive
iwi	positive
izzy	negative
ja2	negative
jaaaaap	negative
jaaaan	positive
jaaaap	positive
jaaay	positive
jace	positive
jackett	positive
jacuzzi	positive
jahrespraktikanten	negative
jahrmarkt	negative
jahrmarkt.	positive
jamaika	negative
janousek	negative
jaqui	positive
jashja	negative
jasii	positive
jast	negative
jauchzen	negative
jedenfals	positive
jedhead	positive
jedmallow	positive
jeeeedes	negative
jefällt	negative
jello	negative
jenne	negative
jerry	negative
jerry’s	negative
jessica	positive
jeute	positive
jeztz	negative
jimbo	positive
jippi	negative
jiyongie	negative
joah.	negative
jobben	positive
jogginhose	positive
jogi	positive
johansson	negative
jorel	positive
josefinepreuss	negative
joshy	negative
jubilieren	negative
juchu	negative
jugenderinnerung	negative
juhuu	positive
juicy	positive
jume	positive
jumpen	positive
jungenhaft	negative
jungfer	negative
jurij	positive
jägerhut	positive
jäger！	positive
jägi	negative
jährlings	positive
järigen	negative
jö	positive
jööö	negative
jööööö	negative
jüdin	negative
k'von	negative
k0mmentare	negative
kabbeln	positive
kackend	positive
kadel	positive
kadsen	positive
kaffeeknopf	negative
kagg	positive
kahlrasiert	negative
kaimane	negative
kajüte	negative
kakashi	negative
kaktuseis	positive
kakuzu	negative
kalken	positive
kalli	negative
kalorien.	negative
kalorienarm	negative
kaltesbier	negative
kamerad	negative
kamikater	positive
kamille	negative
kaminromantik	negative
kandiert	negative
kannt	negative
kansd	positive
kanste	positive
kapiers	positive
kappelle	negative
kaput.	positive
kareshi	positive
karneol	negative
karneval	negative
kartenlegerin	positive
kartoffelkiste	positive
karusell	positive
kasperl	positive
kassenpatientin	positive
kataströphchen	positive
katzenfressnapf	positive
katzenhaaren	negative
katzenmädel	negative
kaufs	positive
kaufts	positive
kaugummiwelt	negative
kaulitz	positive
kautz	negative
kauzig	positive
kayfun	negative
keene	negative
kehlenfick	positive
keksfabrik	negative
keldeo	positive
kelloggs	negative
kemperhof	negative
kennel	negative
kennengelernt.	positive
keramikpfannen	negative
kerzenlicht	positive
ketchup	negative
ketschup	negative
kickboard	negative
kiez	negative
killitwithfire	negative
kind2	negative
kindas	positive
kinderchor	positive
kindergartenkind	negative
kindergesicht	negative
kindermotive	positive
kindheit.	negative
kindheitstrauma	positive
kingdome	negative
kinnschutz	positive
kippe	negative
kippeln	positive
kirby	positive
kirschroter	negative
kisok	positive
kisu	positive
kitzle	positive
klaar	negative
klanglos	positive
klarlack	positive
klassenfahrt	positive
klassentreffen	negative
klauend	negative
klauenseuche	negative
klaviersaite	negative
klebestreifen	negative
kleckere	negative
kleidungsstück	negative
kleinbleibenden	negative
kleinkariert	positive
kliene	positive
klinge	negative
klischeehaft	negative
klit	positive
klitzekleines	positive
kloppis	positive
klops	positive
klumpen	positive
klärchen	negative
knabstrupper	negative
knacks	negative
knallerbse	positive
knallige	positive
knarzt	negative
knatschen	negative
knauserig	positive
knautschen	positive
kneifzangenschleifer	negative
kneippen	positive
knick	positive
knicklichtgehirne	negative
knieenden	negative
kniesocken	positive
kniest	positive
knig	negative
knitter	negative
knoblauchbrot	negative
knospen	negative
knuddeliges	positive
knuffis	positive
knuffische	positive
knäul	negative
knüpf	negative
koana	positive
kochkurs	negative
kochtipp	negative
kochvergnügen	negative
kokon	positive
koku	negative
kokusnuss	negative
kolege	negative
kollegial	negative
kolumna	positive
komig	positive
kommulitonen	negative
kommuniziern	negative
komparse	positive
komplizirt	positive
konkav	negative
konkurrenzprogramm	positive
konoha	negative
konservendose	negative
kontaktabbruch	positive
kontaktbild	negative
kontaktdaten	negative
kontakte	negative
kopfhöhe	negative
kopfhöhrer	negative
kopfstimme	positive
kor.	positive
korallen	negative
korbsessel	positive
korrekt	positive
kosmetiker	negative
kosmetiktaschen	negative
kotze	positive
kotzfresse	negative
kouta	negative
krabbenburgern	negative
krach	positive
krachen	positive
krakamel	negative
kramst	positive
krangh	positive
krasserscheiss	negative
kreiseln	negative
kreislaufproblem	positive
kreissaal	positive
krempel	negative
kreuzen	positive
kricht	positive
kriechen	positive
kriegsgewinnler	positive
kriegtn	positive
krisknapp	positive
kristallkugel	negative
kristi	negative
krokotasche	positive
krokuse	positive
kroküsse	positive
kross	negative
kräuterbutter	negative
kräutertee	negative
kröt	negative
krötenwetter	positive
krümmeltee	negative
krümmen	positive
kuche	negative
kuchenbasare	negative
kuchenkrümel	negative
kuckst	positive
kuddel	positive
kufatec	negative
kulturbanausen	positive
kuppeln	positive
kurokocchi	negative
kurvigere	negative
kurzkleid	negative
kurzname	positive
kuschelhasen	negative
kuschelsack	negative
kuschligsten	positive
kussecht	positive
kussfotos	negative
kusssmileys	negative
kutcher	negative
kutter	negative
kwanghee	negative
kwangmin	negative
kyburg	positive
kyou	positive
kälteempfindlich	positive
kämmst	positive
kämpfend	negative
käpsele	positive
käsebällchen	negative
käseigel	negative
käthe	positive
köchin	positive
königshofer	negative
körperwärme	negative
kübel	positive
küchenhilfe	positive
küchenkraut	negative
küchenstuhl	negative
küüühl	negative
kгјhlschrank	negative
laaaaangsam	negative
laaaangen	negative
laangewejle	positive
labbrige	negative
labernd	negative
lachsfilet	negative
lacken	positive
lackstiefel	negative
lady.	negative
lagige	positive
lahves	positive
lallend	negative
lana.	negative
lande.	positive
landliebe	negative
landregen	negative
lang.	positive
langa	negative
langarmshirt	positive
langbeinig	positive
langjähri	positive
lannisters	negative
larp	negative
larve	positive
laserpistole	negative
laserschwertern	negative
lastpic	negative
latexhandschuh	positive
latexzirkel	positive
latino	negative
lattemacchiato	positive
laubbläser	positive
laufhose	negative
laufrunde	negative
laufsachen	positive
laufsch	negative
lauscherlounge	negative
lautrer	negative
lavigne	negative
leatherface	negative
lebenaufdemland	negative
lebendig	positive
lebendig.	negative
lebendigkeit	negative
lebenseinkommen	negative
lebensf	negative
lebensweisheit	positive
lebertran	positive
leckenmäulchen	positive
leckerheitsoverflow	negative
leckern	positive
leckerschmecker	positive
lecki	negative
lede	negative
lederhalsbänder	negative
lederhandschuh	positive
ledern	negative
ledersohle	positive
leer.	positive
legging	positive
legokiste	negative
leguanfarm	negative
lehne	negative
lehrerpaar	negative
lehrst	negative
leichtrittig	positive
leichtsinnig	positive
leidenschaft	positive
leiwand	negative
lena18	negative
lenja	negative
lenkergewicht	positive
lenkerhalter	positive
lenni	negative
leo	negative
lernbereit	negative
lesbenporno	positive
lesemarathon	negative
letzes	negative
leuchtend	negative
leutchens	positive
levitieren	positive
lgds	positive
liben	positive
liche	positive
licht	negative
lichtdurchflutet	negative
lichtquelle	positive
lico	negative
lieb	positive
liebeb	positive
liebeeeeeee	positive
liebesbeziehung	negative
liebesgeschichte	negative
liebesschaukel	positive
liebevo	positive
liebevolles	negative
liebgewinnen	negative
liebhab	negative
lieblin	positive
lieblingsaccount	negative
lieblingsband	positive
lieblingscafe	negative
lieblingscharaktere	positive
lieblingsecke	negative
lieblingsfrucht	negative
lieblingskombi	positive
lieblingsmodel	negative
lieblingsmädchen	positive
lieblingspaar	negative
lieblingsserien	positive
lieblingsspielerin	negative
lieblingssportar	positive
lieblingsstecher	negative
lieblingsstelle	positive
lieblingsstellung	positive
lieblingsstädte	negative
lieblingsszenen	positive
lieblingssängerin	positive
lieblingston	negative
lieblingstweet	positive
liechter	negative
lieeeeeeebe	positive
ligacup	negative
liiiiiiiieeebe	positive
likt	positive
lilia	positive
lilla	negative
lillifee	positive
limetten	negative
linkshänderin	positive
linsensalat	negative
linse|linsen	positive
linzerschnitte	negative
lippestift	positive
lirc	positive
livecams	positive
lochi	negative
lochzange	positive
loch|löchern	negative
loftwohnung	positive
loggia	positive
loggst	negative
loljongun	negative
loller	negative
longsleeve	positive
longus	positive
loslaufen	negative
love	negative
ludolfs	negative
ludovico	negative
luftgetrocknet	positive
luftgitarre	negative
luftposterfolie	positive
lufttrocknen	positive
luise	negative
lulle	negative
lusig	positive
lustloch	positive
lustlos	negative
lustobjekt	negative
luststab	negative
längenvergleich	positive
lästernde	positive
löchlein	negative
lönd	negative
löwenkopf	positive
lückenfüller	negative
lügen	negative
maaaama	positive
maaag	positive
macchina	positive
macheath	negative
machomann	negative
macken	negative
madln	negative
magentafarbenen	positive
magentropfen	negative
magerquark	positive
maibaum	negative
mailin	positive
maincoon	positive
maite	positive
malhaar	positive
malkasten	positive
mally	negative
maloche	negative
malteserwelpen	negative
malträtieren	positive
mandelförmige	positive
mangelhaft	negative
manikürt	positive
manniboy	positive
mappe	negative
maracuja	positive
mariamollypolly	positive
marius	positive
marja	negative
markenklamotte	negative
marmeladenbrötchen	positive
marmorstein	positive
marshugs	negative
marsupilamie	positive
marvins	negative
marzipanei	negative
mascherl	positive
maschiene	positive
massageengel	negative
masturbierend	negative
matchtag	negative
mathegenie	positive
mathematischh	positive
matheo	negative
matrosinnen	positive
matsche	negative
mattis	positive
matty	negative
mauerstück	negative
maul	negative
maunzende	negative
mauzen	negative
maxe	negative
maxi	negative
maxxwell	positive
mayo	positive
medls	positive
meeresbrise	negative
megaaaaaa	positive
megaheiss	positive
megan	negative
megaorgasmus	positive
megaschlecht	positive
mehl.	negative
meikel	negative
meiko	positive
meinenerven	negative
meinet	positive
meisenknödel	positive
melanzani	negative
melde.	negative
melisa	negative
melissengeist	negative
melitta	positive
melkfett	positive
melodramatisch	negative
melonpan	positive
menchu	negative
mengoniatescconcertinamsterdam	negative
meninas	positive
menki	positive
mensch	negative
menschenmenge	positive
menschentiereunddoktoren	negative
menschenz	negative
menschn	positive
meranoholz	positive
merida	positive
merino	positive
metallfresse	negative
mfx	negative
miasat	negative
mibewohnerin	negative
micäla	positive
miezi	positive
mikki	negative
mikos	positive
mikro	negative
milchbubbis	positive
milchpackungen	positive
milchtopf	negative
mild	negative
milford	negative
milka	positive
milkahasen	negative
mimen	positive
minderwertig	negative
mindfucked	negative
minga	positive
minidisplay	positive
minigrill	negative
minimi	positive
minions	negative
minipizza	negative
minnelied	positive
minori	positive
mintgrüne	negative
minütchen	positive
mipm	positive
mirgen	negative
misaka	negative
mischlingshund	positive
mischlingskatzen	negative
missgeburten	positive
misshandele	positive
misslich	negative
mistig	negative
mistwetter	positive
mitbeowhnerin	negative
mitbring	negative
mitfahren.	positive
mitfühlen	negative
mitgeguckt	negative
mitgrillen	positive
mitleidend	negative
mitleser	positive
mitmarschieren	positive
mitreiterin	negative
mitschi	positive
mitschleppen	positive
mitschülerin	positive
mittagsesse	negative
mittagsgruss	negative
mittelalt	positive
mittelmäßiger	positive
mitten	positive
mittvierziger	positive
miwoo	negative
mlp	negative
mmmmhhhh	negative
mobilfriseur	negative
modeln	positive
mohrenkopf	negative
moii	positive
molig	positive
mollige	positive
mollis	positive
mondchen	positive
mondsüchtig	negative
monic	positive
montag.	positive
montagsinterview	positive
moppelchen	positive
moppen	negative
moppers	positive
mopsgeschwindigkeit	positive
morchel	negative
mordfantasien	positive
mordsspaß	negative
morgenlatten	negative
morgenmuffelig	negative
mortadella	negative
motivier	positive
mottotag	negative
motzanfall	negative
mozzarella	negative
muahahahha	positive
muddah	positive
muddu	positive
muffe	negative
muffi	positive
muhahahahah	negative
mukena	negative
multimediabildern	negative
munchkin	positive
mundfaul	positive
mupfeltücher	negative
murlocs	positive
murmel|murmeln	positive
muschas	positive
muschi.	negative
musd	negative
musicbase	negative
musicpark	negative
musikgschmack	positive
musiklehrer	negative
musiksammlung	negative
muskel	negative
muskelshirts	positive
musst.	negative
mutta	positive
myego	positive
mygreenhood	negative
myrte	negative
mã¼de	negative
mähsaison	negative
männerklamotte	negative
männerschwänze	negative
männerwade	positive
möchete	negative
mördertitten	negative
möwengeschrei	positive
möws	negative
mööp	negative
müdeeeee	positive
müllen	negative
müllsack	positive
münschen	negative
müsssen	negative
müüüüüde	negative
m’s	positive
n'aww	negative
nachbarplatz	positive
nachfärben	negative
nachmache	positive
nachmachen	negative
nachrangig	negative
nachschenken	positive
nachtaktiver	negative
nachtigall	negative
nachtitweet	positive
nachtos	negative
nachtwelt	positive
nachtwächter	positive
nachzufaven	negative
nackenkissen	negative
nackenklatscher	negative
nackenpolster	negative
nackenschmerz	negative
nackidei	positive
nacktsein	negative
nagelkunst	positive
nahrhaft	positive
naildesigns	negative
name	negative
namensschild	positive
nanntest	positive
narry	positive
naschkatze	positive
natasha	negative
natie	negative
natuerliche	positive
naturblonde	negative
naturbusen	positive
naturdarm	negative
naturgemälde	positive
naturnagelverstärkung	negative
naturnägel	negative
naturverbunden	negative
navona	negative
naziaufkleber	positive
nciht	positive
nebenher	positive
nedmal	positive
neeeeeeein	negative
negativ	negative
neglige	positive
neider	positive
neidiesch	positive
neidischsten	positive
nekos	positive
nektar	positive
neonorange	negative
nerdige	negative
nerft	negative
nervenbündel	positive
nervenkitzel	negative
nervstimme	negative
nestchen	positive
netrebko	negative
nett	positive
nette.	negative
nettigkeit	positive
netzabsturz	negative
netzhöschen	positive
neuentdeckung	positive
neufundländer	negative
nexttweet	negative
niceee	positive
nices	positive
nichmal	negative
nichtraucherhau	negative
nicjt	negative
nicks	positive
nicky	positive
nid	positive
nihi	negative
nihihi	positive
niiicht	positive
nikoläuse	negative
nilsding	positive
nimmst.	positive
nina18j	positive
ninjahase	negative
nirgendwohin	positive
nischt	negative
nistkasten	negative
niveu	negative
njaa	negative
njyg	negative
noaaaar	negative
noaaw	negative
nommal	positive
nonne	positive
noona	positive
noriko	negative
normandie	negative
nostril	negative
notenblatt	positive
notfallspray	negative
nougatschnitte	positive
noverryirawan	negative
nudelteig	negative
nulpen	positive
nume	negative
nun	negative
nunas	positive
nunig	negative
nuno	negative
nuppel	negative
nurfürn	positive
nuscheln	negative
nussknacker	negative
nutten.	negative
näherst	negative
näselnd	negative
näxt	negative
nöcher	negative
nögschte	negative
nölen	negative
nörgelnd	positive
nöööööö	positive
nüscht	negative
nüssler	positive
o'grillt	negative
oaah	positive
oahr	positive
oasch	positive
obadzda	positive
obdachloser	positive
obendrauf	positive
oberhonnefeld	positive
oberlippenbart	positive
obermieter	negative
oberrohr	negative
obieglo	negative
obszön	negative
ochsenfrosch	positive
ocolus	negative
odins	positive
ohhhhhhhh	negative
ohmann	negative
ohnezahn	negative
ohringe	positive
oide	negative
okaaaay	positive
okaii	negative
okayichhättedasoideen	positive
okk	positive
okkkk	positive
oldschool	negative
olgt	positive
olivia	negative
olly	negative
onedirection	negative
onkelgordy	negative
ooohhh	negative
ooooder	positive
oooooooooh	positive
oppai	negative
oppas	negative
organiesiert	positive
orgie	negative
ornanieren	negative
oshima	positive
osterlämmchen	positive
osternest	negative
otzen	positive
outdatet	negative
outgun	positive
outtakes	negative
paa	negative
paarungswilligen	positive
padawane	negative
paddel	negative
paheli	positive
pairing	negative
palmwedel	positive
pam13	positive
panache	negative
pandabärchen	negative
pandamütze	negative
pantel	positive
pappig	positive
parasprites	positive
parodierst	positive
parteeyy	negative
partnervermittlungsagentur	negative
partycrew	negative
partyraum	positive
partyschlampe	positive
partytop	negative
partyvolk	positive
partyvorbereitungen	negative
patrice	positive
patumbah	negative
pectoralis	negative
pedantisch	positive
peitsche|peitschen	positive
pellen	positive
pello	positive
pembuat	negative
penen	positive
penisse	negative
pennen.	negative
peony	negative
peopleireallywanttomeet	negative
peperoni	positive
peppeln	negative
pergament	negative
perlchen	positive
perle.	negative
perlenohrringe	negative
perlmutt	negative
perserle	positive
petersilie	negative
petruskreuz	negative
pewds	negative
pfandflaschen	positive
pfandleiher	negative
pfeifchen	positive
pfeifenraucher	positive
pferd	positive
pferdekopf	positive
pferden	positive
pffft	positive
pfingstrose	positive
pflanzkübel	positive
pflegebeteiligung	positive
pflegegehtaufreisen	negative
pflegehund	positive
pflegepony	positive
pft.	positive
pfäffike	positive
phantasialand	negative
phielib	positive
phine	positive
photoshopt	positive
phä	negative
picky	positive
pics	positive
pieckst	positive
pieeeep	positive
pieren	positive
piia	negative
pilotenbrille	negative
pilsken	negative
pimmels	negative
pinata	negative
pingui	positive
pinguin	negative
pinienkernen	negative
pinkelt.	negative
pinkpanty	positive
pink’s	negative
pinnchen	positive
pinni	negative
pinselchen	negative
pintomix	negative
pintostute	negative
pippi	positive
piratte	positive
pissgeile	negative
pisssklave	negative
pivat	negative
piwek	negative
pixel4art	positive
pixies	negative
planschbecken	positive
plastiktasse	positive
plateauschuh	positive
platzangst	negative
platzregen	negative
plauderei	positive
pletz	negative
pll.	negative
plot4u	positive
plätschern	positive
pläuschen	negative
plötzlech	negative
plüschiges	negative
podcatcher	negative
podenca	positive
poge	negative
pokemons	negative
pollenfrei	negative
poni	negative
ponk	negative
ponyhof	negative
pooh	positive
popen	positive
poppen	positive
pornokätzchen	negative
porzellanfigur	negative
porzellanpuppe	positive
positiv	positive
postamt	negative
postboten	positive
postbotin	negative
posterwand	positive
postet	positive
pottwal	positive
prada	negative
prakti	negative
praxisraum	negative
praxisschild	positive
preiselbeere	positive
preisinger	positive
presentiere	positive
presskopf	positive
prettynina	negative
prittwitz	negative
privatchat	negative
proberaum	positive
probiers	negative
profan	negative
profie	negative
profikoch	positive
promotionscoach	positive
propellerflugzeug	positive
proud	positive
provokante	positive
pröm	positive
pseudointellektualität	positive
psychologin	positive
psychomässig	negative
pubertierender	positive
pummelfee	positive
pumpdildo	positive
punkig	negative
punktejägern	positive
punktewertungen	negative
purtashadud	negative
puten	negative
puush	positive
päda	negative
pörtgenherder	positive
pürieren	negative
qloom	negative
quark	positive
quarkmaske	negative
quietschend	positive
radarpistole	negative
radierer	negative
rafa	negative
raffinesse	positive
rahmengenähte	negative
raku	positive
ramazotti	positive
ramon	positive
ramonadeluxe	negative
ramontik	negative
randomfactaboutme	negative
ranzenboy	negative
rappe	negative
rappen	negative
rappende	positive
rapperin	negative
rasenschnitt	positive
rasensprenger	positive
rassel|rasseln	negative
rassestute	positive
rassisten	negative
rastlos	positive
rastplatz	negative
rasul	positive
rathian	positive
ratte	positive
rattenscharfe	positive
rattler	negative
ratze	negative
raucherbank	negative
raudis	positive
raughs	negative
raumakzente	negative
raupi	negative
raupy	positive
rauschentfernung	positive
rausgegangen.	negative
rausmusste	positive
ravioli.	positive
rawk	positive
raziel	negative
readathon	positive
reapern	positive
rebecka	negative
rebellin	negative
rebensaft	positive
reblogge	negative
rechtschreibschwäche	positive
rechtzei	positive
recom.	negative
redebedarf	negative
redheads	positive
redlich	positive
regenbogenhaus	negative
regenhimmel	positive
reggä	negative
regtop	negative
reibend	negative
reihern	negative
rein	positive
reinbeisst	positive
reinbeißen	positive
reinbrüllst	negative
reinfahren	positive
reinknieen	positive
reinkommen	negative
reinmachst	negative
reinscheißen	negative
reinschiebe	positive
reinspritzen	positive
reinsteck	positive
reinstopfen	positive
reinstopfst	positive
reintunken	positive
reinziehn	negative
reiseangebot	positive
reiselustig	negative
reisendiashow	negative
reishuttragendem	negative
reiskocher	positive
reissverschluss	positive
reit	positive
reitbeteidigung	negative
reitho	positive
reißfest	negative
remidemi	positive
remoulade	positive
renke	positive
renly	negative
renov.	positive
rentnerparty	positive
reshi	positive
restlich	negative
restone	negative
restsonntag	positive
retuschieren	negative
retweet	negative
rhetorikhammer	negative
ricardos	negative
richel	negative
richtig	positive
riechend	negative
riesenbrust	negative
riesendanke	negative
riesenrespekt	negative
riesenschwanz	positive
riessige	negative
rinas	positive
rinderroularde	positive
ring.	negative
ripley	positive
rischmeyer	positive
risige	positive
rita	positive
rittersporn	positive
rißmann	positive
roboterstaubsauger	positive
robs	negative
rocke	positive
rocketpics	negative
rockparty	positive
rogate	negative
rojinski	negative
rokhyun	negative
roki	negative
rolator	negative
rolf.	negative
rom.	negative
romantiker	positive
romantikerinnen	negative
romantische	positive
roooobert	positive
rootrechte	negative
rooz	positive
rosaner	positive
rose	negative
rosenblatt	negative
rostig	negative
rosè	positive
rothmann	positive
rotstich	negative
rotweinglas	negative
rotweinkuchen	positive
rotznäschen	negative
rowdies	negative
rted	negative
rtst	positive
rubenslady	positive
ruckzuck	negative
ruderst	negative
rufste	negative
ruhig.	positive
ruhrpott	negative
ruig	positive
rumgegammelt	positive
rumgehen	positive
rumgehurt	positive
rumgeschupst	positive
rumgeschwule	negative
rumlecken	negative
rumpeltriebwerk	negative
rumrenn	negative
rumsauen.	negative
rumschleimst	negative
rumspacken	negative
rumsprühen	negative
rumtanzen	negative
rumtrampeln	negative
rumtreiben	positive
rumträgst	positive
runffm	negative
runna	positive
runter	negative
runterlaufen	negative
runterspringen	negative
runterzählen	negative
rushe	positive
ryo	negative
räkelnde	positive
röhrenjean	negative
röstkartoffel	positive
röstung	negative
rückbank	positive
rührkuchen	positive
rüschenschal	positive
rüsselantenne	negative
s'alqueria	positive
sabias	negative
sahneklecks	negative
sahs	negative
saju	positive
salamibrote	negative
salatdressings	negative
salatsoße	negative
samantha	positive
saminatorgeschichte	negative
sammlerfiguren	negative
sammlerpuppe	positive
sanduhr	negative
sandwichtoaster	negative
sango	negative
sangria	positive
sarahann	negative
saraya	positive
saruhiko	positive
sascha	positive
sasori	negative
satinbettwäsche	negative
satingürtel	positive
sauber	positive
sauber.	negative
saugeiler	negative
saunabesuch	positive
saunakota	negative
saunavariante	negative
saus	positive
sauteures	positive
sazzy	positive
schaben	positive
schabernackig	negative
schafen.	positive
schafstedt	negative
schaisse	negative
schakeline	negative
schalalala	negative
schale	positive
schalfen	negative
schalllöcher	positive
scharmör	negative
scharrend	positive
schatze	positive
schatzo	negative
schatzys	positive
scheisse	negative
scheisseeeeee	negative
scheisshaus	negative
scherzen	positive
scheu	negative
scheu.	positive
scheußlich	negative
schickeria	negative
schicket	positive
schickts	negative
schiebs	positive
schienst	negative
schiffen	positive
schiffshorn	positive
schippchen	positive
schizophrenia	negative
schlackern	positive
schlacksi	positive
schlafbereich	positive
schlafbesuch	negative
schlafgeräusche	negative
schlafrytmus	positive
schlafwandeln	positive
schlagball	positive
schlagzeug	positive
schlagzeuger	positive
schlampeee	positive
schlangeneier	positive
schlaudia	negative
schlecht	negative
schlieb	negative
schlimm	negative
schlitten	negative
schlohweiß	negative
schlonzi	negative
schluchzen	negative
schluckgierige	positive
schluckgieriges	negative
schlumperbüx	positive
schlupfbluse	negative
schlämpchen	negative
schlön	negative
schlüsel	negative
schlüsselanhänger	negative
schmalzen	positive
schmalzstulle	positive
schmankerl	positive
schmatz	positive
schmeckst	negative
schmelle	positive
schmerz	negative
schmieg	positive
schmierlappen	negative
schminktutorial	negative
schmu	positive
schmucknadeln	negative
schmunzelhasen	positive
schmusehund	negative
schmöcked	negative
schmökere	positive
schnack	negative
schnackt	negative
schnall	negative
schneeballschlacht	negative
schneeweißer	negative
schneiden.	negative
schneien	negative
schnein	negative
schneits	positive
schnelsten	positive
schnibben	positive
schnidde	negative
schnippeln	negative
schnippseln	positive
schnittmuster	negative
schnorren	negative
schnorres	positive
schnuffelig	negative
schnuffligen	negative
schnuggelich	positive
schnullerbacke	positive
schnupfig	positive
schnuppi	positive
schockräume	negative
schoffer	positive
schokohäschen	negative
schokoladenbrunnen	negative
schokoladenosterhase	negative
schokoladiger	negative
schokomaus	positive
schokosplittern	negative
schokotassenkuchen	negative
schoneinmal	negative
schonste	positive
schrade	negative
schramme	negative
schraube	positive
schreck	positive
schreiberin	positive
schreibtischplatte	positive
schreibtischschublade	negative
schribsch	positive
schroff	positive
schrottkiste	negative
schrumpel	negative
schrumpfkopf	negative
schuhmarke	negative
schuhsammlung	negative
schuldest	positive
schulermittler	positive
schulmädchen	positive
schulpause	negative
schulterklappe	positive
schuluni	positive
schulweisheit	negative
schutzengelbild	negative
schw	positive
schwabenländle	negative
schwach	negative
schwanzträger	negative
schwarzbier	negative
schwarzbrot	positive
schwarzweißen	negative
schweigend.	positive
schweinemaske	positive
schweinisch	positive
schweinsfilet	negative
schweiß	positive
schweißgebadet	positive
schwergängig	negative
schwerhörig	positive
schwertset	positive
schwiegermutters	positive
schwimmring	negative
schwin	negative
schwingend	negative
schwipp	positive
schwippschwapp	negative
schwulenpornos	positive
schwummerig	negative
schwungvoll	negative
schwänze	positive
schwänzerin	negative
schwärze	positive
schwörma	positive
schädlich	negative
schähm	positive
schälchen	negative
schälst	negative
schõne	positive
schön	positive
schül	negative
scotch	positive
screenie	negative
sechseck	negative
sedona	positive
seeehr	positive
seehund	negative
sehest	positive
sehnlich	negative
sehnsuchtsadressen	negative
sehnsuchtsvoll	positive
sehts	positive
seicht	positive
seil	positive
seintje	positive
seitdem	positive
seitenrand	negative
sekttrinken	negative
selbstbefriedigen	negative
selbstbild	positive
selbstbildnis	positive
selbstgefühl	negative
selbstgemalt	negative
selbstgezeichneten	negative
selbsthass	positive
selbstportraits	positive
selbstvergessen	positive
selbstzweifelnd	positive
seltsam	negative
senf	negative
sentimental.	negative
sepia	positive
serenas	positive
sers	positive
servieren	positive
setlock	negative
sevi	negative
sevil	negative
sexsomnia	negative
sexyhexi	negative
sexylady	negative
sfx	negative
sgtrumpelforpresident	positive
sgtvallerik	negative
shanks	positive
shaq	positive
sharpei	positive
shatz	negative
sheba	negative
sheldoncooper	positive
shemale	positive
shemales	positive
shindong	negative
shinigami	positive
shiro	positive
shnt	positive
shopdichfit	negative
shoppingtrip	negative
shortys	positive
shou	negative
shoutout	positive
shoutouts	negative
shrek	negative
shwester	positive
shä	positive
siamkatze	negative
sica	positive
sichst	positive
sichtschutz	positive
sieghard	positive
sielen	negative
siemensmitarbeiterin	negative
siemst	negative
sie|sie	negative
silikonform	negative
silvity	positive
singha	positive
singleportal	positive
sis.	positive
sisch	negative
sitzende	negative
sitznachbar	positive
sjö	positive
skandalpreisen	positive
skara	negative
skelett	positive
skikurs	positive
sklavenmaul	negative
sklavenschwanz	negative
sklaventreiber	positive
skypem	negative
skypen.	positive
sleepover	negative
sleigher	positive
slendytubbies	negative
slushy	positive
smaya	negative
smoothies	negative
snakebite	positive
snapbacks	positive
sobst	negative
sockelleiste	negative
softes	negative
sohappy	positive
sommermantel	negative
sommerparty	negative
sommershuhe	negative
sommersocken	negative
sonderbonbons	negative
sonn	negative
sonnelicht	negative
sonnenplätzchen	positive
sonnenreichen	negative
sonnenstich	negative
sonnsee	negative
sonore	positive
sooonneee	positive
sooooooooooooooooooooooo	positive
sooss	positive
sorgenbrecher	negative
sorte.	negative
sowiso	positive
sozialevolontär	positive
sozialromantikhintergrund	negative
spacig	positive
spagel	positive
spalt	negative
spammercommunity	positive
spargelcremesuppe	negative
spargelsalat	positive
sparky	negative
spazier	positive
speckbauch	negative
speculum	positive
spellyournamewithrammsteinsongs	negative
spiegelbrille	positive
spiegelfoto	positive
spiegelfotos	positive
spielcharakter	positive
spieldrang	negative
spiiieeeellll	negative
spitzenstoff	negative
spitzohr	positive
spliff	positive
splittern	positive
spn	negative
spok	positive
spongbob	negative
spongebozz	positive
sport.	positive
sportbegeistert	positive
sportgeschäft	negative
sportspektakel	negative
sprachmemo	negative
sprachs	negative
sprachschub	positive
sprallo	positive
sprayende	negative
sprechstimme	positive
sprenkel	positive
springbrunnen	negative
sprudelliegen	negative
sprössling	positive
spüler	negative
ssiges	negative
stabilos	negative
stachelschwein	negative
stadessen	positive
stahlhelmfraktion	positive
stallgemeinschaft	negative
standhaft.	positive
standst	positive
stangentanz	negative
stanze|stanzen	negative
starbucksverkäufer	negative
staskowiak	positive
statistikverbesserung	negative
staub.	negative
staubfänger	negative
staypimmel	negative
stechers	negative
stehenlassen	negative
steier	positive
steiinoptik	positive
stengel	positive
sterb	positive
sterben	positive
sternchenverteiler	positive
sternenzerstoiber	negative
stewardess	positive
stiefdad	positive
stiefelabsatz	negative
stiefpapi	positive
stilikonen	negative
stillkissen	positive
stillst	negative
stimmfang	positive
stimmungsschwankung	negative
stirnküsse	negative
stockdunkle	positive
stockschirme	negative
stoffhose	negative
stofftasche	negative
stormcloud	negative
stotterst	negative
stowasser	positive
straciatella	positive
strapon	positive
strapshalter	positive
strassapplikation	negative
strassenband	positive
strassenmusikerin	negative
strassenseite	positive
strasssteinen	positive
streitest	negative
streitlustig	negative
stretchkleid	positive
streunen	negative
strickliese	positive
stricktreffen	negative
strick|stricken	negative
strumphose	negative
stubenrocker	negative
stuie	negative
stupse	negative
sturmmaske	positive
sturr	negative
stute.	positive
styla	positive
stéphanie	negative
stöckel	positive
störrisch	negative
suchtet	negative
suezz	negative
suffie	negative
suhlen	negative
suizidwelle	positive
sulzmann	positive
supeerrr	positive
superfan	negative
superheldenkostüm	positive
superhübsch	negative
superhübsche	negative
supernatural	negative
supersonniges	positive
supersüsses	positive
supporten	negative
surferboys	positive
surp	negative
surreal	negative
surrealen	positive
susannah	negative
sushi.	negative
suspektesten	positive
suuuu	negative
svend	positive
svene	negative
swaaaaag	negative
swaghetti	positive
sweeett	positive
sweetdesire	positive
sweetsteffi001	negative
sweetsusi	negative
swiet	positive
swingerpärchen	positive
sylvester	positive
sylvi	negative
sächlich	negative
sächsilüüte	negative
sänger	negative
süb	negative
südgarten	negative
südländisch	negative
süffelt	negative
süffig	negative
süse	positive
süssenbach	negative
süssling	negative
süz	negative
süüüsss	positive
taaaag	negative
tabaluga	positive
tabby	positive
tablett	positive
tachchen	positive
tafelwerk	negative
taff	positive
tagebart	negative
tagescafe	negative
tageslichtlampe	positive
tagesrhythmus	negative
tagsforlikes	negative
tammara29	negative
tampopo	negative
tanu	negative
tanzst	positive
tanzstudenten	positive
tanztraining	positive
tapezierarbeit	positive
tarnklamotte	positive
taschenaschenbecher	positive
taschenuhr	negative
tasern	negative
tattootermin	negative
tattop	negative
tauchbecken	negative
taxifahrer	negative
tbpafk	positive
teamaufbau	positive
teamtea	positive
technikbegeistert	negative
teebaumöl	positive
teeglas	positive
teeniefreundin	positive
teenygirl	positive
teetisch	positive
teier	negative
teigfladen	negative
telefoieren	positive
tellerrock	positive
tellytellz	negative
tenimyu	positive
tennie	positive
tensor	positive
tentakeln	negative
teppat	positive
teppich.	positive
teppichmesser	negative
terrassentür	negative
teufelsküche	negative
textcontainer	positive
textnachrichten	positive
thailänderin	negative
theaterpädagogin	positive
thefaculty	negative
thehehe	positive
thehidden	negative
thekohas	positive
theredcubetv	negative
thermalbad	positive
thommy	positive
thunfisch	positive
tierdokus	positive
tiergifs	negative
tihihi	negative
timberlands	positive
tischgebet	negative
titkoja	positive
tittenava	negative
tittenmassage	positive
toasty	positive
toblerone	positive
tobsuchtsanfall	positive
tockner	negative
tokiohotelthanksfollowspree	positive
tollige	positive
tollpatschigen	positive
tomatenbrotparty	positive
tonni	negative
tonstudio	negative
tooooodes	negative
topfenpalatschinken	negative
torchwood	positive
totknuddeln	positive
totkrank	positive
toupiert	positive
tourgeschenk	negative
trabireiter	negative
trainingsanzug	positive
trainingspartnerin	negative
trannen	positive
trashig	negative
trashiger	negative
trashnight	negative
trashtazmani	negative
trauen	negative
traumgebilde	positive
traumhaus	positive
traumpirat	negative
traumpärchen	negative
traumschuhe	positive
trebs	positive
trekkingtour	positive
trendigen	positive
trendsetter	positive
tret	negative
trette	negative
tribühne	positive
tribünendach	positive
triforce	negative
trilby	positive
trockenfrucht	negative
trocknen	positive
trocknungsgerät	negative
trolololol	positive
trololololololo	negative
trommelfloh	negative
trotzdem.	positive
trotzden	positive
troya	positive
troztem	negative
trulle	positive
trz.	negative
trägershirt	positive
trägertops	negative
träinen	positive
trüb	negative
tschaui	negative
tschuldige	positive
tschöö	positive
tschüüüs	negative
tuerkis	positive
turino	negative
tute|tuten	negative
tvtotal	negative
twafl	positive
twelite	negative
twink	positive
twittbürger	positive
twitterabstinent	negative
twitteraccount	negative
twitterbar	positive
twittere.	negative
twittererin	negative
twittergemeinde	positive
twitterianer	positive
twitterinen	positive
twitteristas	negative
twitternamen	negative
twitterrunde	negative
twittreim	negative
tws	negative
typie	negative
tyra	positive
tzaziki	negative
tzz	negative
tzzz	positive
tätet	negative
täusch	negative
tölen	positive
tövbe	negative
tøsen	positive
tüdelü	positive
tüdelüü	negative
türkisblau	positive
türrahmen	negative
türramen	positive
ubd	positive
udn	positive
uffgeregt	negative
ufgwacht	negative
uhhi	positive
ukelele	positive
ullmann	positive
um3	negative
umarmt	negative
umbringen.	positive
umdrehn	positive
umflausch	negative
umgekleidet	negative
umgerannt	positive
umschnall	positive
umschnalldildos	positive
umsich	positive
umsorge	positive
umzugskiste	negative
umzugsstress	positive
unaktiv	negative
unangenehm	negative
unbedarft	negative
unbehaart	negative
unbequem	negative
unbescholte	positive
unbeschreiblich.	negative
unbeschrieblich	negative
uncoole	positive
unddann	negative
undurchsichtig.	positive
uneigennützig	positive
uneinsichtig	positive
unerfreulich	negative
unfallambulanz	positive
unfollowen	negative
ungarin	positive
ungelogen	negative
ungeniert	positive
ungesund	negative
ungeziefer	negative
ungezogen	positive
ungeübt	positive
unglücklich	negative
ungünstig	negative
unikat	negative
universalist	negative
universalmedizin	positive
universitätsstadt	negative
unizeug	negative
unkommunikativ	negative
unkpomplizierte	negative
unmac	negative
unrecht	negative
unschlüssig	positive
unschön	negative
unterholz	positive
unterhöschen	negative
unterlegen	negative
untermotorisiert	positive
untersuchungsheft	positive
unvernünftig	negative
unvollkommenheit	negative
unwiderstehli	positive
unwiederstehlich	negative
unwissend	negative
unzufriedenes	negative
unästhetisch	negative
urgh	negative
urinieren	positive
urlaubsende	negative
urlaubsland	negative
urlaubsort	positive
urlaubsziel	negative
ursprungsfrage	negative
uuuuunglaublich	negative
uzi	positive
vaginas	negative
valldemossa	positive
vampir	negative
vanillefarben	negative
vanillekipferl	positive
vanilleschote	positive
vanillezucker	negative
vaseline	positive
vatti	positive
vegetarierin	positive
veloursleder	positive
velut	positive
vendola	negative
verabscheuen	negative
verarschst	positive
verbittern	positive
verblichen	positive
verdamm	positive
verdauungs	positive
verdiens	negative
verdirb	positive
verdorben	negative
verfi	positive
verfic	positive
verfluchen.	negative
verfärben	negative
verführun	negative
vergammel	positive
verhauen	positive
verhült	negative
verkauffe	positive
verkehrtrum	positive
verknalle	negative
verknallt	positive
verkopfter	positive
verkriechst	positive
verkühlung	positive
verlangem	negative
verlauft	positive
verletzend	negative
verliehrt	negative
vermissse	negative
vernunftbegabt	negative
vernüftigen	positive
verpartnern	positive
verpeilt.	negative
verpenn	negative
verpennen	negative
verplanter	positive
verrufen	negative
verrücktesachenmachenwennmanverliebtist	negative
versaue	negative
verschisse	positive
verschwörungstweet	positive
versicherungstyp	positive
verslein	positive
versorgst	negative
versprechs	positive
versteinern	negative
verstöre	negative
versüssung	negative
vertilg	positive
vertrauensvoll	negative
verwanschaft	positive
verweilen	positive
verwohne	negative
verwöhnpension	negative
verwöhnprogramm	negative
verzehrst	negative
verzichte.	negative
verziehn	positive
verziere	negative
verzweifelter	negative
veräppelt	negative
vid	positive
videooo	negative
videowunsch	positive
viech	positive
viedo	negative
vieeeeele	positive
vieeeele	negative
vierteilen	positive
vika	positive
vilt	positive
visagistic	positive
vladimir	negative
vogelnest	positive
vogelwilde	negative
voher	positive
volant	negative
vollblut	negative
vollgeil	positive
vollgewichst	negative
vollglatze	negative
vollkommen	positive
volllabert	positive
vollspast	negative
vollspastis	positive
vollstopfen	positive
volltrottel	positive
voollll	negative
voract	positive
vorahnung	negative
vorbeiziehen	positive
vorglühen	positive
vorgruppe	positive
vorhut	negative
vorkochen	positive
vormittag	positive
vornehmt	negative
vornimmst	negative
vortanzen	negative
voyeur	negative
vr100	negative
vreni	negative
völkchen	negative
vöu	negative
w23	positive
waaaaah	positive
waaaaas	positive
waaaah	positive
wackeldackel	positive
wackelpudding	positive
waffenschein	negative
waffentechnisch	positive
wahlkabinen.	positive
wahnsinng	positive
wahnsinns	positive
wahr.	positive
wakame	negative
walther	negative
wambir	positive
wandern	negative
wandsetal	negative
wannebe	positive
wardinator	positive
ward’s	negative
warlander	negative
warn.	positive
wart|warte|warten	positive
waschbecken	negative
waschen.	negative
waschsalon	positive
wasser.	positive
wasserkaskaden	positive
wasserkocher	negative
wassern	positive
wattebauschen	negative
waxing	negative
we	positive
webcamfotos	positive
webdesignerin	negative
wecker	positive
wegat	negative
wegbier	negative
weger	positive
wegessen	negative
weggeboxt	positive
weggefeiert	negative
weggehn	negative
weggeleckt	negative
weggesetzt	positive
wegpennen	negative
weht.	positive
weibas	negative
weibsbild	negative
weilichskann	negative
weinende	negative
weinkeller	positive
weinkenner	positive
weinstrasse	positive
weintest	negative
weish	positive
weissbauch	positive
weissesr	negative
weiteer	negative
weitergepennt	positive
weitermachen	negative
weiterschicken	positive
weiterträumen	positive
wellensitische	positive
welpenfotos	negative
weltfrieden	negative
weltreise	positive
weltschönste	negative
welzweit	positive
wengal	negative
wennigstens	positive
wennihrmichimrlkennenwürdet	positive
wenn’s	negative
werbayernmünchenmag	positive
werbebude	positive
werbegeschenk	negative
werdest	positive
wertschätzt	negative
westpaket	positive
wetterkerze	negative
wetterservice	positive
wetterumschwung	negative
wetterunabhängig	positive
wettr	negative
wgds	positive
whatsappnachrichten	negative
whatwhat	positive
wheeey	negative
whoa	negative
wic	negative
wichskinder	positive
wichtig	positive
wichtiig	positive
wickeltuch	positive
widde	positive
widerlich	negative
widerspenstig	positive
widerwärtig	negative
wiedergebären	negative
wiedl	positive
wiets	positive
wievielt	negative
wigs	positive
wigwam	negative
wiiiiie	negative
wild.	positive
wilden.	negative
wildernder	negative
wildfa	negative
willkommem	negative
wintermüde	negative
winterpulli	positive
wintertraining	negative
winti	negative
winzermeister	negative
winzigkeit	negative
wirsch	negative
wisoo	negative
witzebuch	positive
witzfigur	positive
witzige	positive
wiviele	positive
wixe	negative
wixxen	negative
wneig	negative
wochen	negative
wochenede	positive
wochenenddomizil	negative
wochenendeende	positive
wodi	positive
woggy	positive
wohaa	positive
wohlschmeckend	positive
wohnor	negative
wohns	negative
wohnug	negative
wohnzimmerwand	negative
woistolivia	negative
wolke.	positive
wolkenfreier	negative
wollmäusen	positive
wollt.	positive
wolten	positive
wommy	positive
wonderwall	negative
woodkid	negative
wordpressseite	negative
wortgewandtheit	negative
wuchenend	negative
wulli	positive
wundercreme	negative
wunderherrlichen	positive
wunderhund	positive
wunderschöner	negative
wunderschööööön	negative
wundeschön	negative
wundeschöner	positive
wunschhalsband	positive
wunschoutfit	negative
wunschsongs	negative
wurscht	negative
wurzelimperium	positive
wuselnde	positive
wushi	negative
wusstes	negative
wutze	negative
wynona	negative
wã¼rdest	positive
währst	positive
wäschespinne	positive
wäscheständer	negative
wää	positive
wäääh	positive
wünderschönen	positive
wüns	negative
wünscg	negative
wünsh	positive
würgreiz	positive
würschtel	negative
x215cm	negative
x3333	positive
x333333	negative
xdich	negative
y'know	negative
yagma	positive
yamada	positive
yeahhhhhhhh	positive
yeeear	positive
yeehaaa	negative
ylva	positive
ymca	positive
yololatte	positive
yongguks	positive
yosha	negative
youtubern	positive
yupii	positive
yuppies	negative
yuri	negative
yutaka	negative
yäy	positive
yüäär	positive
zackzack	negative
zahnspangen	negative
zahnstange	negative
zahnärzten	positive
zartbitterschokolade	positive
zauberfee	negative
zauberhaftigst	positive
zayns	negative
zazabrooklyn	positive
zdz	positive
zehensocken	positive
zeichentrickfigur	positive
zeinfeld	positive
zeitlupenknopf	negative
zelten	positive
zerdrücke	negative
zerfetzen	negative
zerfickt	negative
zeri	positive
zerkratzen	negative
zermatscht	negative
zermatschte	positive
zerplatzen	negative
zerren	negative
zerst	positive
zerteil	positive
zettel	negative
zeuch	negative
zeugen	positive
zickende	positive
ziegenbärtchen	negative
ziernaht	negative
zigarettenrauch	positive
zigarreten	positive
ziischtig	positive
zimmerboy	negative
zimmerbrunnen	positive
zimmerwand	positive
zimt.	negative
zinha	negative
zischtig	positive
zitronencreme	positive
zmüed	negative
zockst	positive
zockt	positive
zombieaugen	negative
zrugg	positive
zuballern	negative
zubeißen	negative
zuchtstute	negative
zuckerherz	negative
zuckst	positive
zudröhnen	negative
zugekniffen	negative
zugerotzt	positive
zugfahren	positive
zuha	negative
zukriegen	positive
zulenken	positive
zupfer	negative
zureiten	positive
zurennt	negative
zurúck	negative
zurückgrüßen	positive
zusammen.	negative
zusammenfalten	positive
zusammenpacken	positive
zusammenschmeisst	positive
zuschauerin	negative
zuschmeissen	negative
zuspamt	positive
zuu	positive
zuver	positive
zuvergessen	negative
zuverlässi	negative
zuziehst	positive
zvväggg	negative
zweiohrküken	negative
zweitwohnung	positive
zweizimmerwohnung	negative
zwergdackelwelpen	positive
zwergrex	negative
zwetna	positive
zwick	negative
zwiebelmett	negative
zwiebelrostbraten	positive
zwiebelsaft	negative
zwilling.	positive
zwitschern.	positive
zwitschernd	positive
zwulf	positive
zwängen	positive
zzzz	positive
zämme	positive
zärtliche	positive
zürichsee	negative
den	positive
°a°	positive
°°	negative
ä3	negative
äglichen	negative
ält	negative
ärmellos	negative
äähh	positive
ääähm	positive
çay	positive
öhhhm	positive
öhm	positive
übel	negative
überfliegst	negative
überfressen	positive
überlegen	positive
überlegs	positive
übernacht	positive
überra	negative
überragend	positive
überraschungsparty	positive
überrumpeln	positive
überstundenabbau	positive
überweisungszweck	negative
ütendorf	negative
ړײ	negative
‘digga’	negative
‘nem	positive
’nem	positive
☆☆	negative
☕☕☕	negative
♥kostenlos	positive
♥lich	positive
♥liebe	positive
♥♡♥♡	negative
♪	negative
✌✨	negative
❄⛄	negative
❣	positive
❤liche	negative
🎀	positive
🎉	negative
👏👏👏	negative
👗	positive
💇	positive
💛☀✨	positive
😳	negative
