...?	positive
170	negative
36j_	positive
ablenken	positive
abreiben	positive
affengeil	negative
aladdin	negative
alicia	negative
alihan	positive
altfollower	positive
am√ºsierst	negative
angenehm	positive
anschliessend	negative
anstossen.	positive
anstrengst	negative
antipasti	positive
antispeziesistisch	positive
architekturprogramm	positive
arlette	positive
arm	negative
armselig	negative
aronal	negative
arschhure	negative
artistin	positive
arvika	negative
ausgezeichnet	positive
ausstellungsbuch	positive
authentisch	positive
autofenster	negative
awkward	negative
azkaban	positive
azzlack	positive
backpfeifengesicht	negative
ballonseide	negative
bartschatten	negative
battlerap	positive
bayernfan	negative
bedauernswert	negative
bee5	negative
beileid.	negative
belangsendung	negative
benjoo	negative
berufspraktisch	negative
beruhigungstropfen	negative
besondertes	positive
bespannen	negative
besser	positive
besti	negative
betontem	positive
biddesch√∂n	negative
biiiitte	positive
bildsch√∂nes	negative
birakta	negative
bittesehr	positive
blaf	negative
blasegirl	positive
blas‚Äô	negative
blattsalat	positive
blechdose	positive
bleibe	negative
blondierung	positive
blouson	positive
boooom	negative
bowser	positive
braunt√∂nen	negative
brotteig	negative
budni	positive
buntstiften	negative
burka	positive
busfenster	positive
b√∂se	negative
catscorner	negative
catsitter	positive
chattest	negative
cheef	negative
cheffe	negative
cheo	negative
chrischan	positive
christbaumkugel	positive
ch√∂nnt	negative
cialaska	negative
commandante	positive
companytour	positive
cosette	positive
daigo	negative
dascha	positive
dasitz	negative
dazustellen	negative
deinjanina	positive
desinfektionsmittel	positive
devourment	negative
dikka	negative
diktatorin	positive
dingerchen	positive
dinosaurierskelette	negative
disneyfilm	negative
disskutieren	negative
dixi	negative
dorn	negative
dough	positive
dschungelbewohner	negative
dupstep	positive
durchs	negative
duz√∂	positive
d√§bak	negative
d√§nerys	positive
d√∂rt	positive
d√ºrftig	negative
eckzahn	positive
eine.	negative
einfallen	negative
eitag	positive
ekelerregend	negative
ekelhaft	negative
ekelig	negative
elefantenhaken	negative
elektrisiert	positive
emailadresse	negative
endllich	positive
engelnyoga	positive
erdbeerquark	negative
erdbeertorte	positive
erdloch	positive
erinnern	negative
erlernba	negative
erotikmesse	positive
ertragbar	negative
facebookprofil	negative
faken	positive
falsch	negative
fan.	positive
fanarts	negative
fasr	negative
fernweh	negative
ferres	negative
feucht.	positive
feuerwehrauto	positive
fieberblase	negative
fies	negative
filterzigarette	negative
finstre	negative
firmenfeier	positive
flippig	negative
fluchderkaribik4	negative
flusspferd	positive
fotofreak	negative
frah	negative
franzy	negative
frauenzimmer	positive
frein	positive
freitagsgr√ºsse	negative
freizeittaschen	positive
freundlich	positive
frutkoff	negative
fr√§stechnik	negative
fr√ºhlingsbunt	negative
fr√ºhlingsnachmittag	positive
fr√ºhst√ºckstweet	positive
ganzk√∂rperkontakt	negative
gassiservice	negative
geburtstagssteak	positive
geb√§udetechnikplaner	positive
gef√ºhlsecht	positive
gegenst√ºck	positive
geldbeutel	negative
gemein	negative
gepupst	negative
geretweetet	negative
geringwertig	negative
germanys	negative
gestanden	negative
getellt	positive
gewand	positive
gideon	positive
glubschi	negative
gl√ºcklich	positive
gl√ºckstr√§ne	negative
googlesuggest	positive
grauehaft	negative
gripp	positive
gr√ºnzeugs	negative
gschieder	negative
gseht	positive
gst√∂rt	negative
guhut	positive
gut	positive
guteeeeee	positive
gutster	positive
hackfleisch	negative
hahahahq	positive
hakle	negative
halskratzen	positive
hamburger.	positive
hammerstimme	negative
hamsterbacken	negative
handynummer.	negative
harpune	positive
heibe	positive
heilerdemaske	positive
heimkinovergn√ºgen	positive
heir	negative
hellblau	negative
hemdchen	positive
henckels	positive
herzensw√§rme	positive
herzerweichend	positive
herzlichkeit	negative
hingehn.	positive
hinte	negative
hintereingang	positive
hmhmhmmm	negative
hochzeits	positive
holts	positive
holzbeinen	positive
holzperlenarmband	negative
hormon	negative
huiiii	negative
hundepfoten	positive
hurensch√∂n	negative
h√§lmchen	negative
h√§rzlich	positive
h√§sslich	negative
h√∂herwertig	positive
h√ºbsch	positive
ijemand	negative
internet.	positive
irdendwann	negative
irrenhaus	positive
irrig	negative
jaaay	positive
jessica	positive
jippi	negative
kaffeeknopf	negative
kalli	negative
kamerad	negative
kartoffelkiste	positive
kirschroter	negative
kliene	positive
klinge	negative
kniesocken	positive
knospen	negative
kn√§ul	negative
konservendose	negative
korbsessel	positive
korrekt	positive
kramst	positive
kreissaal	positive
kricht	positive
kuschelhasen	negative
kwanghee	negative
kwangmin	negative
k√§mpfend	negative
lady.	negative
lallend	negative
lang.	positive
langarmshirt	positive
lastpic	negative
laufsch	negative
lebendigkeit	negative
lecki	negative
lede	negative
legging	positive
legokiste	negative
lehne	negative
lehrerpaar	negative
lena18	negative
lenkergewicht	positive
liche	positive
lichtdurchflutet	negative
lieb	positive
lieblingsaccount	negative
lieblingsecke	negative
lieblingsserien	positive
lieblingsspielerin	negative
l√∂chlein	negative
macchina	positive
macheath	negative
machomann	negative
maltr√§tieren	positive
mangelhaft	negative
mathegenie	positive
matheo	negative
matsche	negative
maul	negative
mauzen	negative
megaaaaaa	positive
megaschlecht	positive
melitta	positive
menki	positive
menschentiereunddoktoren	negative
mibewohnerin	negative
milchtopf	negative
minderwertig	negative
mindfucked	negative
min√ºtchen	positive
misslich	negative
mistig	negative
mitmarschieren	positive
mittelalt	positive
mollis	positive
muahahahha	positive
muddah	positive
muddu	positive
mukena	negative
myrte	negative
m√ºllen	negative
nachrangig	negative
nachtitweet	positive
nachzufaven	negative
nacktsein	negative
negativ	negative
nett	positive
netzabsturz	negative
noaaw	negative
nuppel	negative
n√∂cher	negative
obdachloser	positive
obieglo	negative
ohringe	positive
onkelgordy	negative
outgun	positive
pairing	negative
pappig	positive
partyschlampe	positive
pewds	negative
pflanzk√ºbel	positive
pics	positive
pimmels	negative
pippi	positive
pixies	negative
pll.	negative
podenca	positive
porzellanpuppe	positive
positiv	positive
postbotin	negative
probiers	negative
propellerflugzeug	positive
quark	positive
rassestute	positive
ratte	positive
ratze	negative
ravioli.	positive
rechtschreibschw√§che	positive
richtig	positive
robs	negative
rocke	positive
rothmann	positive
ruckzuck	negative
rumtrampeln	negative
runter	negative
r√∂hrenjean	negative
r√∂stung	negative
salamibrote	negative
saruhiko	positive
sasori	negative
schaben	positive
schatze	positive
scheu√ülich	negative
schienst	negative
schippchen	positive
schlangeneier	positive
schlecht	negative
schlimm	negative
schlumperb√ºx	positive
schl√§mpchen	negative
schl√∂n	negative
schmalzen	positive
schmalzstulle	positive
schmusehund	negative
schnuppi	positive
schokosplittern	negative
schrottkiste	negative
schutzengelbild	negative
schwach	negative
schwarzbier	negative
schwerg√§ngig	negative
schwin	negative
schwungvoll	negative
sch√§dlich	negative
sch√∂n	positive
scotch	positive
selbstzweifelnd	positive
sentimental.	negative
sers	positive
sevi	negative
shanks	positive
shemale	positive
sica	positive
siemensmitarbeiterin	negative
silvity	positive
sis.	positive
skikurs	positive
sleigher	positive
slushy	positive
snapbacks	positive
sobst	negative
sommersocken	negative
sonderbonbons	negative
sozialromantikhintergrund	negative
speculum	positive
spellyournamewithrammsteinsongs	negative
spiegelfotos	positive
sprachs	negative
stachelschwein	negative
stadessen	positive
staubf√§nger	negative
stiefdad	positive
stillkissen	positive
stimmfang	positive
styla	positive
suhlen	negative
superfan	negative
surp	negative
sushi.	negative
swiet	positive
tagebart	negative
tammara29	negative
tanu	negative
tanzst	positive
tanzstudenten	positive
taschenaschenbecher	positive
taschenuhr	negative
taxifahrer	negative
thail√§nderin	negative
theaterp√§dagogin	positive
theredcubetv	negative
tischgebet	negative
tittenava	negative
tockner	negative
torchwood	positive
totkrank	positive
trainingsanzug	positive
trashig	negative
trashiger	negative
trashtazmani	negative
trekkingtour	positive
trocknungsger√§t	negative
trolololol	positive
tr√ºb	negative
twink	positive
twitterabstinent	negative
twitterbar	positive
typie	negative
umgekleidet	negative
unangenehm	negative
unbeschreiblich.	negative
unerfreulich	negative
ungl√ºcklich	negative
ung√ºnstig	negative
unrecht	negative
unterlegen	negative
urinieren	positive
velut	positive
vendola	negative
verabscheuen	negative
verdorben	negative
verhauen	positive
verkopfter	positive
vern√ºftigen	positive
verschisse	positive
verziehn	positive
vika	positive
vogelnest	positive
vollblut	negative
vollgewichst	negative
vollkommen	positive
vorahnung	negative
waschsalon	positive
webcamfotos	positive
weger	positive
weggeboxt	positive
weibsbild	negative
weissesr	negative
weitergepennt	positive
weiterschicken	positive
welpenfotos	negative
wetterunabh√§ngig	positive
wgds	positive
whatwhat	positive
widerlich	negative
widerspenstig	positive
widerw√§rtig	negative
winzermeister	negative
winzigkeit	negative
wohaa	positive
wolke.	positive
wundercreme	negative
wundersch√∂ner	negative
wunschhalsband	positive
w√§√§	positive
w√§√§√§h	positive
ylva	positive
zickende	positive
zitronencreme	positive
zur√ºckgr√º√üen	positive
zuvergessen	negative
zuverl√§ssi	negative
zweizimmerwohnung	negative
zwergdackelwelpen	positive
zwick	negative
zwiebelmett	negative
zwulf	positive
√ºbel	negative
√ºberfressen	positive
√ºberlegen	positive
√ºberlegs	positive
√ºbernacht	positive
√ºberra	negative
√ºberragend	positive
‚Äòdigga‚Äô	negative
‚ùÑ‚õÑ	negative
üéÄ	positive
