!..	positive
#oase	positive
#technik	negative
%negsmileyam	negative
%negsmileyerfekt	negative
%negsmileykrampf	positive
%possmiley-collection	positive
%possmiley33333333	negative
%possmiley33333333333333	positive
%possmileyanke	positive
%possmileydenke	negative
%possmileyguten	negative
%possmileyhast	positive
%possmileyiesmal	negative
%possmileyino	positive
%possmileyjo	positive
%possmileylg	positive
%possmileylieb	positive
%possmileylove	negative
%possmileymeiner	negative
%possmileyschicke	negative
%possmileyschreib	positive
%possmileysfz	positive
%possmileysie	positive
%possmileysind	negative
%possmileyvon	negative
%possmileywerde	negative
%possmileyx	positive
%possmileyxd	negative
%possmileyxxx	positive
%possmiley³	negative
%user-fan	negative
%user-team	negative
%user-zahl	positive
&	positive
'	positive
****	positive
********	positive
+1s_	positive
...?	positive
/;	positive
170	negative
170g_	positive
19)_	positive
19+_	positive
19j_	positive
19°_	negative
20j_	negative
23j_	positive
25º_	positive
27j_	positive
27°_	negative
2m_	negative
36j_	positive
38j_	positive
39j_	negative
3h_	negative
45,1	negative
48)_	negative
50j_	negative
55j_	positive
57j_	negative
60)_	positive
65j_	negative
750)_	negative
75c_	positive
8)	positive
8b_	negative
:'*	positive
:'dddd	positive
;o)	negative
?	negative
???...	positive
????..	negative
?????	negative
@57kitty57	positive
@carobeatz	negative
@igippi	positive
@learnosm	positive
aaaaaaaaaaaw	positive
aaaaaaah	negative
aaaaalter	positive
aaaaargh	negative
aaaaauch	negative
aaaalte	positive
aaaalter	negative
aahhhhh	negative
aarons	positive
abber	negative
abblättern	positive
abbo	negative
abbos	negative
abdï	positive
abendbrotzeit	negative
abendlich	negative
abendmode	negative
abendrunde	negative
abendspaziergang	positive
abendtee	negative
abfat	negative
abfuck	positive
abfucked	negative
abfährst	negative
abfällen	negative
abgammeln	negative
abgeritten	positive
abgeschnitten	positive
abgesägt	negative
abgetragen	positive
abgewixt	positive
abgrasen	positive
abhotten	positive
abhä	negative
abhänging	positive
abi	negative
abi2015	negative
abifahrt	negative
abig	negative
abigail	positive
abkauen	negative
abklatschen	positive
abkühlen	negative
abla	positive
ablacht	positive
ablenken	positive
abnehmt	negative
abneigen	positive
abnemme	negative
abnormal	positive
abnäher	negative
abonnentin	negative
abonnier	negative
abrechnungsspezialistin	positive
abreiben	positive
abschiedsbrief	positive
abschiedsessen	positive
abschiedsgeschenk	negative
abschiedskuss	negative
abschlecken	negative
abschleifen	negative
abschleppseil	negative
abschli	positive
abschlussshirt	positive
abspasten	negative
abspült	positive
abstechen	negative
abstehen	positive
abstossend	negative
abtrocknen	positive
abtupfen	positive
abwasche	positive
abwechseln	negative
abwechselungsreich	negative
abwechslung.	positive
abwechslungsreich	negative
abzurasieren	negative
abzuwichsen	positive
accio	positive
achwat	positive
ackern	positive
acoount	positive
adelsblass	positive
adidasneo	negative
adipösen	positive
adipöses	positive
adoptier	negative
adoptieren.	positive
adoptivsohn	positive
adrenalin	positive
adressenliste	negative
adrienne	positive
adultgermany	negative
aeropress	negative
affengeil	negative
affig.	negative
afro	positive
agressiv	positive
agressive	negative
ahahahahahaha	positive
ahoj	positive
ahso	negative
aiii	negative
aipotu	negative
airmax.	positive
akane	positive
akazienhonig	negative
aktenmappe	positive
aktiv	negative
aktualisierst	negative
akzent.	positive
aladdin	negative
alarmknopf	negative
alaska	negative
albanerin	positive
alessa	positive
alexe	positive
algierfranzösisch	negative
alicia	negative
alihan	positive
alkoholiker	negative
alkohoool	negative
alleinerzieh	negative
alleingeburten	negative
alleinsein	negative
allerallerallerbeste	positive
allerbestefreundin	positive
allercoolste	negative
allergikerin	positive
allerherzlichsten	positive
allerschönsten	positive
allertollsten	positive
alliteration	negative
alllller	positive
alloa	positive
allover	positive
allroundtalent	positive
alltagslook	negative
alltagsstress	positive
allwissend	negative
almans	negative
aloha	positive
alprausch	negative
alsleben	negative
alsob	negative
alt.	negative
altair	negative
altaïr	negative
alterego	positive
alterer	positive
altersgenosse	negative
altersheim	negative
alterst	positive
altfollower	positive
alti	negative
altkräfte	negative
altrosa	positive
alufolie	negative
alüg	negative
amaranth	positive
amateurfilm	negative
amateurstorys	positive
amde	positive
amiland	negative
ammoniakgeruch	negative
amumu	negative
amöbe	positive
amüsier	positive
amüsierst	negative
analgeilheit	positive
analsex	positive
analspülung	positive
analstoss	positive
ananashaus	negative
anbrüll	negative
andalusierwallach	positive
andere	negative
anderscht	negative
andeutung	positive
andic	positive
androidlockxt	negative
aneinanderkuscheln	positive
anett	negative
anfassen	positive
anfeuer	positive
anfängerhund	positive
anfühl	positive
angebetete	negative
angedeutet	positive
angefangen	positive
angehabt	positive
angeliebt	negative
angelkumpel	negative
angeln	positive
angeln.	positive
angenehm	positive
angepisst.	positive
angepisstclub	positive
angestrahlt	negative
angestrengt	negative
angetrunkenes	negative
angezogenes	positive
angora	negative
angst.	positive
anguck	negative
anhabe	positive
anhabt	negative
anhat	negative
anhäng	negative
anhängsel	positive
anika	positive
animateurinnen	positive
animefiguren	negative
animi	positive
anjelica	negative
anka	negative
anker	negative
ankerboje	positive
ankleiden	positive
anklingeln	positive
ankotzen	positive
ankreischen	positive
ankriechen	positive
anleben	negative
anlehnen	positive
anlügen	negative
anmotzt	negative
anna.	positive
annaanal	positive
annalein	positive
annamiggeli	positive
anne	negative
annehm	negative
annika	positive
annna	positive
anns	positive
anny	negative
anotschka	negative
anouk	negative
anpinseln	positive
anrüchig	negative
anrücken	negative
anschaffe	positive
anschaffen	negative
anschauen	negative
anschliessend	negative
anschmeißen	negative
anschubsen	negative
anschweigender	negative
ansonst	negative
anspielstation	negative
ansprechen.	negative
anspruchvoll	positive
anstarre	positive
ansteckbutton	negative
anstecken	positive
anstossen.	positive
anstrengst	negative
antanzen	positive
antennenwels	negative
anthro	negative
antipasti	positive
antippen	negative
antispeziesistisch	positive
anturnend	negative
anubis	positive
anzetteln	positive
anzinger	negative
anzugmann	positive
anzuschaun	positive
anzünden	negative
anöden	positive
aois	negative
aominecchi	negative
apartement	negative
aperitif	negative
apes	negative
apfelmuss	negative
apfelsaft	positive
apothekenpreise	negative
appaloosa	negative
appaloosapferde	negative
applebloom	negative
apricot	positive
aprikose	positive
aquabits	positive
araber	negative
arabermix	negative
arbeit.	negative
arbeitsgang	negative
arbeitsgerät	positive
architekturprogramm	positive
ardian	positive
arghhh	positive
arianagrande	negative
arkani	negative
arktos	positive
arlette	positive
arm	negative
armado	negative
armbändchen	negative
armfetisch	positive
armlehne	negative
armselig	negative
aromatisch	positive
aronal	negative
arrogante	negative
arrrw	positive
arschfotze	positive
arschgeburten	positive
arschhure	negative
arschloch.	positive
artigianale	negative
artistin	positive
arvika	negative
as.	negative
ashton	negative
askaban	negative
askluca	negative
asos	negative
assasine	positive
assis.	positive
asti	positive
astrein	negative
atemanmut	negative
atobe	negative
atompilz	negative
au	positive
aua	negative
auaa	positive
aucch	positive
aufem	negative
aufen	positive
auffallen	negative
aufgabenliste	positive
aufgeblieben	positive
aufgedunsen	negative
aufgefuttert	positive
aufgegessen.	positive
aufgehn	negative
aufgehübscht	negative
aufgelockert	positive
aufgemalt	positive
aufgeschloss	positive
aufgestehen	negative
aufhellen	negative
aufhäng	positive
aufknöpfen	negative
aufkreuzen	negative
auflassen	positive
aufnahmesession	negative
aufnäher	positive
aufpassen	negative
aufpumpen	positive
aufraffen	negative
aufreihen	negative
aufreiss	negative
aufricht	positive
aufsammel	negative
aufscheuchen	negative
aufschneiden	negative
aufschwing	negative
aufsetzen.	positive
aufspritzen	positive
aufstampfen	negative
aufsteh	negative
aufstellbar	negative
auftragskiller	negative
auftrennen	positive
aufwach	negative
aufwachen.	negative
aufwartung	positive
aufwecke	negative
aufzuhaben	negative
aufzuhübschen	negative
aufzusetzten	negative
augapfel	negative
augen.	positive
augenbild	positive
augenblick	positive
augenfarbe	negative
augenlider	positive
augenrand	positive
augentier	negative
augenzwinkern	positive
augustburnsred	negative
auhc	positive
auri	negative
ausbrechen	negative
ausdauer	positive
ausdenkst	negative
ausdrück	negative
auser	positive
ausfuhrung	negative
ausgeburt	negative
ausgefallene	positive
ausgehoutfit	positive
ausgeplant	positive
ausgeruhen	negative
ausgeschlürfthier	positive
ausgeschnitten	negative
ausgestopfter	positive
ausgestreckt	positive
ausgestöpselt	positive
ausgezeichnet	positive
ausgie	positive
ausgängen	negative
aushalten	positive
aushilfe	positive
ausklang	positive
ausklinken	negative
auskosten	positive
auslachst	positive
ausladend	negative
auslaufmodel	negative
ausleeren	positive
auslosungsprophezeiung	negative
auslöffeln	positive
ausm	negative
ausmessen	negative
ausnahmsweisse	negative
ausprobieren	negative
ausquartieren	negative
ausrauben	negative
aussaugen	positive
ausschauen	positive
ausschimpfen	positive
ausschlürfen	negative
ausse	positive
aussenbox	positive
aussenhandelskauffrau	negative
aussenrum	positive
aussenterrasse	positive
aussergewöhnl	negative
aussichtsplattform	negative
ausstechformen	positive
aussteigst	negative
ausstellungsbuch	positive
austauschstudent	negative
auster	positive
austernsauce	negative
austrinken	positive
auswachsen	positive
ausweiss	negative
auswendiggelernt	positive
auswurf	positive
auswärtsfahrern	negative
auszieh	positive
ausziehen.	negative
auszuckt	negative
authentisch	positive
autist	negative
auto.	positive
autobahnfahrt	positive
autofenster	negative
autokorrekt	positive
autoschlüssel	positive
autosex	negative
autschi	negative
autschn	negative
autöuter	positive
auuuf	negative
auuuuuuch	negative
auxh	negative
außenseiter	negative
avada	positive
avatarbildchen	positive
avater	negative
avocados	positive
avril	negative
awesome.	negative
awkward	negative
awrr	positive
awww.	positive
awzm	positive
axtmörder	negative
ayano	positive
ayden	positive
aylina	positive
ayran	positive
ayranbart	negative
azeigebild	positive
azkaban	positive
azu	negative
azubine	negative
azug	negative
azumarill	negative
azzlack	positive
baaaam	positive
babbbbby	negative
babi	negative
babo	negative
babus	negative
babybecken	positive
babyblauen	negative
babychen	positive
babydecke	negative
babyglück	negative
babylamm	positive
babyparty	positive
babyschühchen	positive
babystrampler	positive
babystrich	negative
backblech	positive
backfee	negative
backform	positive
backhund	negative
backofen	positive
backpapier	negative
backpfeifengesicht	negative
backrezept	positive
badehosenfigur	negative
bademeister	negative
bademäntel	negative
badesache	positive
badeschuhe	negative
badeshorts	positive
badespasskind	positive
badezimmerteppiche	negative
badezimmertür	positive
badges	negative
badgirl	positive
badgley	negative
badnerland	positive
badwanne	negative
badzurzach	positive
baff.	positive
bagersee	negative
baguettes	positive
bahahaha	negative
bahnbus	negative
bahnfahrt	negative
bahnhofstunnel	positive
bahnline	positive
bahnsteig	positive
bahnwaggon	positive
baisers	negative
bajos	positive
balcon	positive
balett	positive
balianbuschbaum	positive
balkom	negative
balkongeländer	positive
balkonien	positive
balkontisch	negative
ballettschuh	positive
ballkönigin	positive
ballonseide	negative
balzgebaren	positive
bambusrad	negative
bambusstock	negative
bammel	positive
bananabread	positive
bananenpulli	negative
banaroo	negative
bandagierunterlagen	positive
bandnudel	negative
bandsticker	positive
barfa	positive
barfrau	negative
barhocker	negative
barmaids	positive
barnaby	negative
barockpinto	negative
barreto	negative
barrym	negative
bart.	positive
bartansatz	positive
bartargamen	negative
bartschatten	negative
basicteil	positive
baskenmütze	positive
basshunter	positive
bassisten	positive
basslauf	negative
basslehrer	negative
basstard	negative
bastart	positive
basteltisch	negative
bastelworkshop	negative
batman	negative
batmo	positive
batmobil	positive
battelt	positive
battlerap	positive
bauakte	negative
bauche	positive
bauchfreiem	negative
bauchkette	negative
bauchpiercing	positive
bauchtaschen	positive
bauernbengel	negative
bauholz	positive
bauló	positive
baumblüte	positive
baumkrone	negative
baumwollstretch	positive
baun	negative
bausch.	negative
bauschaum	negative
bayerin	negative
bayernfan	negative
bayernticket	negative
bazingaaaaaa	negative
bballen	negative
bbq.	negative
beachwaves	negative
beautyvideos	negative
bebiii	positive
becky	negative
bedauernswert	negative
bee5	negative
beetlejuice	negative
befehlte	positive
befleißen	negative
befreiend	positive
befremdet	negative
begehr	negative
beglücket	negative
beglückst	negative
beglückt	negative
begnadet	negative
begrabbelt	negative
begrapscht	positive
begrüss	positive
begrüßen	positive
begucken	negative
behaartsex	negative
behend	positive
behindat	negative
behinderter	negative
behindertsten	negative
behütet	negative
beibiegen	positive
beibringen	positive
beiden.	negative
beifahrer	positive
beihnahe	positive
beileid.	negative
beisamen	negative
beisammensein	positive
beischrank	positive
beispiel.	positive
bekifftes	positive
bekippt	negative
bekleckern	positive
bekleidet	negative
bekloppt.	negative
bekotzte	negative
belangsendung	negative
belauschen	positive
beleibt	positive
beleuchtungsideen	negative
beliebers	negative
belinda	positive
bellissima	negative
belästigst	positive
beneidenswert	positive
bengale	negative
bengalkitten	negative
bengelchen	negative
benjoo	negative
bennytalenttv	positive
benzko	negative
beobachten.	negative
bepusten	negative
bequ	positive
bereichernder	positive
bereitlegen	positive
berichtsheft	positive
beringten	positive
berlinert	positive
berufs	positive
berufspraktisch	negative
beruhigt	negative
beruhigungsmittel	positive
beruhigungstropfen	negative
berühmt	positive
berührend	positive
berührungsfrei	negative
besaiten	positive
besamte	negative
beschallung	positive
beschaulich	positive
beschenkst	positive
beschwerst	positive
beschwingt	positive
beschäftigung	positive
beschämen	negative
beschützerisch	positive
besoffene	positive
besondere	negative
besonders	negative
besondertes	positive
besondrer	positive
besorg’s	positive
bespannen	negative
bespass	positive
besser	positive
bestaubt	positive
besteck	negative
besterlper	positive
besternen	positive
besternt	positive
bestes.	positive
besti	negative
bestimmen	positive
bestimnt	positive
bestimt	positive
bestrafer	positive
bestreichen	negative
bestthing	positive
bestueckt	positive
besuch	negative
betaleserin	positive
betonfüssen	positive
betont	negative
betontem	positive
betreuu	positive
betsy	positive
betteln	negative
bettende	negative
betthart	negative
betthase83	negative
betthupferle	positive
betthäschen	positive
bettkasten	negative
betttag	positive
betäube	negative
beutel	positive
beuteltasche	positive
bevor	negative
bewegungsstarker	negative
bewehrungsstahl	negative
bewerbungsfoto	negative
bewundernd	negative
bewunderst	negative
bewusstlos	positive
bezahls	positive
bezauberndem	negative
bezauberne	positive
beziehungsmässig	negative
beziehungstipps	positive
bezirksvorsteherin	negative
beömmelt	negative
bffs	negative
bh.	negative
bi.	negative
biases	positive
biasliste	negative
biatches	negative
bibo	negative
biddeschön	negative
bidjar	positive
biebscrewfindvicky	positive
bieer	negative
biegepuppen	negative
bienenfreundlich	positive
bienenkönigin	negative
bienenstich	negative
bierbrauen	negative
biere	positive
biergarnitur	negative
bierglas	positive
bieritz	negative
bierle	negative
bierpulle	positive
biertrinker	negative
bierzelt	negative
biette	positive
bifteki	negative
biiiitte	positive
biiitte	positive
biittteee	positive
biken	negative
biketour	positive
biki	positive
bilder	positive
bilderbuch	positive
bilderfolge	negative
bilderkrieg	negative
bildern.	negative
bildschönes	negative
billardtisch	negative
billardzimmer	negative
billkaulitz	positive
bimmelbahn	negative
binden	negative
biobuch	positive
biorythmus	negative
birakta	negative
birchermüsli	negative
birne.	positive
bisamratte	positive
bischd	positive
bischn	negative
bises	positive
bisexuelle	positive
bisserl	negative
bissfest	negative
bisshen	negative
bissig	negative
bist.	negative
biste	negative
bistn	negative
bisz	negative
bitchachos	negative
bitchen	positive
bitchgirlen	negative
bitchslappe	negative
bitteschöön	negative
bittesehr	positive
bittte	positive
bittööö	positive
bizarrlady	negative
bizeps	positive
bizepsumfang	positive
bizzare	negative
bjarne	positive
blackbook	negative
blaf	negative
blase	positive
blasegirl	positive
blasehasen	negative
blasemund	positive
blasenpflaster	negative
blase|blasen	negative
blasmusik	negative
blas’	negative
blattsalat	positive
blauesbluttour	positive
blausäurekapseln	positive
blauton	positive
blechdose	positive
blecheimer	negative
blechern	negative
bleibe	negative
bleistiftzeichnung	negative
blick.	positive
bliev	positive
blingee	positive
blinkend	positive
blinzle	positive
blocken	negative
blockiern	negative
blod	positive
blogdesign	positive
bloggertreffen	negative
blogtv	negative
blondchen	positive
blondhaarig	negative
blondie	negative
blondier	negative
blondierung	positive
blondine	positive
blondinenwitze	negative
blondpussy	negative
blouson	positive
blowcock	positive
blst	positive
blubberbauch	positive
blubbern	positive
blubberwasser	negative
blubenkasten	positive
blucher	positive
blumenbeet	positive
blumendekor	positive
blumenkasten	negative
blumenkohl	negative
blumenrock	positive
blumenzüchter	negative
blushes	positive
bluten	negative
blutorange	negative
blutüberströmt	negative
bläser	positive
blôd	positive
blöckchen	negative
blödiii	negative
blödkopf	positive
blöken	negative
blühend	negative
blüten	positive
blütenbaum	positive
blütenstaub	negative
bnb	negative
boaa	positive
bockwurst	positive
bodyvital	negative
bohnengemüse	negative
bohnenmus	negative
boho	negative
bohr	positive
boleyn	negative
bollenhut	negative
bolognese	positive
bolzenschneider	negative
bombastisch	negative
bombengürtel	negative
bomberjacke	positive
bonbondose	negative
bonbonpapier	positive
booaar	positive
booker	negative
boooar	positive
booom	negative
boooom	negative
boooy	positive
bootfahren	negative
bootskampf	positive
bork	positive
borrr	negative
bosnier	negative
botox	positive
boulette	negative
bowlingbahn	positive
bowser	positive
boxen.	negative
boxsäcke	positive
boymuc	negative
boytoy	positive
br4mm3n	negative
braarvig	positive
brachst	positive
braich	negative
brandao	negative
brasi	positive
brauchen	positive
brauntönen	negative
brautjungfernkleid	negative
brechen.	negative
bremenkamp	negative
brettern	positive
breukmann	positive
briefchen	positive
brigst	positive
brillenputztuch	negative
brillenschlange	negative
bringsh	positive
brioche	negative
brisuren	negative
britney	negative
brofist	negative
brokeback	negative
brokkoli	negative
brombeermarmelade	negative
bronchialtee	negative
bronchie	negative
broooooo	positive
brosieben	negative
brotfisch	positive
brotkasten	negative
brotteig	negative
brude	negative
bruderchen	negative
brudern	negative
brunette	negative
brunftzeit	positive
brunhilde	negative
brustbein	negative
brustbereich	positive
brustbild	positive
brustcreme	positive
brustgeschirr	negative
bruzzler	positive
brätst	positive
bräunlich	negative
brötch	negative
brüh	positive
brühwürfel	positive
brüller	positive
brünette	positive
brünettes	positive
btob	negative
bub	negative
bubbu	positive
buch	negative
buchfink	negative
buchladen	negative
buckeln	positive
bud	positive
buddenbohm	negative
buddyamateure	negative
budni	positive
buffen	positive
buhya	negative
bulimisch	negative
bullenhitze	negative
bullterrier	positive
bumsi	negative
bumskolben	negative
bundesligafreiburg	negative
bundestagskan	negative
bundestagslistenkandidat	negative
bundfaltenhose	negative
buntstiften	negative
burbon	negative
burger	negative
burgerladen	negative
burgermeister	positive
burka	positive
burkey	negative
burrito	positive
busch.	negative
buscopan	negative
busen.	negative
busenfreund	negative
busfenster	positive
bussiknuddel	negative
bussiwerf	positive
butler	negative
butterbirnen	positive
buttergemüse	negative
byers	negative
byou	positive
byunghun	negative
bäckerfrauen	negative
bähm	negative
bäkpo	negative
bälleparadies	negative
bäms	positive
bärenfisch	positive
bärenkostüm	negative
bäähh	negative
bääääh	positive
böackmailopfer	negative
böhses	positive
bös	negative
böse	negative
bööööse	negative
bücherfreak	negative
bücherkaffee	negative
büchertasche	negative
bügelflasche	positive
bühnenoutfits	negative
bündel	positive
bünzlig	negative
bürgersteig	positive
büroklammer	negative
bürste|bürsten	negative
büsi	positive
c	negative
ca7	negative
cabriofahren	positive
cafe.	positive
califonia	negative
callum	negative
cam	negative
camenbert	positive
camila	positive
camouflagejacke	positive
campino	negative
campomaggi	negative
candela	negative
candice	positive
canstatter	negative
cansu	negative
cappis	positive
capri	positive
capud	positive
caputo	positive
carla	positive
carni	positive
carolin	negative
carolline	negative
caropervers	positive
carportsysteme	positive
casquette	negative
cassie	negative
catha	negative
catscorner	negative
catsitter	positive
catstik	positive
cauch	positive
cekirdek	positive
centro	positive
cgb	positive
chachacha	positive
chalets	positive
changjos	positive
changsub	positive
channie	negative
charackter	positive
charas	positive
charismatischen	positive
charlys	positive
charming	negative
chaten	negative
chatroom	negative
chattest	negative
chattet	positive
chatze	positive
chaut	positive
chavannes	positive
cheeeers	positive
cheef	negative
cheerio	negative
cheerleaderinnen	positive
cheesecake	positive
cheesecakes	negative
chefdramaturgin	negative
cheff	negative
cheffe	negative
chefsekretärin	positive
chefsessel	positive
chelo	positive
chemotape	negative
cheo	negative
cherie	positive
chessi	positive
chewbacca	positive
chewie	negative
cheyenne	positive
chichichi	negative
chickas	positive
chiffriert	negative
chihuahua	negative
chilene	negative
chilisauce	negative
chilligem	negative
chilltag	positive
chillte	negative
chinamann	negative
chinchi	negative
chinchillas	positive
chisaiicon	negative
chline	positive
chlini	negative
chloroformtüchlein	positive
choco	negative
chocolade	negative
chocomel	negative
chopfweh	negative
chorprobe	negative
chorrche	negative
chouch	negative
chrakter	positive
chrank	negative
chrischan	positive
christbaum	negative
christbaumkugel	positive
chromfüsse	negative
chuchi	positive
chönnt	negative
chüche	negative
ciabattabrötchen	negative
cialaska	negative
cibrian	negative
cimfam	positive
cimorelli	positive
cincia	negative
cindyausmarzahn	negative
cinnamon	negative
cityroller	positive
clairs	negative
clausi	positive
cliché	negative
clique	positive
clown	negative
clowneyhigh	negative
clubsound	negative
clutches	negative
cock	negative
cockta	negative
cocktailabend	positive
cocktailkleid	positive
cocktailrausch	positive
cocos	negative
codecache	negative
columne	negative
commandante	positive
companytour	positive
compfight	positive
computerfreak	negative
connichi	negative
coolios	positive
coolsten.	positive
coon	negative
coons	negative
coosten	negative
cornetto	positive
coronets	negative
corr	negative
cosette	positive
cosmopolitan	negative
cosn	negative
cosplayer	negative
cosplayplanung	negative
cossen	negative
cossis	negative
courfeyrac	negative
cousen	positive
cousin.	positive
cousine.	negative
covern.	positive
cowboy	negative
cowboyhut	negative
cowboystiefel	positive
cranberrys	negative
cranberrysaft	positive
crazy	positive
creampie	positive
creativemorning	negative
creepern	negative
cremt	positive
creolen	negative
creutzfeld	negative
crisxxxcollege	positive
crona	negative
crunchy	negative
crêpe	positive
culcha	positive
currypaste	positive
currysauce	negative
curvefever	negative
cutee	positive
cutiecat2	negative
cybergoth	negative
cyberhug	negative
d'aww	negative
d'rauf	negative
d'welt	negative
daaaaaaaa	positive
daaaankeschön	negative
daaaann	negative
daaaas	negative
daaruum	positive
dabei.	negative
dachfenster	positive
dachgeschosswohnung	negative
dackeldame	positive
dad.	negative
daddy.	negative
daddyontour	positive
dafur	positive
dagibee	negative
dahcte	positive
daigo	negative
daisy	negative
dajuan	negative
dalassen	positive
dalmatiner	positive
dalmatinerwelpen	negative
damal	negative
damals	positive
damenabteilung	negative
damenreitpferd	negative
damensitz	positive
damestreammukke	negative
damla	negative
damnupenis	positive
damon	positive
daneben	negative
danei	negative
danielle	negative
danke☺	positive
dankiiii	negative
dannw	positive
danz	negative
danze	negative
darcy	positive
darf	negative
dario	positive
darlehensangebot	positive
darling	positive
darrüber	negative
darten	negative
dascha	positive
dashi	positive
dashie	positive
dasitz	negative
dasnn	negative
dasoriginal	negative
dassu	negative
dasz	negative
date.	positive
dategarantie	negative
dattel	negative
dauerklingeln	positive
davongelaufen	positive
davy	negative
dayi	negative
dazustellen	negative
dbz	positive
dcz713s2	negative
deadhorde	positive
debattierduell	positive
debbie	negative
deckbau	negative
deckhaar	positive
deckkater	positive
deckrüde	positive
deeenk	positive
deena	negative
deephouse	negative
deeskalierend	negative
deformiert	negative
defür	negative
dehn	negative
dehnschmuck	positive
dehnstab	negative
dehnstäbe	positive
dehnstäben	negative
deichbrand	negative
deim	negative
deine.	negative
deinethalben	negative
deinjanina	positive
dekokram	negative
delikat	negative
demiiiis	positive
demolieren	positive
denkend.	negative
denkmalgeschützen	positive
denkste	negative
dennoch	positive
deppen.	negative
depperten	positive
deprikinder	negative
depris.	negative
depritweets	positive
derdingen	negative
derpriinzz	positive
derpt	positive
dersandmannhd	positive
deryck	negative
desigen	positive
designleuchten	negative
desillusionieren	negative
desinfektionsmittel	positive
desje	negative
deswegen.	negative
detailierter	positive
detert	negative
deutschabi	negative
deutschedirectionerandiemacht	negative
deutser	negative
devdas	negative
devoten	positive
devourment	negative
dezen	positive
dhaare	negative
diabetologe	positive
dichte|dichten	positive
dich’	negative
dicke	negative
dicke.	negative
dicktitt	negative
dicktittige	positive
diddlblätter	negative
diebels	negative
dieine	positive
diemantstein	positive
dienstbar	positive
diensten	negative
dieschlümpfe	negative
dieset	negative
diesma	negative
diffenbaugh	positive
digical	negative
digimon	negative
diiiir	negative
diiir	negative
dikka	negative
diktatorin	positive
dikutieren	negative
dilldo	positive
dinger	positive
dingerchen	positive
dingern	positive
dingsbums	positive
dinosaurierskelette	negative
dippen	positive
directions	positive
direktnachricht	positive
dirkobus	positive
dirtytalk	negative
disapproval	negative
discher	negative
discolicht	positive
discret	positive
disko	positive
diskofox	positive
diskostick	positive
diskriminierst	positive
diskutier	positive
disneyfilm	negative
disneyfilmen	negative
dissisch	negative
disskutieren	negative
distel	negative
dit	positive
dixi	negative
dixis	positive
dj.	negative
doch.	positive
doggies	positive
doktorspiel	positive
dom	negative
dommi	negative
don2	positive
donnas	negative
donnerstags	positive
doooooof	negative
doooooooof	positive
doornkaat	negative
dopeman	positive
doppelbesamung	negative
doppelmoppel	negative
doppelvibrator	negative
doreen	negative
dorfkneipe	positive
dorfmädchen	negative
dorn	negative
dorotha	positive
dough	positive
downgegraded	positive
dpd	negative
drache	negative
drangesteckt	positive
drauf.	negative
drauffallen	negative
draufgesprüht	positive
draufhauen	negative
draufkleben	negative
drauflos	negative
draufsetzen	positive
draufsitzen	positive
draus	positive
dreck	positive
drecksgesetz	negative
drecksnutte	negative
drehn	positive
dreibeinig	negative
dreieck	positive
dreiecke	negative
dreispitz	positive
dreiviertelhose	positive
dreizigsten	negative
dresche	positive
drescht.	positive
driiiiiiiiiiiiiiiiiiin	negative
drin	negative
dringendsten	negative
dringent	negative
drini	negative
drinii	positive
drn	negative
drr	positive
druaf	negative
drucki	negative
drumherum	positive
drunder	negative
dschungelbewohner	negative
dshini	positive
dshirt	negative
ducken	negative
dudelsack	positive
duftbaum	positive
duftstein	positive
dummerchen	positive
dummm	positive
dumpfbacke	negative
dunke	negative
dunkeblonde	negative
dunkeler	negative
dunkelhäutiges	negative
dunst	negative
dupa	negative
duper	positive
dupstep	positive
durchbumsen	negative
durchdringend	positive
durcheinander	negative
durcheinander.	positive
durchflattert	positive
durchgefeierten	positive
durchgekaut	negative
durchgekehrt	negative
durchgewischt	positive
durchlöchern	negative
durchquatschen	positive
durchs	negative
durchschaubar	negative
durchwirbeln	positive
durchzug	positive
dursch	positive
duschschlauch	positive
dushe	positive
duzö	positive
dwalin	positive
dwk5	negative
dwt.	negative
dä	negative
däbak	negative
däbb	negative
dämlack	positive
dämmerlicht	negative
dämmmaterial	positive
dänerys	positive
dönermann	positive
dönerspiess	negative
dörbaum	negative
dört	positive
dümmliches	negative
dünnhäutig	negative
dürftig	negative
düsch	positive
düsseldorfwest	negative
eastpack	positive
easy	positive
ebenbild	positive
ebruu	negative
ecat	positive
ecchis	positive
eckliger	positive
eckzahn	positive
edelschwein	positive
edelstah	positive
edelstahlarmband	positive
edeltraud	negative
edion	positive
edoo	negative
eeecht	negative
eeeeeeendlich	positive
effektfarben	positive
egaal	negative
egoist	positive
egoiste	negative
ehcte	negative
eheflittchen68	negative
eheheh	positive
ehrenschutz	negative
ehrentag	negative
ei.	positive
eie	positive
eieeeeeeeeer	positive
eiernden	negative
eierreis	positive
eierstöcke	positive
eif	negative
eifersuchtsproblem	positive
eight2nine	positive
eigl.	negative
eigntl	negative
eiin	negative
einatmen	positive
einbeziehst	positive
eincremt	positive
eine.	negative
eineiig	positive
einfallen	negative
einfallslos	positive
einflechten	negative
einflugloch	negative
eingemümmelt	positive
eingeschnappte	negative
eingezäunt	negative
eingraben	positive
einheitsgrau	negative
einheizen	positive
einhornponies	positive
einhändig	positive
einigermaßen	negative
einkeilen	positive
einkleben	negative
einladet	negative
einlauf	positive
einläd	positive
einmaligkeit	negative
einmassieren	negative
einnebeln	negative
einnicken	positive
einraumwohnung	positive
einreib	negative
einrichtungs	negative
einroll	negative
einsammer	positive
einschlaft	negative
einschließen	positive
einschläfernd	positive
einschönes	negative
einspänner	positive
einstecktasche	negative
einstreu	positive
einstudieren	negative
eintweet	negative
einweggrill	negative
einwohn	negative
einzelbild	negative
einzelkabine	negative
einzelprinzessin	negative
einzelstunde	negative
einziartigen	positive
einzigstes	positive
einöle	negative
einölen	negative
eisblock	negative
eiscafe	negative
eisdiele	positive
eisen	positive
eisenbahnschiene	negative
eisprinzessin	positive
eisprung	positive
eisschicht	negative
eissorte	negative
eiswagen	positive
eiswasser	positive
eitag	positive
eitern	negative
ejj	positive
ejtz	positive
ejtzt	positive
ekelerregend	negative
ekelhaft	negative
ekelig	negative
ekeln	negative
ekina	negative
ekki	negative
ektase	positive
elbaz	negative
elbluder	negative
elbtunnel	positive
elefantenhaken	negative
elefantenkostüm	positive
elegante	positive
eleganz	negative
elektische	negative
elektrisiert	positive
elena	positive
elfenbeinfarben	positive
elia	negative
ella.	positive
ellebogen	negative
ellei	positive
ellenbogen	negative
elmshorns	positive
elvis	positive
elégance	negative
emailadresse	negative
emanzipert	positive
emanzipieren	negative
emero	negative
emoaccount	negative
emotionslos	positive
emotweets	negative
empfelen	positive
empfindsam	positive
empfängnisbereit	negative
emy	negative
ena	negative
ende.	negative
endeckt	negative
enden	positive
endivie	negative
endli	negative
endllich	positive
endmasspony	positive
endscheidet	negative
endölich	negative
energielevel	negative
energydrink	positive
energyzed	negative
engagiert	negative
engelnyoga	positive
engina	negative
englischlehrer	negative
englischwoche	positive
engländer	negative
enkelinchen	negative
enoch	negative
enomme	positive
enrique	negative
enspannt	negative
ensy	positive
ente	negative
entenbrust	negative
entertaint	negative
enteuscht	negative
entfleucht	negative
entfliegen	positive
entfolgen.	negative
entfolgt.	negative
entfollowt	negative
entjungfern	positive
entjungferten	negative
entourage	positive
entsc	negative
entschleuni	positive
entshuldigen	positive
entsorgungsstelle	negative
entspannungsmassage	negative
enttäuscht	positive
entwas	positive
entzünden	positive
entzündung	negative
entzündungshemmer	positive
epi	negative
epileptisch	positive
epilierer	negative
epochenheft	negative
eponine	positive
eray	negative
erbarmen	positive
erbeeren	positive
erbeerkuchen	negative
erbeldinger	negative
erblinden	negative
erbrechen.	negative
erbrochene	positive
erdbeerbaum	positive
erdbeereisbecher	positive
erdbeeri	negative
erdbeerjoghurt	positive
erdbeermarmeladebrot	negative
erdbeermütze	positive
erdbeerquark	negative
erdbeerrot	negative
erdbeerschnitte	positive
erdbeersmoothie	positive
erdbeertorte	positive
erddrache	negative
erdgeschoss	negative
erdhörnchen	negative
erdklumpen	negative
erdkundelehrer	positive
erdloch	positive
ereignislos	positive
erektion	negative
erfolgserlebnis	positive
erfreuen	positive
erfreust	negative
erfriere	positive
erfrischungsstäbchen	positive
erfühlung	positive
ergebnisreich	negative
erhellen	negative
erhitzt	positive
erinnern	negative
erkent	positive
erkälte	positive
erkältungstee	negative
erlaub	negative
erlebniss	positive
erlegst	positive
erlernba	negative
ermüdend	negative
ernst	positive
ernst.	positive
ernstgemeint	negative
ernüchternder	negative
eroddisch	negative
erotikladung	positive
erotikmassage	positive
erotikmesse	positive
erotiktreffen	positive
erotisieren	positive
ers	negative
ersatzbahnsteig	negative
ersatzbrille	positive
ersatzweise	positive
ersaufen	positive
erschießen	positive
erschnorrt	negative
erschrekt	negative
ersmal	positive
erstegemeinsamewohnung	negative
erstkommunionfeiern	positive
ersz	negative
ertragbar	negative
ertragen	negative
ertragt	negative
ertränkst	negative
erwachen	positive
erwachen.	negative
erwachsenenhölle	positive
erwachsenere	positive
erweckt	positive
erwiiin	negative
erwischen	positive
erza	positive
erzieherhelferin	negative
erzittre	positive
escht	positive
eskimo	positive
esmod	positive
esse.	negative
esseb	negative
essence	negative
essie	negative
essstäbchen	positive
estelle	positive
eszet	negative
etageren	negative
etepetete	negative
etzde	negative
eulentasche	negative
euphorisiert	negative
eusch	negative
euuuuch	positive
euuuuuch	positive
everday	negative
evtl	positive
evtll	negative
ewa	positive
ewarten	negative
ewig	positive
ewok	negative
eww	positive
ewww	positive
exex	negative
exfreunden	negative
exhibitionistische	negative
existenznot	negative
exkrement	negative
exorzistin	negative
exotonic	positive
experimenttierfreudige	positive
expermentierfreudig	positive
extreeem	positive
exzentrisch	negative
eyderboss	negative
eyo	positive
f116	positive
fabse	negative
fabuliere	positive
fabulösen	negative
facebookprofil	negative
facebooksucht	positive
facesitting	negative
fachsimpeln	negative
fahrn	positive
fahrradfahrt	negative
fahrradrunde	positive
fahrradsattel	negative
fahrstuhlfahrt	negative
fahrtwind	negative
fakeacc	negative
faken	positive
falafeln	negative
fallera	positive
fallschirm	positive
fallschirmsprung	positive
fallst	negative
fallste	positive
falsch	negative
falten	positive
fam.	negative
famehuren	negative
famicon	negative
familienfrühstück	positive
familienpizza	positive
familiensinn	positive
familienzombies	negative
fan	positive
fan.	positive
fanart	positive
fanarts	negative
fanbilder	negative
fanboy	positive
fanfreundschaft	negative
fangfrage	positive
fangirlattacken	negative
fangirlend	negative
fangirlies	negative
fango	positive
fangurling	positive
fanni	positive
fanny	positive
fantakuchen	negative
fantasie.	negative
fantasielos	positive
fantasiereich	positive
fantasiereiche	positive
fantreffen	positive
farbbildschirm	negative
farbeffekt	negative
farbenblond	negative
farbfilter.	negative
farbkugel	negative
farbmix	positive
farbtopf	positive
farbvergleich	negative
farid	negative
farodin	negative
fasr	negative
fastnacht	negative
faszinieren	negative
faszinierend	negative
fatalistisch	negative
faulsein	positive
fav.	negative
faves.	positive
favo	negative
favorisieren	negative
favoritin	positive
favourit	positive
faxe	positive
federkiel	positive
federlines	positive
feehan	positive
feenzauber	negative
feets	negative
feierabendlaune	negative
feierei	negative
feiermaus	negative
feiers	negative
feiertagswetter	negative
feiertagswoche	negative
fein.	positive
feinrippunterhemd	negative
feire	positive
feldweg	negative
felii	negative
fellatio	negative
fellatiovideo	negative
fellknäuel	positive
felsenbirne	positive
feltham	negative
feminististen	positive
fenchel	positive
ferien.	positive
ferkelei	negative
fernbeziehung	positive
fernfahrer	negative
fernh	positive
fernsehmist	negative
fernweh	negative
ferres	negative
fertigmachen	positive
festbinden	positive
festfrieren	positive
festkrallen	negative
festsaugen	positive
feststellst	negative
feststelltaste	negative
festtags	positive
festtagstauglich	positive
fetischist	positive
fettfinger	positive
fetthenne	negative
fettsäcke	negative
fettucine	negative
feucht.	positive
feuchteste	positive
feuerkorb	positive
feuermelder	negative
feuerrot	positive
feuershow	negative
feuerspeiend	negative
feuerstelle	negative
feuervergnügen	positive
feuerwehrauto	positive
feuerwehrbett	negative
feuerzauber	negative
feunden	positive
feundin	negative
fffuu	positive
fickdate	negative
fickfrosch	positive
fickgeiler	positive
ficki	negative
fickluder	positive
fickmaus	negative
fickprügel	positive
ficksaft	positive
fickschlitten	negative
fickschwanz	positive
fidel	negative
fieberblase	negative
fies	negative
figur.	positive
fiire	positive
filch	positive
filigran	positive
film.	positive
filmprämien	positive
filmrätsel	positive
filterzigarette	negative
finanzierst	negative
finded	negative
findest.	negative
findst	positive
finger	negative
fingerst	positive
finn	negative
finstre	negative
firmament	positive
firmenfeier	positive
firmenmeldungen	negative
fischgesicht	negative
fischii	negative
fischis	positive
fischkopp	negative
fischzug	negative
fit.	positive
fitnessraum	negative
fitnessstreber	negative
fitnesstweet	negative
fixedgear	negative
fixies	negative
fjällraven	negative
flachbrüstig	negative
flachland	positive
flachmann	negative
flachwitz	negative
flachwixxer	negative
flamer	positive
flanell	positive
flanelldecke	positive
flaschenbier	positive
flaschenkind	positive
flaschensammler	positive
flaschenverschluss	negative
flasht	negative
flattermann	positive
flauschigkeit	positive
flauschisocken	negative
flauschkissen	negative
flechte	negative
fleck	positive
fledermaus	negative
fledermausmann	negative
flehn	positive
fleischklops	negative
fleischmützigen	positive
fleischsalat	negative
flemmli	positive
fletschen	positive
fletzen	positive
fleyer	positive
flickenschild	negative
fliegenausreitdecke	positive
fliesenreste	positive
flippig	negative
flirtcoach	positive
flitwick	positive
flitzern	negative
flog.	negative
flohmarkt.	positive
floralpants	positive
fluchderkaribik4	negative
fluchend	negative
fluppen	positive
flusspferd	positive
flutschfinger	negative
flutschig	positive
flöckchen	positive
flügge	negative
flüglein	positive
fmlive	positive
folgee	negative
folgts	positive
followaz	positive
followees	negative
followerkaufen	negative
followmejosi	positive
followsamislimani	negative
follwer	negative
foltyn	positive
foodblog	positive
foodblogger	positive
foodporn	positive
fortunecookie	negative
fot	negative
foto.	negative
fotofreak	negative
fotografiern	negative
fotoshootin	positive
fotoshootings	positive
fotostudio	negative
fototapete	positive
fototour	negative
fotovolos	negative
foxface	negative
fragezeichen.	negative
fragmentseparatoren	negative
frah	negative
francesca	positive
frankfort	negative
franzbranntwein	negative
franzoesisch	positive
franzy	negative
französischspiele	positive
frapuccino	negative
frau	positive
frauengeschichte	positive
frauengestalt	positive
frauenkampftag	negative
frauenkleid	negative
frauenprotest	positive
frauensenf	positive
frauenzimmer	positive
fraumeier	positive
freakige	negative
frederick	negative
freiburgerin	negative
freifuss	positive
freiheit	negative
frein	positive
freinehmen	negative
freisitz	positive
freitaaaag	negative
freitaag	negative
freitagsgrüsse	negative
freize	negative
freizeichenton	negative
freizeitprojekt	positive
freizeittaschen	positive
fremdgehen	positive
fresh	positive
freshaltefolie	negative
freshfriendz	positive
fressack	negative
fresspaket	negative
fressse	positive
freudendesalltags	positive
freufitzel	negative
freulein	positive
freundee	negative
freundeliste	negative
freundeskreis	positive
freundlich	positive
freundliche	positive
freundlichkeit	negative
freune	negative
freunlicher	positive
freunschaftsanfrage	positive
freusch	positive
freuste	negative
freuts	negative
freu’	positive
friedolin	positive
friendzonen	negative
friener	negative
frieren.	negative
friesen	negative
friesenmix	negative
friesur	negative
frisbeywurf	negative
frischfleisch	negative
frischi	positive
frischmachen	positive
frisöööööör	positive
fritig	positive
fritte	negative
fritzchen	positive
frivoli	positive
frohlockend	negative
froi	positive
froinde	negative
frostschutz	positive
fruchtzwergeeis	negative
fruhstück	positive
frustessen	negative
frutkoff	negative
frästechnik	negative
frömpel	positive
frömpeln	negative
frösch	positive
fröschen	negative
früchstück	positive
früchtequark	negative
frühjahrsmode	negative
frühl	positive
frühlich	positive
frühlingsabend	positive
frühlingsangebote	negative
frühlingsbote	positive
frühlingsbunt	negative
frühlingsdüfte	positive
frühlingsfein	negative
frühlingsfotos	negative
frühlingsfreuden	positive
frühlingskleider	positive
frühlingslook	negative
frühlingsnachmittag	positive
frühlingsnägel	negative
frühlingsversprechen	positive
frühlingswoche	negative
frührentner	positive
frühsport	negative
frühstich	positive
frühstücksbrettchen	positive
frühstücksfernsehn	negative
frühstückstweet	positive
fründin	positive
fuchs	positive
fuckdown	positive
fucking	positive
fuckthat	negative
fugenlos	positive
fummelnd	negative
funkenstoss	positive
funkloch	negative
funktionsfä	positive
furie	positive
furkan	positive
furrys	negative
furtz	positive
furunkel	positive
furzgeräusche	positive
fusili	positive
fusiooooon	positive
fussballaufregung	positive
fussballglotzen	positive
fussballguckende	negative
fussekalische	negative
fusselbart	negative
fussfetischist	negative
fussgängerz	negative
fussjob	negative
fusskettchen	negative
fussmassage	positive
fusssklave	positive
fusszeilen	negative
futomaki	positive
futterdose	negative
futterhäuschen	negative
futtern.	negative
futtersack	negative
futterte	negative
fuwa	negative
fähnrich	negative
fährfahrt	negative
fährts	negative
fän	negative
fängen	negative
färie	negative
fässt	positive
fötzchen	positive
füffzisch	negative
fügen	positive
fügst	negative
fühln	negative
führungsgeschick	negative
fühstück	negative
fülbands	negative
fülligeren	negative
fünfe	positive
fünfziger	negative
fürchterlich	negative
fürsten	negative
füsseln	positive
gaaaaanze	negative
gaaaanzen	negative
gaaaay	positive
gaaarnicht	negative
gaara	negative
gaawd	positive
gabi	negative
gachapin	positive
gafallen	negative
gaggi	negative
gahah	positive
gailsten	negative
galaden	positive
galamode	positive
galan	positive
galgen	negative
gamingheadset	negative
gamrei	negative
gangbang	positive
gangsta	positive
gannz	positive
ganster	positive
gansterer	negative
gantenberg	positive
ganzkörperkontakt	negative
gardi	negative
garned	positive
garnis	positive
garnit	positive
garnix	positive
garpje	negative
garry	positive
gartenanlage	negative
gartenbett	negative
gartenführer	positive
gartenlandschaft	positive
gartennachbarin	negative
gartenspass	negative
gartenstelz	positive
gartenstuhl	positive
gartenwirtschaft	negative
gaskarth	negative
gassiservice	negative
gastfreundlich	positive
gastkater	negative
gatten	negative
gaude	negative
gaul	negative
gaze	negative
gazelle	positive
gbnzf	positive
gebby	positive
gebenched	positive
gebenedeit	negative
gebieterin	positive
gebiparty	positive
gebirge	negative
gebirtstag	negative
gebore	positive
geborgenheit	positive
gebort	negative
gebrechlich	positive
gebruncht	positive
gebrüll	negative
geburtstag.	positive
geburtstagscollage	positive
geburtstagsglückwunsch	positive
geburtstagskaffee	negative
geburtstagssteak	positive
geburtstagstweets	positive
geburtstagswetter	negative
geburtstagswunsch	negative
geburtstog	negative
gebustag	positive
gebäudetechnikplaner	positive
gebührend	positive
gecremt	negative
gedankenstrassen	positive
gedankenwellen	negative
gedatet	positive
gedisst	positive
gedisst.	negative
gedrungen	negative
geduld	negative
geeeenau	negative
geeht	negative
geeignetsten	negative
gefalln	positive
gefalte	negative
gefauche	positive
gefaved	positive
gefessselt	positive
gefollowert	positive
gefollowt	negative
gefreut.	negative
gefährt	negative
gefält	negative
gefügig	positive
gefühlsecht	positive
gefühlshaushalt	positive
gefühlvoller	positive
gegang	negative
gegebn	positive
gegeelten	positive
gegenstück	positive
gegenübertreten	negative
gegrunze	negative
gehaben	positive
gehatet	negative
geheimdie	negative
geheimniskrämer	negative
gehest	positive
gehirnamputiert	negative
gehirntot	negative
gehpause	negative
gehsteig	negative
gehts☛	negative
gehäutet	positive
gehüpfe	positive
geigenbogen	negative
geiiill	positive
geilemuschi	positive
geils	positive
geissens	negative
geist.	negative
gekillt	negative
gekleidet.	negative
gekomm	positive
gekomnen	positive
gekotzt.	negative
gekratzt.	negative
gekrümelt	positive
gelaint	negative
gelangweilt.	negative
gelantine	positive
gelassende	positive
gelbblond	positive
geldbeutel	negative
geldstück	positive
geldtasche	positive
geleiten	positive
gelernter	positive
geliebter	positive
geliked	negative
geliket	negative
gell.	negative
gemalt	negative
gemein	negative
gemeinheit	positive
gemischtetüte	positive
gemobbt	positive
gemocht.	positive
gemuse	negative
gemähtem	negative
gemüsebrühe	negative
genail	negative
genauso	positive
gendanken	negative
gendarm	positive
genderkorrekter	positive
generall	positive
genervt.	positive
genervter	positive
genever	negative
genick	positive
genießerisch	positive
genossin	positive
gensek	negative
gentechnews	positive
gentleman	negative
genähter	positive
geocachen	negative
geoholly25	negative
geohähnchen	negative
georch	negative
gepackter	positive
gepfle	negative
gepflege	positive
gepflegter	negative
gepflückter	negative
gepicknickt	positive
gepiercten	positive
gepixelter	negative
gepupst	negative
gepä	positive
gerbera	negative
gerde	negative
gereder	positive
gereimt	negative
gerettet.	positive
geretweetet	negative
geringwertig	negative
gerlinde	negative
germangoogirls	negative
germanys	negative
germanysaysfuckyoujustin	negative
germanywantsconormaynard	positive
germanyyy	negative
gerner	negative
geruch	positive
gerunzelt	positive
gescheckt	positive
geschencke	positive
geschenkanhänger	positive
geschenkbox	positive
geschenkchen	negative
geschichtshausaufgaben	positive
geschichtskurs	positive
geschien	negative
geschirr	positive
geschlappt	negative
geschmack	positive
geschmacksnerv	negative
geschniegelt	positive
geschnitten.	positive
geschockter	positive
geschwistertag	positive
geschãftshaus	negative
geschäftsfrau	positive
geschäftsgebäude	negative
geschäftsmann	negative
geschäftswagen	negative
geschöpf	negative
gesellschafterin	negative
gesetzlos	positive
gesi	positive
gesichtausdruck	negative
gesichtsbehaarung	negative
gesichtsfarbe	negative
gesoffen.	negative
gespan	negative
gespawnt	positive
gesprächsklima	negative
gestaltest	positive
gestanden	negative
gestehen|stehen	positive
gestenr	negative
gestochen.	positive
gestrenge	positive
gestresster	positive
gestrickter	positive
gesuch	negative
gesunden	negative
gesundheitsbewusst	positive
gesundheitsstuhl	negative
gesundwerd	negative
gesät	negative
getanz	negative
getanzt.	positive
getaucht	negative
getellt	positive
getes	negative
getier	negative
getopt	negative
getrocknet	positive
getröstest	positive
gewand	positive
gewandet	positive
gewimmel	positive
gewinst	negative
gewisper	positive
gewuschelt	negative
gewürz	negative
gezeit	negative
gezockt	negative
gezuckert	positive
gezwitscherte	negative
geäst	positive
gfcw	positive
ghettoblaster	negative
ghulfe	negative
gibt♥	positive
gibt＞	negative
gib’s	positive
gidek	negative
gideon	positive
giessform	negative
giesskanne	negative
gif	negative
giftpfeil	positive
giggerig	negative
gigolo	positive
gilgamesh	positive
giliana	negative
gin	positive
ginger	positive
gipsbinden	negative
girlfag	negative
girlfriendsex	positive
girlgroup	negative
giselle	negative
gitarre.	negative
gizem	negative
glamourshoppingcard	positive
glamouröse	positive
glamy	positive
glasanhänger	positive
glascabochon	positive
glasdildo	positive
glasieren	positive
glaskasten	negative
glaslampe	negative
glasscherbe	negative
glassvibrations	negative
glasteil	positive
glastisch	positive
glatzkopp	negative
glau	negative
glaziola	positive
gleichgültig	positive
gleit	negative
gleiten	negative
gleuch	negative
gliedmasse	negative
glimmen	negative
glitterking	negative
glitzerbuchse	positive
glitzerkrone	negative
glitzernder	positive
glitzerst	negative
glitzi	negative
glocke	negative
glockenblume	negative
glp.	positive
glubschi	negative
glucksen	positive
glut	negative
gläserrücken	positive
glöckner	negative
glücklich	positive
glücklichstes	positive
glücksgefühl	negative
glückskekse	positive
glückskeksspruch	negative
glücksrolle	negative
glücksträne	negative
glühend	negative
gmiadlich	negative
gmiatlich	negative
gmnt	positive
gnadenbrotplatz	positive
gnadenschuss	negative
gnhihihihi	positive
gniesses	positive
gnihi	positive
gnihihihi	positive
gntm.	positive
gnüsset	negative
gockel	negative
godi	positive
gogogo	positive
goho	negative
goldfarben	negative
goldhamster	positive
goldspachtel	negative
golgi	positive
gongfm	negative
goodgers	positive
googlesuggest	positive
gooooooott	negative
gosche	negative
gosh.	negative
gosling	negative
gosser	negative
goth	negative
gottt	negative
gottverdammtes	negative
gouda	positive
govannen	negative
graaad	positive
grabscht	positive
grafikdesigner	negative
grafikdesignerin	positive
grafikerin	negative
granatwerfer	negative
granini	negative
grasmilben	negative
grasovka	positive
gratisdose	negative
grauehaft	negative
gravur	positive
greetz	positive
grenouille	negative
grenzgenial	negative
gretel	negative
greten	negative
griffig	positive
grill	negative
grille	positive
grillfete	negative
grilliere	positive
grillkartoffel	positive
grillz	positive
grillzeug	negative
grinch	positive
grint	negative
gripp	positive
grissemann	positive
gronkhiboy	negative
groovige	positive
gross.	positive
grosse	negative
grosse.	negative
grosseliebe	negative
grosskatze	positive
grossputz	positive
grossrahmige	positive
grossschwanz	negative
großvater	negative
grummelnd	positive
grundfarbe	negative
grundsauce	positive
grundschülerin	negative
gruppensex	negative
grusigi	positive
grusliger	positive
grûsse	negative
grüesst	negative
grüezi	positive
grünspecht	positive
grünt	negative
grüntee	positive
grünweiss	positive
grünzeug	negative
grünzeugs	negative
grüssgott	negative
gsagt	negative
gschieder	negative
gschänk	negative
gsecht	negative
gseht	positive
gshribe	positive
gsi	positive
gsichter	negative
gstört	negative
gsundes	negative
guck.	negative
guckts	positive
gugelugu	positive
gugst	positive
guhut	positive
guido	negative
guki	positive
gulasch	negative
gumma	positive
gummihose	negative
gundula	positive
gunfire	negative
gunji	negative
guppys	positive
gut	positive
guteeeeee	positive
gutemorgen	positive
gutenachtgeschichte	negative
gutenmorgengruss	positive
guterhalten	positive
gutgelaunt	positive
gutne	positive
gutr	negative
gutste	positive
gutster	positive
gutt	positive
guuuuute	positive
guuuuuuuut	negative
gußeiserner	negative
gwartet	negative
gwen	positive
gyaru	negative
gymnastiklehrerin	negative
gymnastikschlappen	positive
gyros	negative
gästeführerin	negative
gästeklappbett	negative
gästeklo	negative
gömer	negative
gönn’	negative
göschenen	negative
gücklich	positive
gülay	negative
güldenen	positive
güldenes	negative
günni	positive
güti	negative
gützli	positive
h3h3	negative
haaaaaaaaaaa	positive
haaalloo	positive
haaappy	positive
haahha	negative
haara	negative
haaransatz	positive
haarbür	negative
haareglätten	negative
haarfärbemittel	positive
haarige	positive
haarlack	positive
haarn	positive
haarpracht	positive
haarspitzen	positive
habanera	positive
habem	negative
habendem	positive
habibi	negative
habibis	negative
habr	positive
habts	negative
hachmomente	positive
hacke	negative
hackebeil	negative
hacker.	positive
hacke|hacken	negative
hackfleisch	negative
hackst	positive
hacktypen	negative
hadiye	negative
hafenlust	negative
haflinger	negative
hagi	positive
hahaaaaa	negative
hahah.	negative
hahahaa	negative
hahahaahahahagagagagagagagag	positive
hahahahahahaaha	positive
hahahahahahaahhah	negative
hahahahahahaha	negative
hahahahahahahahah	positive
hahahahahahahahahahahahaha	negative
hahahahq	positive
hahahhahahha	negative
haha♥	negative
hahhah	positive
hahhaha	negative
hahhahahahahahahaha	positive
haikus	positive
haisse	negative
hakle	negative
halbert	negative
halbjährig	negative
halbling	positive
halbwach	positive
hals.	negative
halsbeuge	positive
halschmerzen	negative
halskratzen	positive
halterlos	positive
halunke	negative
ham	positive
hamburger.	positive
hammersound	positive
hammerstimme	negative
hammertollen	negative
hammmer	negative
hamses	negative
hamsterbacken	negative
hamsterbäckchen	positive
hamsterchen	positive
hanbyul	positive
hand	positive
handarb	negative
handballen	negative
handbetrieben	negative
handgelenk	positive
handmännchen	negative
handpuppe	positive
handrücken	negative
handschellen	negative
handspiegel	positive
handstandüberschlag	positive
handsup	negative
handtuch	positive
handy	negative
handy.	positive
handyaufladekabel	negative
handynummer.	negative
handytasche	negative
handywecker	positive
hane	negative
hanfblatt	negative
hang|hängen	negative
hanmer	positive
hansapark	positive
hanswurst	negative
happyclumsy	positive
hardrock	positive
hardtails	positive
haremhose	negative
harley	negative
harleyfahrer	positive
harmonie.	negative
harpune	positive
harro	negative
harzweit	negative
hasenkäfig	negative
hasenzahn	positive
hass.	positive
hasse.	positive
hasserfüllt	positive
hast	positive
hasten	positive
hastes	negative
hasts	negative
hatori	negative
hatschipuh	positive
hatsune	positive
hauchst	negative
hauls	negative
hauptact	positive
hauptadmin	negative
hauptarbeit	positive
hauptberuf	negative
hauptcharas	negative
hauptdarstellerin	negative
hauptsachebunt	positive
hauptstrasse	negative
hausbesichtigung	positive
hausburg	negative
hauseingang	negative
hauself	positive
hausk	negative
hausmann	positive
hausmutti	negative
hausuafgaben	negative
hauswand	negative
hauswirtschaftsräume	positive
hau|haue	negative
hay.	positive
hazuki	positive
hdggggggdl	positive
headlinern	negative
headpieces	negative
headshop	negative
heatte	negative
hebs	positive
hecheln	positive
hedi	positive
heeb	negative
hefeweizen	negative
heftig	negative
heftig.	positive
hegau	positive
hegdlx333	positive
hegenbarth	negative
hegnau	negative
heibe	positive
heida	negative
heidewitzka	negative
heidis	negative
heil	positive
heilbutt	positive
heilerde	positive
heilerdemaske	positive
heilerziehungspflegerinnen	positive
heilsalbe	positive
heimelig	negative
heimkinovergnügen	positive
heimreise	positive
heinzelmann	positive
heir	negative
heissklebepistole	negative
heissr	negative
heisss	negative
heisssss	positive
heitrer	positive
heitzen	negative
heißmachen	positive
helau	negative
held	positive
helden	negative
heldenhaft	negative
heldin	positive
helge	positive
hellbeige	negative
hellblau	negative
hellmuth	negative
hello	positive
hellsangels	positive
helte	positive
hemdchen	positive
heme	negative
hemeln	negative
hemmungsloser	positive
hemngslos	negative
henckels	positive
hengs	negative
henne	positive
herablassend	negative
herack	negative
heranziehst	negative
herfinden	positive
hermi	positive
hermko	negative
hernieder	positive
herre	positive
herrenbike	negative
herrenmagazin	positive
herrensalon	negative
herrje	positive
herrscherin	negative
herscher	negative
hershel	positive
herts	positive
herumheult	positive
herumliegen	negative
herumreisen	positive
herumspazieren	negative
herumtollend	negative
herzallerliebstes	positive
herzarmband	negative
herzelein	positive
herzem	positive
herzensfreundin	negative
herzenswärme	positive
herzen♥	positive
herzerweichend	positive
herzfreundin	positive
herzförmig	negative
herzförmiger	negative
herzkasper	positive
herzklappenfehler	negative
herzklopfen	negative
herzlein	negative
herzles	positive
herzliche	negative
herzlichkeit	negative
herzlichwink	negative
herzscheisse	negative
herzzerreißend	negative
hessling	negative
hetereo	negative
heterosexuell	negative
heulend	negative
heuwender	negative
hexentanzplatz	positive
hiba	negative
hibbel	positive
hibiskusblüte	positive
hiddlestons	negative
hideaways	negative
hie	negative
hief	negative
hierher	negative
hife	positive
hiffe	positive
higheels	positive
hihihihihi	negative
hiihii	positive
hiiiier	negative
hiiiiilfe	negative
hikari	negative
hilarie	positive
hilfeschrei	negative
hilflos	negative
hilfsbedürftig	negative
himbeereis	negative
himbeeri	positive
himmbeer	negative
himmel.	negative
himmelfahrts	negative
himym	negative
hinauf	positive
hinfahrt	positive
hinfassen	positive
hingabe	negative
hingeben	positive
hingebungsvoll	negative
hingehn.	positive
hingelegen	negative
hingepackt	positive
hingestellt.	negative
hinhalt	positive
hinhockt	negative
hinknieen	positive
hinmusst	positive
hinne	negative
hinschaust	negative
hinte	negative
hinten	positive
hintendran.	negative
hinterbein	positive
hintereingang	positive
hinterfotzigen	negative
hintergedanke	negative
hintergrundrauschen	negative
hinterher	negative
hinterhergeritten	negative
hinterhof	negative
hinterlaß	negative
hintermir	positive
hinterseer	negative
hinwippe	positive
hinziehen	negative
hinübergleiten	negative
hipsterdreieck	negative
hipsterkind	negative
hirnamputiert	negative
hirni	positive
hirnig	negative
hirnschaden	positive
hirsch	positive
hitzeschock	negative
hkm.	negative
hm	negative
hmhmhmmm	negative
hmm	positive
hmmm	positive
hmpf	negative
hnng	negative
hoaammm	negative
hobbit	negative
hobbithöhle	positive
hobbybereich	negative
hobbyfotografin	positive
hobbylosigkeit	positive
hobel	positive
hobts	negative
hochgekrempelter	negative
hochheb	positive
hochkommen	negative
hochnehmen	positive
hochnäsig	negative
hochschließen	negative
hochtalentiert	positive
hochtzeit	negative
hochzeits	positive
hochzeitseinladung	positive
hochzeitskuchen	negative
hochzeitspartys	positive
hochzeitstag	negative
hochzeitstaugliche	positive
hochzeitszeitungen	negative
hochzieh	negative
hocke	positive
hocker	negative
hoff	negative
hoffee	positive
hofgartenstrasse	negative
hogun	positive
hohlglasperlen	positive
hoho	positive
hol.	positive
hollandrad	positive
hollt	negative
holts	positive
holtsee	positive
holzbeinen	positive
holzhacken	positive
holzklotz	negative
holzlaufrad	negative
holzperlenarmband	negative
holzpfahl	negative
holzschild	positive
holzsplitter	negative
holzstapel	negative
hol’s	negative
homebutton	negative
homeoffice	positive
homofürst	positive
homosapien	positive
honigmet	positive
honigsüß	positive
hoodi	negative
hoooch	negative
hooooot	positive
hoppelt	negative
hopse	negative
horan	negative
hormon	negative
hormone.	negative
horneffer	negative
hornest	negative
horrorfilm	positive
horscht	negative
hostel	negative
hot	positive
hotd	negative
hotelbad	positive
hotelbar	negative
hotelbett	positive
hotelfachfrau	positive
hotelparkplätzen	negative
hotelpool	negative
hoteltyp	negative
hottes	positive
hotteste	positive
hotties	positive
houseparty	positive
howimetyourmother	negative
hrhhr	negative
hrithik	negative
huahuahuahua	positive
hubd	positive
hubi	positive
huch	positive
hucke	positive
hudgens	positive
huhuuuuuuuu	negative
huii	positive
huiiii	negative
hummus	positive
humorvol	negative
humpe	positive
hunde	negative
hundehalsband	positive
hundehotels	negative
hundekissen	negative
hundekopf	negative
hunden	negative
hundepfoten	positive
hundetraining	positive
hundeverträglich	negative
hundiiii	negative
hundine	positive
hungerst	positive
hungrig.	positive
hunni	negative
hurenschön	negative
hurig	positive
hurleys	positive
hurre	positive
hurtig	positive
huskey	negative
hustanfall	negative
hustlen	positive
hutablage	negative
hutkreation	positive
huut	negative
huuuunger	positive
hyazinth	negative
hydrate	negative
hyeongkon	negative
hyojun	negative
hypen	negative
hypothalamus	negative
hysterisch	positive
hyuk	positive
häagen	negative
hähnchenbeine	negative
hähnchengrill	positive
häkele	negative
häkelnadel	negative
hälmchen	negative
hämisch	negative
händy	negative
hängebrüste	positive
hängebrüsten	positive
hängenbleiben	negative
hängerchen	positive
härzlich	positive
hässchen	positive
hässlich	negative
hässligste	positive
hässliich	negative
hässlons	positive
häßliche	negative
häää	negative
häääässlich	positive
höchstpersönlich	positive
höckerschildkröte	negative
höherwertig	positive
höhlenmensch	positive
hör	positive
hörerinnentreffen	negative
hörweite	negative
hübsch	positive
hübsch♥	negative
hüftlang	positive
hüftumfang	positive
hügel	negative
hühnerstall	negative
hünchen	positive
hünschen	positive
hüpfburg	negative
hüpschen	positive
hürchen	positive
hüre	positive
hüschen	positive
hüttenzauber	negative
iblackz	positive
ic	negative
ichag	positive
ichat	negative
ichhalt	negative
ichjetztso	negative
ichnich	positive
ich’s	negative
icj	negative
icon	positive
icq	negative
idealistin	negative
idol	positive
iglu	negative
ignorier	positive
ihpennt	negative
ihrm	positive
ijemand	negative
ikaros	negative
ilebe	negative
illustratorin	negative
illustri	positive
imfall	positive
immer.	positive
immergeiler	negative
immet	positive
imne	positive
impekoven	negative
imperatorin	negative
imponieren	positive
inanna	negative
incentives	positive
inds	negative
industriepalast	positive
inen	negative
ines	negative
infomieren	positive
inglot	positive
ingwertee	negative
inlineskater	positive
inne	negative
innem	negative
innenaustattung	negative
innenbox	positive
innenfutter	positive
innentasche	positive
insektenbehausungen	negative
insektenschutz	negative
insektenspray	positive
inselwelt	negative
insta	negative
instagrammfilter	positive
instagramt	negative
instalove	negative
instandsetzungs	negative
instrumentalstück	negative
intarsia	negative
intelligent	positive
intellktuell	positive
intensiv	negative
interagiere	positive
interessant	positive
internet.	positive
interresant	negative
intressiere	negative
invincibile	positive
iphone.	negative
ipod.	positive
irdendwann	negative
ire	negative
irgendjmd	negative
irgenwelche	negative
irgrndwie	negative
iritiert	negative
ironie	negative
irrenhaus	positive
irrig	negative
irritierend	negative
irwas	positive
isabelangeli	negative
isabell	positive
ische.	positive
islandpferd	positive
isotonisch	negative
isst.	negative
iss’n	negative
itze	negative
ivoire	positive
ivonne	negative
iwi	positive
izzy	negative
iç	negative
i❤u	positive
ja2	negative
jaaaaaaaaaaaaaa	positive
jaaaaaaaaaaaaaaaaaaaaaaaaa	negative
jaaaaap	negative
jaaaan	positive
jaaaap	positive
jaaay	positive
jaahaa	positive
jace	positive
jackass	positive
jackett	positive
jacuzzi	positive
jahreskartenbesitzer	positive
jahrespraktikanten	negative
jahrmarkt	negative
jahrmarkt.	positive
jamaika	negative
jannas	negative
jannika	negative
janousek	negative
januar13	negative
jaqui	positive
jaquline	negative
jashja	negative
jasii	positive
jast	negative
jatpack	negative
jauchzen	negative
jawoll.	positive
jeans.	positive
jeansfritz	positive
jeaw	negative
jeck	positive
jedenfals	positive
jedentag	negative
jedhead	positive
jedmallow	positive
jeeeedes	negative
jefällt	negative
jello	negative
jellylock	negative
jenand	positive
jenne	negative
jensi	negative
jerry	negative
jerry’s	negative
jessica	positive
jetsetten	positive
jeute	positive
jewlz	negative
jeztz	negative
jimbo	positive
jippi	negative
jippie	positive
jiyongie	negative
jmd	positive
joah.	negative
jobben	positive
jobgruss	positive
jodl	negative
joelle	positive
joga	positive
joggerin	negative
jogginhose	positive
jogi	positive
johansson	negative
joly	positive
joni	negative
jorel	positive
joscha	negative
josefine	positive
josefinepreuss	negative
joshy	negative
jrock	negative
jubelpaar	negative
jubilieren	negative
juchu	negative
jucken	negative
juckige	positive
jugend.	positive
jugenderinnerung	negative
jugendliebe	negative
jugendschreibtisch	negative
juhuu	positive
juhuuuuuu	negative
juicy	positive
jume	positive
jumpen	positive
jungeeeeee	negative
jungenhaft	negative
jungfer	negative
jungfräulich	negative
jungmädchenava	positive
junkie	negative
jup.	positive
juppiii	positive
jurij	positive
justi	negative
juunge	negative
juuunge	positive
juwe	negative
jzz	negative
jäckie	positive
jägerhut	positive
jäger！	positive
jägi	negative
jährling	positive
jährlings	positive
järigen	negative
jö	positive
jööö	negative
jöööö	negative
jööööö	negative
jüdin	negative
k'von	negative
k0mmentare	negative
kabbeln	positive
kackboons	negative
kackend	positive
kackstift	positive
kackvögel	positive
kadel	positive
kadsen	positive
kaffebecher	negative
kaffeeklatsch	negative
kaffeeknopf	negative
kaffeequelle	negative
kaffeesatz	negative
kaffeetscherl	positive
kaffefahrt	positive
kagari	negative
kagg	positive
kahl	negative
kahlrasiert	negative
kaido	positive
kaimane	negative
kajalstift	negative
kajüte	negative
kakashi	negative
kaktuseis	positive
kakuzu	negative
kalken	positive
kalkzug	negative
kalli	negative
kalorien.	negative
kalorienarm	negative
kaltesbier	negative
kaltwachsstreifen	positive
kamelie	negative
kamerad	negative
kamikater	positive
kamille	negative
kaminromantik	negative
kanaken	positive
kandiert	negative
kanibale	positive
kannibalenopfer	positive
kannnst	negative
kannsd	negative
kannt	negative
kansd	positive
kanste	positive
kapiers	positive
kapitalismuskritiker	negative
kappelle	negative
kapriziös	negative
kaput	positive
kaput.	positive
karacho	negative
karai	positive
kardamom	positive
kareena	positive
kareshi	positive
karlo	negative
karneol	negative
karneval	negative
karnevalskostüm	positive
kartenlegerin	positive
kartofel	positive
kartoffelkiste	positive
kartonpackung	positive
karusell	positive
kaschmir	negative
kasperl	positive
kassenpatientin	positive
kassierst	positive
katara	positive
kataströphchen	positive
kate	negative
kati.	negative
katie	negative
katjes	positive
katrin	negative
katyarobbie	negative
katzenarsch	positive
katzenbabyfotos	negative
katzenbild	negative
katzenfressnapf	positive
katzengeschirr	positive
katzenhaaren	negative
katzenkopf	negative
katzenkotze	negative
katzenlady	positive
katzenmama	positive
katzenmädel	negative
katzensicher	positive
kaufs	positive
kaufts	positive
kauf’	positive
kaugummiautomat	negative
kaugummiwelt	negative
kaulitz	positive
kautz	negative
kauzig	positive
kayfun	negative
kdl2	negative
keeler	positive
keene	negative
kehlenfick	positive
kekschen	negative
keksfabrik	negative
keksteig	positive
kelch	negative
keldeo	positive
kellne	negative
kellner	positive
kelloggs	negative
kemperhof	negative
kennel	negative
kennengelernt.	positive
kennlern	positive
kenny	positive
kento	positive
keramikmesser	positive
keramikpfannen	negative
keramikspüle	negative
kernbeisser	positive
kernig	positive
kernöl	negative
kerzchen	positive
kerzenlicht	positive
kerzenwachs	negative
kesha	negative
ketchup	negative
ketschup	negative
kettcar	positive
kevn	negative
khaki	negative
kickboard	negative
kiddi	positive
kieran	negative
kiesling	negative
kiessee	negative
kiez	negative
kik	negative
kilimann	negative
killa	negative
killefitt	positive
killitwithfire	negative
kimchi	negative
kimmi	positive
kind	negative
kind2	negative
kindas	positive
kinderbetreuer	positive
kinderchen	negative
kinderchor	positive
kindergartenkind	negative
kindergartenliebe	negative
kindergesicht	negative
kindergärtnerin	negative
kinderhaarspangen	negative
kinderlieber	positive
kindermotive	positive
kinderparadies	negative
kindersitzgarnitur	negative
kinderstelzen	positive
kindheit.	negative
kindheitstraum	negative
kindheitstrauma	positive
kindl	negative
kingdome	negative
kinnings	positive
kinnschutz	positive
kinodate	positive
kippe	negative
kippeln	positive
kippenautomat	positive
kippenpause	negative
kippst	negative
kirby	positive
kirschroter	negative
kirste	negative
kisok	positive
kisu	positive
kitty	positive
kitzle	positive
klaar	negative
klammerblues	positive
klamottenladen	negative
klamottenmässig	positive
klanglos	positive
klappe	positive
klappen	negative
klapse.	negative
klarlack	positive
klaroo	negative
klassenfahrt	positive
klassenlehrer	negative
klassentreffen	negative
klaube	negative
klauend	negative
klauenseuche	negative
klaviersaite	negative
klebestreifen	negative
kleckere	negative
kleidun	negative
kleidung	positive
kleidungsstück	negative
kleinbleibende	positive
kleinbleibenden	negative
kleinigkeit	positive
kleinkariert	positive
kliene	positive
klinge	negative
klingeln	negative
klingelton	negative
klingen	positive
klippundklar	positive
klischeehaft	negative
klit	positive
klitzekleine	negative
klitzekleinen	negative
klitzekleines	positive
klo	positive
klolektüre	positive
kloppis	positive
klops	positive
klugscheisserin	negative
klumpen	positive
klärchen	negative
knabbere	negative
knabberst	positive
knabstrupper	negative
knacks	negative
knallerbse	positive
knallige	positive
knallpinke	positive
knallpinken	positive
knarren	negative
knarrend	positive
knarzt	negative
knatschen	negative
knauserig	positive
knautsch	negative
knautschen	positive
kneifzangenschleifer	negative
kneipentour	positive
kneippen	positive
knick	positive
knicklichtgehirne	negative
knickserl	positive
kniee	positive
knieenden	negative
kniesocken	positive
kniest	positive
knig	negative
knitter	negative
knitterfrei	negative
knittrig	negative
knoblauchbrot	negative
knopp	negative
knospen	negative
knuddeliges	positive
knuddelmutti	positive
knuffis	positive
knuffische	positive
knutschst	negative
knäul	negative
knödelt	positive
knüpf	negative
koana	positive
kobato	positive
kochkurs	negative
kochtipp	negative
kochvergnügen	negative
kohai	positive
kokon	positive
kokos	positive
koku	negative
kokusnuss	negative
kolege	negative
kollege	positive
kollegial	negative
kollegin.	negative
kolumna	positive
kombinierst	negative
komi	positive
komig	positive
komma	negative
kommissare	negative
kommulitonen	negative
kommunionkerze	negative
kommuniziern	negative
komparse	positive
komplitziert	negative
komplizirt	positive
komsichen	negative
komödiantin	negative
konata	positive
konfikleid	negative
konfirmieren	positive
konfitüre	positive
konkav	negative
konkurrenzprogramm	positive
konntest.	negative
konoha	negative
konplott	negative
konservendose	negative
konstanze	negative
kontaktabbruch	positive
kontaktbild	negative
kontaktdaten	negative
kontakte	negative
kontaktet	negative
kontaktier	negative
konterfei	positive
kontrastprogramm.	positive
koof	positive
kooperativenprojekte	positive
kopfhöhe	negative
kopfhöhrer	negative
kopfhören	negative
kopfkissenbezug	negative
kopfstimme	positive
kopptätscheltweet	negative
kor.	positive
korallen	negative
korallfarbenen	negative
korbsessel	positive
kordel	positive
kornfeld	negative
korrekt	positive
korytko	positive
kosch	negative
kosmetikbox	negative
kosmetiker	negative
kosmetiktaschen	negative
kosmetiktäschchen	negative
kotze	positive
kotzendes	positive
kotzfresse	negative
kotzt.	negative
kouta	negative
krabbenburgern	negative
krabbenbürger	negative
krach	positive
krachen	positive
krack	negative
krakamel	negative
kram	positive
kramst	positive
krangh	positive
krankenpfleger	positive
krasserscheiss	negative
kratzspur	positive
kraxeln	positive
krchkrch	positive
kreiseln	negative
kreislaufproblem	positive
kreissaal	positive
krempel	negative
kreolen	negative
kreuzen	positive
kricht	positive
krieche	negative
kriechen	positive
kriechtunnel	negative
kriegsgewinnler	positive
kriegtn	positive
kringelig	positive
kringel|kringeln	negative
kris	negative
krisknapp	positive
kristallkugel	negative
kristi	negative
kritzel	positive
krokodil	negative
krokotasche	positive
krokuse	positive
kroküsse	positive
kross	negative
krunchy	negative
kräuterbutter	negative
kräutertee	negative
krönungsfeiern	positive
kröt	negative
krötenwetter	positive
krüken	positive
krümelig	negative
krümmeln	positive
krümmeltee	negative
krümmen	positive
kuche	negative
kuchen.	positive
kuchenbasare	negative
kuchenblech	negative
kuchenduft	positive
kuchenkrümel	negative
kucker	negative
kuckst	positive
kuddel	positive
kudrow	negative
kufatec	negative
kugeldildo	positive
kugelig	negative
kuh	negative
kuhdorf	positive
kuhschwanz	negative
kulturbanausen	positive
kumpel.	negative
kumpelspass	positive
kunstlehrerin	negative
kuppeln	positive
kuriositätenkabinett	negative
kurokocchi	negative
kurvigere	negative
kurzbesuch	positive
kurzerhand	negative
kurzkleid	negative
kurzmantel	negative
kurzname	positive
kurzärmeligem	negative
kuschelhasen	negative
kuschell	positive
kuschelsack	negative
kuschelwetter	positive
kuschligsten	positive
kushina	positive
kussecht	positive
kussfotos	negative
kusssmileys	negative
kutcher	negative
kutter	negative
kwanghee	negative
kwangmin	negative
kyburg	positive
kyou	positive
kyung	positive
käfer	negative
kälte	negative
kälteempfindlich	positive
kämmst	positive
kämpfend	negative
kämst	negative
käpsele	positive
käsebällchen	negative
käsefüsse	negative
käseigel	negative
käserei	positive
käsesandwich	negative
käsetörtchen	positive
käsewürstchen	negative
käthe	positive
köchin	positive
kölnergram	negative
königsbacher	positive
königsblau	positive
königshofer	negative
köpfchen	negative
körperbewusst	negative
körperfläche	positive
körpersaft	negative
körperwärme	negative
kööönnte	negative
kübel	positive
küchenaufbau	positive
küchenchaos	negative
küchenfliesen	positive
küchenhilfe	positive
küchenkraut	negative
küchenstuhl	negative
kühlergrillen	negative
kürbissuppe	positive
küüühl	negative
kгјhlschrank	negative
l'd	negative
laaaaaangweilig	positive
laaaaangsam	negative
laaaangen	negative
laangewejle	positive
labberst	negative
labbrige	negative
labere	positive
laberflash	negative
labernd	negative
labra	positive
labrets	negative
lach.	positive
lachanfälle	positive
lachflashs	negative
lachsfarbende	positive
lachsfilet	negative
lacken	positive
lackieren	negative
lackierst	negative
lackiert	positive
lacklacken	positive
lackstiefel	negative
lady.	negative
lagenlook	positive
lagige	positive
lahves	positive
lakierten	negative
lallend	negative
laluna	positive
lamey	negative
lana.	negative
lande.	positive
landesschatzi	negative
landliebe	negative
landregen	negative
lang.	positive
langa	negative
langarmshirt	positive
langbeinig	positive
langen	negative
langeweile.	negative
langjähri	positive
langschläfer	negative
langwillig	positive
langzeitfreunden	positive
lannisters	negative
lappy	positive
laptop.	positive
larose	positive
larp	negative
larve	positive
laserpistole	negative
laserschwertern	negative
lassen	negative
lasstet	positive
lastlasttweet	positive
lastpic	negative
lateline	negative
latexfarbe	positive
latexhandschuh	positive
latexzirkel	positive
latino	negative
lattemacchiato	positive
laub	positive
laubbläser	positive
lauchs	negative
laufhose	negative
laufrunde	negative
laufsachen	positive
laufsch	negative
laune.	negative
lauscherlounge	negative
lautrer	negative
lauwarm	positive
lavendelduft	negative
lavigne	negative
layla	positive
leatherface	negative
lebenaufdemland	negative
lebendig	positive
lebendig.	negative
lebendigkeit	negative
lebenseinkommen	negative
lebensf	negative
lebensfrohe	negative
lebensgefährte	positive
lebensgroß	negative
lebenslangerschicksalsschatz	negative
lebenspartnerin	positive
lebensquelle	positive
lebensweisheit	positive
lebensziel	positive
leberkäs	negative
lebertran	positive
leberwurs	negative
leberwurscht	positive
leberwurst	negative
lebhaft	negative
leckdiener	positive
leckenmäulchen	positive
leckerheitsoverflow	negative
leckern	positive
leckerschmecker	positive
lecki	negative
leckmuschel	negative
lede	negative
lederarmatur	positive
lederhalsbänder	negative
lederhandschuh	positive
lederleggins	negative
ledern	negative
ledersessel	positive
ledersohle	positive
lederärmeln	negative
leecker	positive
leer.	positive
legging	positive
legokiste	negative
leguanfarm	negative
lehne	negative
lehrerpaar	negative
lehrst	negative
leichenteil	negative
leichtrittig	positive
leichtsinnig	positive
leidenschaft	positive
leiwand	negative
lemongras	negative
lena18	negative
lenaloveteam	positive
lenja	negative
lenkergewicht	positive
lenkerhalter	positive
lenni	negative
leo	negative
leos	positive
lernbehinderung	positive
lernbereit	negative
lernblätter	positive
lernnen	negative
lernzeug	positive
lesbe	negative
lesbenporno	positive
lesbische	positive
lesemarathon	negative
lesen	positive
lesesessel	positive
lesesofa	positive
letzes	negative
leuchtdekoration	positive
leuchtend	negative
leuchtkuli	positive
leudde	positive
leutchens	positive
leutee	negative
levitieren	positive
lgds	positive
liabn	positive
liane	negative
liben	positive
liche	positive
licht	negative
lichtdurchflutet	negative
lichtquelle	positive
lichtschwert	negative
lico	negative
lieb	positive
liebdich	positive
liebeb	positive
liebeeeeeee	positive
liebesanime	positive
liebesbekundung	negative
liebesbeziehung	negative
liebesgeschichte	negative
liebeskind	negative
liebeskummer	positive
liebessaft	positive
liebesschaukel	positive
liebessuchende	negative
liebevo	positive
liebevolles	negative
liebe♡	negative
liebgewinnen	negative
liebhab	negative
liebhat	positive
liebie	positive
lieblin	positive
lieblingbeschäftigung	positive
lieblingsaccount	negative
lieblingsanime	positive
lieblingsband	positive
lieblingscafe	negative
lieblingscafé	negative
lieblingscharaktere	positive
lieblingsecke	negative
lieblingsfilme	negative
lieblingsfisch	negative
lieblingsfreundin	negative
lieblingsfrucht	negative
lieblingshaustier	positive
lieblingskleid	negative
lieblingskombi	positive
lieblingsland	positive
lieblingslehrer	positive
lieblingsmodel	negative
lieblingsmädchen	positive
lieblingsnachbarn	negative
lieblingsort	positive
lieblingspaar	negative
lieblingspullover	positive
lieblingsrappern	negative
lieblingsrolle	positive
lieblingssender	positive
lieblingsserien	positive
lieblingsspieler	negative
lieblingsspielerin	negative
lieblingssportar	positive
lieblingsstecher	negative
lieblingsstelle	positive
lieblingsstellung	positive
lieblingsstädte	negative
lieblingsszene	positive
lieblingsszenen	positive
lieblingssängerin	positive
lieblingst	positive
lieblingstage	negative
lieblingstante	negative
lieblingsteile	negative
lieblingston	negative
lieblingstweet	positive
lieblingstwittermensch	negative
lieblingstüchlein	negative
lieblingswaffe	positive
liebst.	positive
liebäh	negative
lieb♥♥	negative
liechter	negative
lieeeeeeebe	positive
liegeützen	negative
liegst.	negative
lifestylewelt	negative
ligacup	negative
liiieeebe	positive
liiiiiiiieeebe	positive
likeaboss	positive
likt	positive
likörchen	positive
lilia	positive
liliane	negative
lilla	negative
lillifee	positive
lilu	negative
lilys	negative
limbi	positive
limetten	negative
lineal	positive
liners	negative
linkshänderin	positive
linsengericht	negative
linsensalat	negative
linse|linsen	positive
linus	negative
linzerschnitte	negative
lippestift	positive
lirc	positive
lise	positive
livecams	positive
lobbykumpeln	positive
lochi	negative
lochmuster	negative
lochzange	positive
loch|löchern	negative
lockeneisen	negative
lockenköpfchen	negative
locki	positive
lockscreenboy	negative
loftwohnung	positive
loggia	positive
loggst	negative
loljongun	negative
loller	negative
lollie	negative
longsleeve	positive
longus	positive
looser	negative
loretta	negative
lori	negative
lose	positive
loslaufen	negative
lottie	positive
love	negative
lovedoll	positive
lovestory	positive
lucia	negative
luckyloser	positive
ludolfs	negative
ludovico	negative
luftballontiere	negative
luftgetrocknet	positive
luftgitarre	negative
luftpolsterfolie	positive
luftposterfolie	positive
luftschokolade	positive
lufttrocknen	positive
luise	negative
luke	positive
lulle	negative
lunge	positive
lusig	positive
lustgrotte	negative
lustloch	positive
lustlos	negative
lustobjekt	negative
luststab	negative
luteces	positive
luvie	negative
luxusküche	positive
luxusprobleme	positive
lvln	positive
lymphödem	positive
lyoner	positive
lyr	negative
lysander	negative
längenvergleich	positive
längwillig	negative
läppchen	positive
lästernde	positive
lästerschwestern	negative
läääächerlich	negative
löchlein	negative
löffle	negative
lönd	negative
löwenkopf	positive
löwenmaul	negative
lüca	negative
lückenfüller	negative
lüftungsbauer	negative
lügen	negative
lügendes	negative
lüüüüp	negative
m0ni	negative
m1er	positive
m27	positive
m49	negative
m4m	positive
maaaaaaa	negative
maaaama	positive
maaag	positive
maaahn	positive
macchina	positive
mach.	positive
macheath	negative
machomann	negative
machsch	positive
mackaiin	negative
macken	negative
mackevision	negative
madita	positive
madln	negative
madschen	negative
mafiaboss	negative
magdi	negative
magentafarbenen	positive
magentropfen	negative
magerquark	positive
magnizkij	positive
magnolie	negative
magsch	positive
mahiro	negative
maibaum	negative
maike.	positive
mailin	positive
mainchar	negative
maincoon	positive
maite	positive
majestätisch	negative
make	positive
malerisch	negative
malhaar	positive
malkasten	positive
mally	negative
maloche	negative
malsache	positive
malso	negative
malteserwelpe	positive
malteserwelpen	negative
malträtieren	positive
malvorlage	positive
malz	negative
mammas	negative
mandelbäumchen	negative
mandelförmige	positive
mandelkruste	negative
mangaladen	positive
mangelhaft	negative
manikürt	positive
mann.	positive
mannfrauen	negative
manniboy	positive
manschmal	positive
maoh	negative
mappe	negative
maracuja	positive
marcamateure	negative
marcofono	negative
marder	negative
margäry	positive
mariacron	positive
mariamollypolly	positive
marieke	negative
marina	negative
marius	positive
marja	negative
markenklamotte	negative
marktfrau	positive
marktstand	negative
marlon	positive
marmeladenbrötchen	positive
marmeladenglas	positive
marmorstein	positive
marshugs	negative
marsupilamie	positive
martinfreeman	positive
marvelheroes	positive
marvin	positive
marvins	negative
marzipanei	negative
marzipantorte	positive
mascherl	positive
maschiene	positive
masken	positive
masochist	positive
masochistisch	positive
masquarade	positive
massage.	negative
massageengel	negative
massageliebhaben	positive
massel	positive
massenmention	positive
massina	positive
masturbiere	negative
masturbierend	negative
matchtag	negative
mathegenie	positive
mathematischh	positive
mathenachhilfe	negative
matheo	negative
mathis	negative
matrosinnen	positive
matryoshka	negative
matsche	negative
mattenzäunen	positive
mattis	positive
mattuschka	positive
matty	negative
matzingha	negative
maudado	negative
mauerstück	negative
maul	negative
maunzende	negative
maurier	negative
mausebärchen	negative
mauzen	negative
maxe	negative
maxi	negative
maxmara	negative
maxxwell	positive
mayo	positive
mcbitch	positive
mccafe	positive
medikamten	positive
medis	positive
medls	positive
meeehr	negative
meensch	negative
meeresbrise	negative
meeressalz	negative
meerrettich	negative
meetingraum	positive
megaaaaaa	positive
megaheiss	positive
megan	negative
megaorgasmus	positive
megaschlecht	positive
megasuperduper	negative
mehl.	negative
meib	negative
meikel	negative
meiklokjes	negative
meiko	positive
meine.	negative
meinejugend	positive
meinenerven	negative
meinet	positive
meinetwegen	negative
meinung.	negative
meisenknödel	positive
meissten	positive
meisterbrief	negative
meisterprämie	negative
melanzani	negative
melde.	negative
melisa	negative
melissengeist	negative
melitta	positive
melkfett	positive
melodramatisch	negative
melonpan	positive
menchu	negative
mendt	positive
mengoniatescconcertinamsterdam	negative
meninas	positive
menki	positive
mensch	negative
menschenfressend	positive
menschenmenge	positive
menschentiereunddoktoren	negative
menschenz	negative
menschn	positive
menstruierenden	negative
mentions	positive
meranoholz	positive
mercii	positive
merida	positive
merino	positive
merkwürdig	positive
merte	negative
mesotherapie	negative
messer	positive
messwein	positive
metallfresse	negative
metallics	positive
metallklammer	negative
metrickz	negative
metrosexuell	positive
metzschke	positive
mexikaner	negative
mezzomix	negative
mfx	negative
mhhhh	positive
mhp3	positive
miaaau	positive
mianhä	negative
miasat	negative
mibewohnerin	negative
mich.	negative
michonne	negative
micäla	positive
mief	positive
mieinander	negative
mienz	negative
mietraum	negative
mietzen	positive
miezi	positive
miiiich	negative
miiir	positive
mika	negative
mikealson	negative
mikki	negative
mikos	positive
mikro	negative
mikrofaser	positive
mikz	negative
milan	positive
milchbubbi	negative
milchbubbis	positive
milchflasche	positive
milchkanne	positive
milchpackungen	positive
milchtopf	negative
mild	negative
mileys	positive
milfarsch	negative
milford	negative
milka	positive
milkahasen	negative
mimen	positive
minderwertig	negative
mindfucked	negative
minga	positive
miniaturbild	negative
minidisplay	positive
minigrill	negative
minikleider	negative
minilop	positive
minimi	positive
minions	negative
minipizza	negative
miniwidderchen	positive
miniwolke	negative
minnelied	positive
minori	positive
mintgrüne	negative
minütchen	positive
mipm	positive
miramanga	negative
mirco	negative
mirgen	negative
mirotic	positive
mirrorzfx	negative
mir　gegeben	negative
misaka	negative
miscanthus	positive
mischlingshund	positive
mischlingskatzen	negative
mischlingskind	negative
missgeburten	positive
misshandele	positive
misslich	negative
misssssss	negative
misstrauisch	positive
misstune	negative
misten	negative
mistig	negative
mistwetter	positive
mit.	positive
mitantragssteller	positive
mitbeowhnerin	negative
mitbewoh	positive
mitbring	negative
mitenand	positive
mitfahren.	positive
mitfahrplatz	negative
mitfeiern	positive
mitfieberst	negative
mitfühlen	negative
mitgeguckt	negative
mitgeraten	negative
mitgliedsausweis	negative
mitgrillen	positive
mitlaufen	positive
mitleiden	positive
mitleidend	negative
mitleser	positive
mitläufer	positive
mitläufersuche	positive
mitmarschieren	positive
mitneh	positive
mitnem	positive
mitpendler	negative
mitreiterin	negative
mitschi	positive
mitschleif	negative
mitschleppen	positive
mitschülerin	positive
mitsingen	negative
mittagschlaf	positive
mittagsesse	negative
mittagsgeschichte	negative
mittagsgruss	negative
mittelalt	positive
mittelmäßiger	positive
mitten	positive
mitternachts	negative
mittersendling	negative
mittrinken	negative
mittvierziger	positive
mit’m	negative
miwoo	negative
mlp	negative
mmmmhey	positive
mmmmhhhh	negative
moaaah	negative
mobilfriseur	negative
modeln	positive
modisch	negative
mohrenkopf	negative
moii	positive
moiii	positive
moije	negative
molig	positive
mollige	positive
mollis	positive
mom.	positive
momy	positive
mondchen	positive
mondsüchtig	negative
monic	positive
monstertitten	negative
montach	negative
montag.	positive
montage.	positive
montagsinterview	positive
moofey	negative
moppedfahren	negative
moppelchen	positive
moppen	negative
moppers	positive
moppet	negative
moppi	positive
mopsgeschwindigkeit	positive
mopswelpen	positive
morchel	negative
mordfantasien	positive
mordmitaussicht	negative
mordsspaß	negative
morge	positive
morgend	negative
morgends	negative
morgengymnastik	positive
morgenlatten	negative
morgenlicht	negative
morgenmuffelig	negative
morgän	negative
moriarty	positive
morisse	negative
morlox	negative
morsche	negative
mortadella	negative
motivier	positive
motocrosspaket	negative
motorradl	positive
motorradurlaub	negative
motorschlitten	negative
mottotag	negative
motzanfall	negative
mousepad	negative
mozzarella	negative
mqcht	negative
mrmarcig	positive
mrmore	positive
mrs.	negative
muah	positive
muahahahha	positive
mucc	positive
muchlove	negative
muddah	positive
mudder	negative
muddha	negative
muddu	positive
muffe	negative
muffi	positive
muhahahahah	negative
muhahahahahaha	positive
mukena	negative
mulde	positive
multimediabildern	negative
multimediacen	positive
mumpe	positive
munchkin	positive
mundfaul	positive
mupfeltücher	negative
murlocs	positive
murmeln	positive
murmel|murmeln	positive
muschas	positive
muschelschale	negative
muschi.	negative
muschies	positive
musd	negative
musicbase	negative
musicpark	negative
musikblog	negative
musikgeschmack.	negative
musikgschmack	positive
musiklehrer	negative
musiksammlung	negative
musikverleger	negative
muskel	negative
muskelprotz	positive
muskelshirts	positive
musst.	negative
mustaches	negative
mustermix	negative
musterprofi	positive
mustertapete	positive
musti	negative
mutta	positive
muttertag	negative
muttertagskarte	negative
muttertier	negative
muuh	negative
muusik	positive
myego	positive
mygreenhood	negative
mykke	negative
myrte	negative
mã¼de	negative
mädchenschwarm	negative
mähsaison	negative
mänlich	negative
männerfaust	negative
männergespräch	positive
männerhaut	negative
männerklamotte	negative
männerparfum	positive
männersachen	positive
männerschwänze	negative
männertag	positive
männerwade	positive
märche	negative
märchenprinzessin	positive
mäulchen	negative
mópse	negative
möchete	negative
mönchskutte	positive
möpp	positive
mördertitten	negative
möwengeschrei	positive
möws	negative
mööp	negative
mückenstich	negative
müdeeeee	positive
müeder	negative
mühesam	negative
müllen	negative
müllsack	positive
müllst	negative
mülltone	negative
mülltonne	negative
mümmel	negative
münschen	negative
mürrisch	positive
müssest	positive
müsssen	negative
müüüdeee	positive
müüüüüde	negative
m’s	positive
n'aaawww	negative
n'aw	negative
n'aww	negative
n'paar	positive
naa	positive
naaaawwww	negative
naaww	negative
naawww	negative
nachahmen	negative
nachbardorf	negative
nachbarplatz	positive
nachbarschaft	positive
nachbarskatze	negative
nachfragst	positive
nachfärben	negative
nachhängen	negative
nachmache	positive
nachmachen	negative
nachmittagsprogramm	positive
nachname	positive
nachpfeifen	negative
nachrangig	negative
nachrichtenverlauf	negative
nachschenken	positive
nachschlüssel	negative
nachschminken	negative
nachsichtig	negative
nachspeisse	positive
nachtaktiver	negative
nachteilen	positive
nachteulis	positive
nachtigall	negative
nachtitweet	positive
nachtkleid	negative
nachtos	negative
nachtschwärmer	positive
nachtsichtkamera	negative
nachtwelt	positive
nachtwächter	positive
nachzufaven	negative
nachzuschminken	positive
nackenkissen	negative
nackenklatscher	negative
nackenmassage	negative
nackenpolster	negative
nackenprobleme	negative
nackenschmerz	negative
nackidei	positive
nacksch	positive
nacktkatzen	positive
nacktsein	negative
nageldesigns	negative
nagelkunst	positive
nagellacke	negative
nagellackregal	positive
nageln	positive
nagerhaus	negative
nah	negative
nahaufnahme	positive
nahrhaft	positive
naildesigns	negative
nailpolish	positive
nakose	positive
nakten	positive
name	negative
namenhaf	negative
namensschild	positive
namensschwester	negative
nanntest	positive
naoe	positive
narrenschuhe	negative
narry	positive
narumol	positive
naschkatze	positive
nasenbohren	negative
nasenduschen	positive
nasenflügel	negative
nasenring	positive
natascha	negative
natasha	negative
natie	negative
natuerliche	positive
naturbehaart	negative
naturblonde	negative
naturbrüste	positive
naturbusen	positive
naturdarm	negative
naturfranzösisch	negative
naturfreunde	negative
naturgemälde	positive
naturnagelverstärkung	negative
naturnägel	negative
naturverbunden	negative
navona	negative
naylor	positive
nazans	negative
naziaufkleber	positive
nciht	positive
nebeneinander	negative
nebenher	positive
nece	negative
nedmal	positive
neeeeeee	positive
neeeeeeein	negative
negativ	negative
neglige	positive
negromi	negative
neid.	positive
neider	positive
neidiesch	positive
neidischsten	positive
neidsch	negative
neig	positive
neiiin	negative
nekos	positive
nektar	positive
neon	negative
neonorange	negative
nerddings	negative
nerdige	negative
nerdkurve	positive
nerft	negative
nervenbündel	positive
nervenkitzel	negative
nervstimme	negative
nescht	negative
nesli	negative
nestchen	positive
nesterl	negative
netrebko	negative
nett	positive
nette.	negative
nettigkeit	positive
netzabsturz	negative
netzhöschen	positive
netzoberteil	positive
netzstrumpfhose	negative
neuentdeckung	positive
neufollowern	positive
neufundländer	negative
neulich	positive
neunuhrurlaubsort	negative
newday	positive
newgape.	negative
nexttweet	negative
nhemen	positive
niceee	positive
niceeeeee	negative
nices	positive
nicgt	negative
nichma	negative
nichmal	negative
nichs	negative
nichtmehr	negative
nichtraucherhau	negative
nichtsgönner	negative
nichttraurig	negative
nicjt	negative
nickend	negative
nicks	positive
nicky	positive
nid	positive
niederholtorf	positive
niedluch	negative
nielpferd	positive
nieren.	negative
niesser	negative
nightline	negative
nihi	negative
nihihi	positive
niici	negative
niiicht	positive
niiiicht	positive
nikoläuse	negative
nilsding	positive
nim.	negative
nimmerleins	negative
nimmst.	positive
nina18j	positive
ninjahase	negative
ninjasterne	negative
ninjauberer	positive
nirgendwohin	positive
nischt	negative
nistkasten	negative
niveu	negative
nivht	negative
njaa	negative
njyg	negative
noaaaar	negative
noaaw	negative
nochj	negative
nommal	positive
nonne	positive
noodle	negative
noona	positive
nordglanz	negative
noriko	negative
normali	negative
normandie	negative
nostril	negative
notenblatt	positive
notfallspray	negative
nothingmoretosay	positive
notizzettel	negative
notkastrat	negative
nougatschnitte	positive
noverryirawan	negative
nsz	negative
nudelteig	negative
nudelwasser	positive
nudist	positive
nullneun	negative
nulpen	positive
number1	negative
nume	negative
nun	negative
nunas	positive
nunig	negative
nuno	negative
nuppel	negative
nups	negative
nurfürn	positive
nurnoch	positive
nuru	positive
nuscheln	negative
nussini	negative
nusskipferl	positive
nussknacker	negative
nutellaglas	positive
nutten	positive
nutten.	negative
nuttendiesel	negative
nuttige	negative
nylonfüsschen	positive
nylonhose	negative
nylonsocken	positive
nylonspiele	negative
nyx	positive
nähatelier	negative
näherst	negative
nähh	negative
näselnd	negative
näun	negative
näxt	negative
nöcher	negative
nögschte	negative
nölen	negative
nölig	negative
nörgelnd	positive
nöööööö	positive
nüsch	negative
nüscht	negative
nüssler	positive
o	positive
o'grillt	negative
oaah	positive
oahr	positive
oasch	positive
obadzda	positive
obdachloser	positive
obendrauf	positive
oberaffengeil	negative
obercoolen	negative
obercoolste	positive
obergeile	negative
oberhausen	negative
oberhonnefeld	positive
oberlehrer	positive
oberlippenbart	positive
obermieter	negative
oberrohr	negative
oberschenkel	positive
obieglo	negative
obst	positive
obsthändler	positive
obsttüte	negative
obszön	negative
ochsenfrosch	positive
ocker	negative
ocolus	negative
ocs	positive
oda	negative
odins	positive
ofen	positive
ohhhhhhhh	negative
ohjaa	positive
ohmann	negative
ohnematti	negative
ohnezahn	negative
ohoho	negative
ohrenkrebs	positive
ohrhaken	negative
ohringe	positive
ohrvergewaltigung	positive
ohrwurmlied	negative
oide	negative
okaaaay	positive
okai	negative
okaii	negative
okay.	positive
okayichhättedasoideen	positive
okee.	negative
okeey	negative
okk	positive
okkkk	positive
oldschool	negative
olgt	positive
olivia	negative
olly	negative
onedirection	negative
onee	negative
onestroke	negative
onkelgordy	negative
ooc	positive
ooohhh	negative
ooohr	negative
ooooder	positive
oooooar	negative
oooooooh	positive
oooooooooh	positive
opalen	positive
opernmusik	negative
opfa	positive
opfaz	negative
opii	positive
oppai	negative
oppas	negative
oreoshake	positive
organiesiert	positive
orgie	negative
orginell	negative
originell	positive
orkun	negative
ornanieren	negative
oshima	positive
osterausritt	positive
osterbrot	negative
osterferien	negative
osterhighlights	negative
osterlämmchen	positive
osternest	negative
osterspaziergang	negative
osterüberraschungen	negative
ostwestfale	negative
ota	negative
otl	positive
otze	positive
otzen	positive
oukay	negative
outdatet	negative
outdoorbereich	positive
outen	positive
outgun	positive
outtakes	negative
overlock	positive
oversized	negative
owley	positive
oww	negative
paa	negative
paartanz	negative
paartherapeutin	positive
paarungsfarm	negative
paarungswilligen	positive
packts	positive
padawane	negative
paddel	negative
paddeln	positive
paheli	positive
paillette	negative
pair	negative
pairing	negative
palina	positive
palmwedel	positive
pam13	positive
pampe	negative
panache	negative
pandabärchen	negative
pandakostüm	positive
pandamütze	negative
pandas	positive
panikanfall	negative
panoramabild	negative
pantel	positive
panzerband	positive
pap.	negative
papagei	negative
papapapa	negative
papaya	positive
papayas	positive
pappig	positive
pappkamerad	positive
paprika	negative
paprikasuppe	positive
papsi	negative
paralleluniversum	negative
parasprites	positive
parfümflasche	negative
parisjungsexy	negative
parkettfußboden	negative
parkplatztreffen	negative
parodierst	positive
parteeeey	positive
parteeyy	negative
parteitagen	negative
partnervermittlungsagentur	negative
partycrew	negative
partyraum	positive
partyrausch	positive
partyschlampe	positive
partytop	negative
partyvolk	positive
partyvorbereitungen	negative
pasi	positive
passendsten	positive
passi	positive
patafix	positive
patate	negative
patchi	positive
patrice	positive
patumbah	negative
pausenlos	positive
pavian	positive
paxnos	positive
pdy	negative
pectoralis	negative
pedantisch	positive
pedohöhle	negative
peinlichkeiten	positive
peitsche	positive
peitsche|peitschen	positive
pellen	positive
pello	positive
pembuat	negative
penen	positive
penisse	negative
penne	positive
pennen.	negative
pennerlook	positive
penny	negative
peony	negative
peopleireallywanttomeet	negative
peperoni	positive
peppeln	negative
pepperonis	negative
perfeckte	negative
pergament	negative
perlchen	positive
perle.	negative
perlenfund	negative
perlenohrringe	negative
perlenschlösschen	negative
perlmutt	negative
perserin	positive
perserkater	positive
perserle	positive
persermädchen	positive
person1	negative
perückenkopf	positive
petersilie	negative
petersilienkartoffel	negative
petersilienwurzel	positive
petroleumofen	positive
petruskreuz	negative
petterson	positive
pevers	positive
pewdiepie	positive
pewds	negative
pfandflaschen	positive
pfandleiher	negative
pfeifchen	positive
pfeifenraucher	positive
pfeifst	negative
pfeil	positive
pferd	positive
pferdekopf	positive
pferdemist	negative
pferden	positive
pffft	positive
pfingstrose	positive
pfirsichhaut	positive
pflanzen	negative
pflanzkübel	positive
pflegebeteiligung	positive
pflegegehtaufreisen	negative
pflegehund	positive
pflegepony	positive
pft.	positive
pfui.	positive
pfuideibel	positive
pfundsweib	negative
pfäffike	positive
phantasialand	negative
phielib	positive
phine	positive
photoshoppe	negative
photoshopt	positive
physik	negative
phä	negative
phönchen	positive
phöse	positive
pi	negative
pickeln	negative
pickupartist	negative
picky	positive
pics	positive
pieckst	positive
pieeeep	positive
piepend	negative
piepie	positive
piepmätzen	negative
piercingschmuck	negative
pieren	positive
piet	negative
piia	negative
pilotenbrille	negative
pils	negative
pilsken	negative
pimmels	negative
pinata	negative
pingui	positive
pinguin	negative
pinguine	negative
pinienkernen	negative
pinkelt.	negative
pinkler	positive
pinkpanty	positive
pink’s	negative
pinnchen	positive
pinni	negative
pinnie	positive
pinscher	negative
pinselchen	negative
pintomix	negative
pintostute	negative
pippi	positive
piratenbräute	negative
piratenfahne	negative
piratenparty	positive
piratte	positive
pissed	positive
pissgeile	negative
pisskindern	negative
pisssklave	negative
pissts	positive
pistazie	negative
pistazieneis	positive
pitri	negative
pittoresk	negative
pitu	positive
pivat	negative
piwek	negative
pixel4art	positive
pixies	negative
pizokkel	positive
pizzässen	positive
plakateklau	negative
planschbecken	positive
planschkuh	negative
plantscht	positive
plastikball	positive
plastikeier	negative
plastikplane	negative
plastiktasse	positive
plastische	negative
plateau	negative
plateauschuh	positive
platnum	negative
plattsitzen	negative
platzangst	negative
platzregen	negative
plauderei	positive
playdoh	positive
playhouse	negative
playmobile	positive
pleo	negative
pletz	negative
plinse	positive
pll.	negative
plot4u	positive
plotten	negative
plätschern	positive
pläuschen	negative
plöd	positive
plötzlech	negative
plüschiges	negative
plüschis	positive
pocahontas	positive
podcatcher	negative
podenca	positive
poge	negative
pokemons	negative
pokémon	negative
pollenfrei	negative
pollunder	negative
polly	negative
polonaise	positive
polterabend	positive
polz	positive
pommesgabel	positive
poni	negative
ponk	negative
ponyhof	negative
ponywallach	negative
pooh	positive
popcornmaschine	negative
popen	positive
popogirl	positive
poppen	positive
poppnacht	negative
pornokätzchen	negative
porridge	positive
portionieren	negative
portraitfoto	negative
porzellanen	positive
porzellanfigur	negative
porzellangott	negative
porzellanpuppe	positive
porzellanteile	negative
posiere	positive
posierend	negative
positiv	positive
postamt	negative
postboten	positive
postbotin	negative
poste	positive
posterwand	positive
postet	positive
postfach	negative
pottschnitt	negative
pottwal	positive
powernap	positive
prada	negative
prakti	negative
praktisch.	positive
praxisraum	negative
praxisschild	positive
prayforsyria	positive
preiselbeere	positive
preisinger	positive
preisvergleichs	positive
presentiere	positive
presskopf	positive
prettynina	negative
preziosen	negative
prickelwasser	negative
prinzessinn	negative
prisca	positive
prittwitz	negative
privataccount	negative
privatchat	negative
privatlehrer	positive
proberaum	positive
probiers	negative
probier’s	negative
probleme	negative
problemen.	negative
prodrive	positive
produktionsüberwachung	negative
profan	negative
profesionellen	negative
profie	negative
profikoch	positive
profitänzer	negative
prolo	positive
promisichtung	negative
promotionscoach	positive
propellerflugzeug	positive
propellermaschine	positive
proud	positive
provokante	positive
prusten	positive
präsentationswand	negative
prätentiös	positive
pröm	positive
pseudointellektualität	positive
psst	negative
psychater	negative
psychologin	positive
psychomässig	negative
psychopathisch	negative
pubertierender	positive
pulswärmer	negative
pummelfee	positive
pumpdildo	positive
pumps.	positive
pumuckel	positive
punkig	negative
punktejägern	positive
punktewertungen	negative
pupertierende	negative
puppe	positive
puppenkinder	negative
puppenrucksack	positive
pupsender	positive
purtashadud	negative
purzelbaum	positive
puschelig	negative
pusher	positive
puten	negative
putzen.	positive
putzfee	positive
putzschlampe	positive
putzsklave	positive
puush	positive
puuuur	negative
päda	negative
pädobär	negative
pälla	negative
pärchenabend	negative
päärchen	negative
pöpken	positive
pörtgenherder	positive
püh	positive
pürieren	negative
püüüüh	negative
qeen	positive
qloom	negative
qualm	negative
quark	positive
quarkcreme	positive
quarkmaske	negative
quartieren	negative
queergeeks	negative
quicky	positive
quietschbunt	positive
quietsche	positive
quietschend	positive
quietschlaute	positive
quin	negative
radarpistole	negative
radfahren	negative
radicchio	negative
radierer	negative
radiogesicht	negative
rafa	negative
raffaello	positive
raffinesse	positive
rahmengenähte	negative
raketenantrieb	negative
raku	positive
ramazotti	positive
ramon	positive
ramonadeluxe	negative
ramontik	negative
ramses	negative
randomfactaboutme	negative
rangler	negative
ranke	negative
ranzenboy	negative
ranzt	negative
rappe	negative
rappen	negative
rappende	positive
rapperin	negative
rappte	negative
rasenschnitt	positive
rasensprenger	positive
rasiercreme	negative
rasierseife	negative
rasiertes	positive
rassel|rasseln	negative
rassestute	positive
rassisten	negative
rastlos	positive
rastplatz	negative
rasul	positive
rathian	positive
ratige	positive
ratschen	positive
ratte	positive
ratten	negative
rattenscharfe	positive
rattenschreck	positive
ratti	positive
rattler	negative
ratze	negative
raubeinige	positive
rauch.	negative
rauche.	negative
raucherbank	negative
raudis	positive
raufen	positive
raufkommen	negative
raughs	negative
raumakzente	negative
raumgreifend	negative
raupi	negative
raupy	positive
rauschentfernung	positive
rausgegangen.	negative
rausgepackt	positive
rausgepresst	positive
rausgucken	positive
raushelfen	negative
rauskopieren	positive
rauslegt	negative
rausmusste	positive
rausschmeißen	negative
raussetzen	negative
rausstrecken	positive
ravioli.	positive
rawk	positive
raziel	negative
rckstr	positive
readathon	positive
reagenzglas	negative
reapern	positive
rebecka	negative
rebekka	negative
rebellin	negative
rebensaft	positive
reblogge	negative
rechenmodell	negative
rechtschreibschwäche	positive
rechtspopulistisches	negative
rechtzei	positive
recom.	negative
redebedarf	negative
redefluss	positive
redheads	positive
redlich	positive
regebögen	negative
regenbogenfarbenes	positive
regenbogenhaus	negative
regencape	negative
regenerieren	positive
regenhimmel	positive
regenschauer	positive
reggä	negative
regieassistenz	positive
reglos	negative
regnets	positive
regtop	negative
reh.	positive
reibekuchen	positive
reibend	negative
reichtumsecke	positive
reihern	negative
rein	positive
reinbeisst	positive
reinbeißen	positive
reinbrüllst	negative
reinfahren	positive
reingelaufen	positive
reingeschnittenen	positive
reinhängen	positive
reinkackt	negative
reinknieen	positive
reinkommen	negative
reinmachst	negative
reinscheißen	negative
reinschiebe	positive
reinspritzen	positive
reinsteck	positive
reinstopfen	positive
reinstopfst	positive
reintunken	positive
reinwerfen	positive
reinziehn	negative
reinzuschmuggeln	positive
reiseangebot	positive
reisebegleitung	positive
reiselustig	negative
reisen	positive
reisendiashow	negative
reisepartner	negative
reisepartnerin	negative
reishuttragendem	negative
reiskocher	positive
reissverschluss	positive
reisszweck	negative
reit	positive
reitbeteidigung	negative
reitho	positive
reißfest	negative
rektalgeburt	positive
relike	positive
relilehrer	positive
relirookies	positive
remidemi	positive
remoulade	positive
renke	positive
renly	negative
renno	positive
rennvelo	positive
renov.	positive
rentnerparty	positive
resetknopf	positive
reshi	positive
respekteinflössend	negative
respektklatschen.	negative
restalkohol	negative
restlich	negative
restone	negative
restsamstag	negative
restsonntag	positive
restwochenende	negative
retuschieren	negative
retweet	negative
rhetorikhammer	negative
ricardos	negative
richel	negative
richitg	positive
richtig	positive
riechend	negative
riesenbrust	negative
riesendanke	negative
riesenrespekt	negative
riesenschwanz	positive
riessige	negative
rihanna	negative
riiiiiesen	negative
rika	negative
rinas	positive
rinderfilet	positive
rinderroularde	positive
ring.	negative
ringbahn	negative
ringelnatter	positive
ringkissen	positive
ringo	negative
ringsrum	negative
ripley	positive
risch	negative
rischmeyer	positive
risige	positive
riskier	positive
rita	positive
rittersporn	positive
rißmann	positive
robotermäher	negative
roboterstaubsauger	positive
robs	negative
rocke	positive
rocketpics	negative
rockparty	positive
rogate	negative
rohdiamant	positive
rohrspatz	negative
rojinski	negative
rokhyun	negative
roki	negative
rolator	negative
rolf.	negative
rollator	negative
rollatorraserei	negative
rollkoffern	negative
rolltreppe	positive
rom.	negative
romantiker	positive
romantikerinnen	negative
romantische	positive
romanze	positive
romy	negative
roooobert	positive
rootrechte	negative
rooz	positive
rosa.	positive
rosaner	positive
rose	negative
rosenblatt	negative
rosenmotiv	positive
rosenstrauch	negative
rosskastanie	negative
rostig	negative
rosè	positive
rothmann	positive
rotstich	negative
rotweinglas	negative
rotweinkuchen	positive
rotweinsosse	positive
rotzige	positive
rotznäschen	negative
rowdies	negative
rpi	negative
rrz	negative
rted	negative
rtest	negative
rts.	positive
rtst	positive
rubbelst	positive
rubensfrau	positive
rubenslady	positive
rubensstute	positive
ruckzuck	negative
ruderst	negative
ruffys	positive
rufste	negative
ruhepol	positive
ruhig.	positive
ruhrpott	negative
ruig	positive
rumdrücken	negative
rumfliegende	negative
rumgegammelt	positive
rumgehen	positive
rumgehurt	positive
rumgemache	positive
rumgerollt	negative
rumgeschupst	positive
rumgeschwule	negative
rumkauen	negative
rumkriecht	negative
rumlauf	positive
rumlauft	positive
rumlecken	negative
rumlästern	negative
rumpeltriebwerk	negative
rumrenn	negative
rumsauen.	negative
rumschleimst	negative
rumschnüffeln	positive
rumschreist	positive
rumspacken	negative
rumspielen	positive
rumsprühen	negative
rumstöbern	positive
rumtanzen	negative
rumtrampeln	negative
rumtreiben	positive
rumträgst	positive
rumzulatschen	positive
rundfische	positive
rundflug	negative
runffm	negative
runna	positive
runter	negative
runtergerutscht	positive
runterlaufen	negative
runterspringen	negative
runterzählen	negative
rushe	positive
ryo	negative
räkelnde	positive
räuchern	negative
röhrenjean	negative
röstkartoffel	positive
röstung	negative
rübensirup	negative
rüberschicken	negative
rüberwerf	negative
rückbank	positive
rückenmassagen	negative
rückn	positive
rüde	positive
rüeblisalat	positive
rührkuchen	positive
rührteig	negative
ründchen	positive
rüschenschal	positive
rüsselantenne	negative
rüvi	positive
s'alqueria	positive
saaaaag	negative
sabias	negative
sache	negative
sachet	positive
sachtes	negative
sacko	negative
saftsäcke	negative
sagtes	negative
sahneklecks	negative
sahs	negative
saju	positive
saku	negative
salamibrote	negative
salamualaikum	positive
salatdressings	negative
salatsoße	negative
salatteller	negative
salner	negative
salzkartoffel	negative
salzlake	positive
samantha	positive
samaritische	positive
sambatänzerin	positive
sambuca	negative
saminatorgeschichte	negative
sammlerfiguren	negative
sammlerpuppe	positive
samnaun	positive
samstags	positive
samtband	positive
samy	positive
samydeluxe	positive
sandkiste	negative
sandpapier	positive
sandstrand	positive
sanduhr	negative
sandwichtoaster	negative
sandy	negative
sango	negative
sangria	positive
sani	negative
sansi	negative
sarahann	negative
saraya	positive
sarda	negative
sartre	negative
saruhiko	positive
sascha	positive
sasori	negative
satinbettwäsche	negative
satingürtel	positive
satinwidder	negative
sauber	positive
sauber.	negative
sauerampfer	negative
sauerteig	negative
saugeiler	negative
sauli	negative
saunabesuch	positive
saunafass	negative
saunakota	negative
saunavariante	negative
saus	positive
saut	negative
sauteures	positive
sawatzki	negative
sazzy	positive
scarlett	positive
schaaade	positive
schaaatzi	negative
schaben	positive
schabernackig	negative
schafen.	positive
schaffner	negative
schafftst	positive
schafstedt	negative
schaisse	negative
schakeline	negative
schalalala	negative
schale	positive
schalfen	negative
schalgzeug	negative
schalkelied	positive
schalllöcher	positive
schamesröte	positive
scharmör	negative
scharrend	positive
scharrer	negative
schatze	positive
schatzig	positive
schatzlein	negative
schatzo	negative
schatzt	positive
schatzys	positive
schaulustig	negative
schaumamal	positive
schauspielerin	negative
schaz	positive
schbin	positive
scheibengardine	positive
scheiisse	negative
scheisse	negative
scheisseeee	positive
scheisseeeeee	negative
scheisserchen	positive
scheisshaus	negative
scheisswetter	positive
schene	negative
schenkelklopfen	negative
scherzen	positive
scheu	negative
scheu.	positive
scheußlich	negative
schewski	negative
schickeria	negative
schicket	positive
schicksen	negative
schickts	negative
schiebemäher	positive
schiebs	positive
schiebts	positive
schiefer	negative
schienst	negative
schiessbude	negative
schiffen	positive
schiffshorn	positive
schik	positive
schimpfen	positive
schimpfwort	negative
schin	negative
schippchen	positive
schizophrenia	negative
schlabberfotze	negative
schlabbermatten	negative
schlach	negative
schlackern	positive
schlacksi	positive
schlafbereich	positive
schlafbesuch	negative
schlafen.	positive
schlafgemach	positive
schlafgeräusche	negative
schlafgut	negative
schlaflos	positive
schlafrytmus	positive
schlaftrunk	negative
schlafwandeln	positive
schlafzimmerspiegel	negative
schlagball	positive
schlagerqueen	negative
schlagstock	negative
schlagzeug	positive
schlagzeuger	positive
schlagzeugsolo	positive
schlammpfütze	positive
schlampeee	positive
schlangeneier	positive
schlankmacher	positive
schlauchschal	positive
schlaudia	negative
schlaumeier	negative
schlecht	negative
schlect	negative
schleimbolzen	negative
schleimerei	negative
schleimern	negative
schleimst	negative
schlender	negative
schlenzer	negative
schlepptop	positive
schlieb	negative
schließe	negative
schlimm	negative
schlitten	negative
schlitzauge	positive
schlitz|schlitzen	positive
schlohweiß	negative
schlonzi	negative
schlotzt	positive
schluchzen	negative
schluck	negative
schluckgeiles	negative
schluckgierige	positive
schluckgieriges	negative
schlummerst	positive
schlumperbüx	positive
schlupfbluse	negative
schlägertyp	positive
schlämpchen	negative
schlön	negative
schlüsel	negative
schlüsselanhänger	negative
schlüsselblume	negative
schmalz	positive
schmalzen	positive
schmalzstulle	positive
schmankerl	positive
schmatz	positive
schmeckst	negative
schmeckts	negative
schmelle	positive
schmerz	negative
schmieg	positive
schmiergelpapier	positive
schmierlappen	negative
schminkkoffer	positive
schminktasche	positive
schminktutorial	negative
schmu	positive
schmucknadeln	negative
schmuggelst	positive
schmunzelhasen	positive
schmunzeln	negative
schmusehund	negative
schmusen.	negative
schmöcked	negative
schmöckt	negative
schmökere	positive
schnack	negative
schnackt	negative
schnall	negative
schnalle|schnallen	positive
schnarrchen	positive
schneeballschlacht	negative
schneebesen	positive
schneegestöber	positive
schneeschieber	negative
schneeweißer	negative
schneiden.	negative
schneien	negative
schnein	negative
schneits	positive
schnelsten	positive
schnibben	positive
schniblo	positive
schnidde	negative
schnidel	positive
schnippeln	negative
schnippseln	positive
schnittkurs	negative
schnittmuster	negative
schnitz	positive
schnorren	negative
schnorrer	negative
schnorres	positive
schnuckels	negative
schnuffelig	negative
schnuffligen	negative
schnuggelich	positive
schnuggels	positive
schnullerbacke	positive
schnullerbacken	negative
schnupfig	positive
schnuppe	positive
schnuppi	positive
schnuppsis	negative
schnur	negative
schnäuzchen	positive
schnösel	positive
schockräume	negative
schoffer	positive
schokobärchen	positive
schokocookies	negative
schokocroissants	positive
schokofüllung	positive
schokohäschen	negative
schokoladenbraun	negative
schokoladenbrunnen	negative
schokoladeneier	negative
schokoladenmuseen	negative
schokoladenosterhase	negative
schokoladiger	negative
schokomaus	positive
schokoseite	negative
schokosplittern	negative
schokostücke	negative
schokotassenkuchen	negative
scholzen	negative
schoneinmal	negative
schonste	positive
schrade	negative
schramme	negative
schraube	positive
schreck	positive
schreiberin	positive
schreibi	negative
schreibtisch	positive
schreibtischplatte	positive
schreibtischschublade	negative
schreibtischstuhl	negative
schreibts	positive
schrein	negative
schreklich	positive
schribsch	positive
schriebfehler	negative
schroff	positive
schrottis	negative
schrottkiste	negative
schrumpel	negative
schrumpfkopf	negative
schrupp	positive
schubbern	negative
schuhladen	positive
schuhlöffel	negative
schuhmarke	negative
schuhsammlung	negative
schulbegleiter	negative
schuldest	positive
schuldigung	negative
schulermittler	positive
schuljunge	positive
schulkollegin	negative
schuller	positive
schulmädchen	positive
schulpause	negative
schulterklappe	positive
schulterriemen	negative
schuluni	positive
schulweisheit	negative
schulärztin	negative
schupfnudeln	positive
schussabgaben	negative
schutzengelbild	negative
schutzteufel	positive
schw	positive
schwabenländle	negative
schwach	negative
schwach.	positive
schwan	positive
schwanzgesteuerten	positive
schwanzträger	negative
schwarzbier	negative
schwarzbrot	positive
schwarze	negative
schwarzweißen	negative
schweben	negative
schweigend.	positive
schweineeee	positive
schweinemaske	positive
schweinhund	negative
schweinisch	positive
schweinsfilet	negative
schweiss.	negative
schweissgeruch	negative
schweiß	positive
schweißgebadet	positive
schwergängig	negative
schwerhörig	positive
schwertkampf	negative
schwertset	positive
schwetser	negative
schwiegermutters	positive
schwimmring	negative
schwin	negative
schwingen	positive
schwingend	negative
schwipp	positive
schwippschwapp	negative
schwips	positive
schwizer	negative
schwulenbar	negative
schwulenpaar	negative
schwulenpornos	positive
schwummerig	negative
schwungvoll	negative
schwäbelnde	negative
schwänzchen	positive
schwänze	positive
schwänzerin	negative
schwärze	positive
schwörma	positive
schädlich	negative
schäferhündin	negative
schähm	positive
schälchen	negative
schälst	negative
schärtl	negative
schätzelchen	positive
schätzen	positive
schätzle	negative
schõne	positive
schön	positive
schöneberger	positive
schönherr	negative
schööööönnn	negative
schüch	positive
schül	negative
schürfwunde	negative
schütten	negative
scjon	negative
scotch	positive
scrabble	negative
scrappy	positive
screenie	negative
sechseck	negative
secksi	positive
secound	negative
secus	negative
sedona	positive
see.	positive
seeehr	positive
seehund	negative
seekrank	negative
seelenruhig	negative
seemann	positive
seemannsgarn	positive
seeu	negative
segelschein	negative
sehest	positive
sehkraft	negative
sehnlich	negative
sehnsu	positive
sehnsuchtsadressen	negative
sehnsuchtsvoll	positive
sehts	positive
sehuns	negative
seicht	positive
seidenschal	positive
seife	negative
seil	positive
seintje	positive
seitdem	positive
seitenrand	negative
seitenschläferkissen	positive
sektbar	positive
sekttrinken	negative
selbstbefriedigen	negative
selbstbeschiss	negative
selbstbewuster	positive
selbstbewußter	negative
selbstbild	positive
selbstbildnis	positive
selbstbildniss	negative
selbstbräuner	positive
selbstgefühl	negative
selbstgekocht	positive
selbstgemalt	negative
selbstgezeichneten	negative
selbsthass	positive
selbstportraits	positive
selbstsicherung	negative
selbstvergessen	positive
selbstzweifelnd	positive
selena	positive
seltsam	negative
sely	positive
semel	positive
senf	negative
senpai	negative
sensationsbild	positive
sensibel	negative
sentimental.	negative
sepia	positive
serenas	positive
sers	positive
servieren	positive
serviette	positive
sessy	positive
setlock	negative
severus	negative
sevi	negative
sevil	negative
sexbesessen	negative
sexchats	negative
sexclips	positive
sexfreundschaft	negative
sexgeiler	positive
sexparty	positive
sexsomnia	negative
sexspiele	negative
sexsüchtiges	negative
sextrieb	negative
sexyanita22	positive
sexyhexi	negative
sexylady	negative
sfx	negative
sgtrumpelforpresident	positive
sgtvallerik	negative
sh3p	positive
shabbat	negative
shanks	positive
shannon	negative
shaq	positive
sharon	negative
sharpei	positive
shatz	negative
sheba	negative
sheldoncooper	positive
shemale	positive
shemales	positive
shepert	negative
shettystute	negative
shindong	negative
shinee	negative
shinigami	positive
shira	positive
shiro	positive
shirt.	negative
shiyo	positive
shnt	positive
shopdichfit	negative
shoppingtrip	negative
shortys	positive
shou	negative
shoutout	positive
shoutouts	negative
show.	positive
showeinlage	negative
shprotte	positive
shrek	negative
shwester	positive
shä	positive
shönste	negative
siamkatze	negative
sica	positive
sicha	positive
sichst	positive
sichtbeweis	negative
sichtschutz	positive
sickhead	negative
sidebyside	negative
sidecuts	negative
siedend	positive
siedlungshaus	negative
sieghard	positive
sielen	negative
siemensmitarbeiterin	negative
siemst	negative
sie|sie	negative
siged	negative
sightseeing	negative
sihwan	positive
silikonform	negative
silla	positive
silvi	positive
silvity	positive
silviundsilvio	negative
simi	positive
sinah	positive
singha	positive
singl	negative
singleportal	positive
sinja	negative
sinnen	negative
sinnlichkeit	negative
sirt	negative
sis.	positive
sisch	negative
sistar	negative
sittenlos	positive
sitz	positive
sitzen.	positive
sitzende	negative
sitzheizung	positive
sitznachbar	positive
sjö	positive
skandalpreisen	positive
skara	negative
skat	negative
skeeter	negative
skelett	positive
skikurs	positive
skipbo	positive
skizze	positive
sklavenarsch	negative
sklavenmaul	negative
sklavenschwanz	negative
sklaventreiber	positive
sklavin	positive
skrillex.	negative
skrupellose	positive
skypem	negative
skypen.	positive
skármeta	negative
slaimon	negative
sleepover	negative
sleigher	positive
slendytubbies	negative
slughorn	positive
slushy	positive
smartie	negative
smaya	negative
smexy	positive
smokey	negative
smoothies	negative
snackbox	negative
snakebite	positive
snapback	positive
snapbacks	positive
snooki	positive
snuggery	negative
snuggie	negative
soben	negative
sobst	negative
socialentrepreneurs	positive
socialgedöhns	negative
socializen	negative
sockelleiste	negative
sockenschuss	negative
softes	negative
softie	negative
softwaretips	positive
sofäcke	negative
sogern	positive
sohappy	positive
somerhalder	positive
sommer.	negative
sommerblume	negative
sommergeschirr	positive
sommermantel	negative
sommerparty	negative
sommerpreise	negative
sommerpulli	negative
sommerschuhen	positive
sommershuhe	negative
sommersocken	negative
sommertaschen	negative
sommerurlaub	negative
sonderbonbons	negative
sonderkonstruktion	positive
sonderwunsch	negative
songzitate	negative
sonn	negative
sonnelicht	negative
sonnenaufgang	negative
sonnenbrille.	positive
sonnengruß	negative
sonnenplätzchen	positive
sonnenreichen	negative
sonnenschutzmittel	positive
sonnenschutztag	negative
sonnenstich	negative
sonningen	negative
sonnr	positive
sonnsee	negative
sonntagabend	negative
sonntagswg	positive
sonore	positive
sooonneee	positive
sooooooooooooooooooooooo	positive
sooss	positive
sorath	negative
sorgen.	negative
sorgenbrecher	negative
sorte.	negative
sortof	positive
soulfood	negative
sounde	positive
soundslikeaplan	positive
southpark	negative
sowies	positive
sowiso	positive
sozialevolontär	positive
sozialneider	positive
sozialromantikhintergrund	negative
spachtelmasse	negative
spacig	positive
spagel	positive
spaghetti	negative
spalt	negative
spamer	negative
spammercommunity	positive
spannersau	positive
spargelcremesuppe	negative
spargelcremesüppchen	negative
spargelsalat	positive
spargelsuppe	negative
sparky	negative
spars	negative
spazier	positive
speckbauch	negative
speckröllchen	negative
speculum	positive
speedo	negative
spekulum	positive
spellyournamewithrammsteinsongs	negative
spermafleck	positive
spermafotze	negative
spermaschlürfen	positive
sperrst	negative
spiegelbrille	positive
spiegelburg	positive
spiegelfoto	positive
spiegelfotos	positive
spielcharakter	positive
spieldrang	negative
spielecke	positive
spielendem	negative
spieleparadies	negative
spielerunde	negative
spielkleidung	negative
spielplatz	positive
spielzeugtelefon	positive
spießen	positive
spiiieeeellll	negative
spitzeneinsatz	negative
spitzenoberteil	negative
spitzenstoff	negative
spitzi	negative
spitzohr	positive
spitzwegerich	negative
splicern	negative
spliff	positive
splissig	negative
splittern	positive
spn	negative
spok	positive
spongbob	negative
spongebozz	positive
sport.	positive
sportacus	negative
sportbegeistert	positive
sportfreundinnen	positive
sportgeschäft	negative
sporthose	positive
sportspektakel	negative
sporttest	positive
spottlust	positive
sprachmemo	negative
sprachs	negative
sprachschub	positive
sprallo	positive
sprayende	negative
sprechender	positive
sprechstimme	positive
sprechstundenhilfe	negative
sprengstoffgürtel	negative
sprenkel	positive
sprichts	negative
springball	positive
springbrunnen	negative
spritzend	negative
sprudelliegen	negative
sprudelwasser	positive
sprössling	positive
spätschicht	negative
spühren	positive
spüler	negative
spülmaschine	negative
spülung	negative
squaw	negative
ssiges	negative
stabilos	negative
stachelschwein	negative
stadessen	positive
stadione	negative
stadtnähe	positive
stahlhelmfraktion	positive
stalkst	positive
stallgemeinschaft	negative
stammgast	negative
standgebläse	negative
standhaft.	positive
standst	positive
stange	positive
stangentanz	negative
stanze|stanzen	negative
stapfen	positive
starbucksverkäufer	negative
starbuuuuucks	negative
staskowiak	positive
statistikverbesserung	negative
statler	positive
staub.	negative
staubfänger	negative
staubwedeln	negative
staypimmel	negative
stechers	negative
stehengelassen	negative
stehenlassen	negative
stehlampenfuss	negative
steier	positive
steihert	negative
steiinoptik	positive
steinplatte	negative
steissbein	negative
stengel	positive
steppjacke	negative
sterb	positive
sterben	positive
sternchenverteiler	positive
sternen	positive
sternenmeer	positive
sternenzerstoiber	negative
sternschnuppenregen	negative
steuerrad	negative
steuerwahlkampf	negative
stewardess	positive
sticke	negative
stiefdad	positive
stiefelabsatz	negative
stiefelette	negative
stiefpapi	positive
stielkamm	positive
stift|stiften	negative
stilikonen	negative
stillen	negative
stillkissen	positive
stillst	negative
stimmfang	positive
stimmung	positive
stimmungsschwankung	negative
stinkend	positive
stinkt.	positive
stirn	negative
stirnküsse	negative
stockdunkle	positive
stockschirme	negative
stoff	positive
stofffarbe	negative
stoffhose	negative
stofftasche	negative
stoffübertragung	positive
stolziere	positive
storken	positive
stormcloud	negative
stormtrooper	negative
stotterst	negative
stowasser	positive
straciatella	positive
strandbad	negative
strapon	positive
strapshalter	positive
strassapplikation	negative
strassenband	positive
strassenhund	positive
strassenmusikerin	negative
strassenschuh	positive
strassenseite	positive
strasssteinen	positive
streitest	negative
streitlustig	negative
stress.	positive
stresse	negative
stretchkleid	positive
streunen	negative
strickliese	positive
stricknadel	positive
strickst	negative
stricktreffen	negative
strick|stricken	negative
strippenschlüpper	negative
strumphose	negative
stubenrocker	negative
stubentieger	negative
studienaufgaben	negative
studio.	positive
stuecke	negative
stuie	negative
stumm	negative
stummel	negative
stupse	negative
stupser	positive
sturmmaske	positive
sturr	negative
stute.	positive
styl	negative
styla	positive
stylecheck	positive
stylis	negative
stylistin	positive
ständer	positive
stängelchen	positive
stéphanie	negative
stöbere	negative
stöbern	negative
stöckel	positive
stöhne	positive
stöpsel	negative
störrisch	negative
suchspiel	positive
suchtet	negative
suchtii	negative
sucy	negative
suess.	positive
suezz	negative
sufen	negative
suffie	negative
suffköppe	positive
suhlen	negative
suizidwelle	positive
sulzmann	positive
sunshine	negative
supeeer	positive
supeerrr	positive
superfan	negative
superheldenkostüm	positive
superhübsch	negative
superhübsche	negative
supermann	negative
supernatural	negative
supernettes	negative
supersonniges	positive
supersüssen	positive
supersüsses	positive
superweicher	negative
supporten	negative
surferboys	positive
surp	negative
surreal	negative
surrealen	positive
susannah	negative
sushi.	negative
sushibar	negative
suspektesten	positive
suuuu	negative
suuuuss	positive
svend	positive
svene	negative
swaaaaag	negative
swagg	positive
swaggt	negative
swaghetti	positive
sweatshirt	negative
sweeett	positive
sweetdesire	positive
sweetsteffi001	negative
sweetsusi	negative
sweetsusinrw	positive
swiet	positive
swingerpärchen	positive
swäääg	positive
sylvester	positive
sylvi	negative
szenig	negative
szu	positive
säbel	negative
sächlich	negative
sächsilüüte	negative
sänger	negative
säufst	negative
säxie	positive
söhnchen	positive
sösschen	negative
süb	negative
südgarten	negative
südlage	positive
südländisch	negative
süffelt	negative
süffig	negative
süse	positive
süssee	negative
süssenbach	negative
süssigkeitenvorrat	positive
süsskartoffel	positive
süsslichkeit	negative
süssling	negative
süz	negative
süüüsss	positive
taaaag	negative
tabaluga	positive
tabby	positive
tablett	positive
tachchen	positive
tacken	negative
tafelwerk	negative
taff	positive
tag.	positive
tagebart	negative
tagebuch.	negative
tagesausflug	negative
tagescafe	negative
tagesfreizeit	negative
tageslichtlampe	positive
tagesm	positive
tagesrhythmus	negative
tagesweise	positive
tagsforlikes	negative
tagwach	positive
tag♥	negative
takehito	negative
takkatukkaland	negative
talentierti	positive
talkshowreifer	positive
tam.	negative
tammara29	negative
tampopo	negative
tandempartner	negative
tanktops	positive
tannebaum	positive
tannenzäpfle	positive
tanu	negative
tanzet	positive
tanzindenmai	positive
tanzmoves	positive
tanzst	positive
tanzstudenten	positive
tanztraining	positive
tapezierarbeit	positive
tarnklamotte	positive
taschen.	negative
taschenaschenbecher	positive
taschenuhr	negative
tasern	negative
tasu	positive
tatkräftig	positive
tatscht	positive
tattoomodel	negative
tattoos.	negative
tattootermin	negative
tattop	negative
tauchbecken	negative
taufe	negative
taurig	negative
tauschkarten	positive
tauschmutter	negative
tavuk	negative
taxifahrer	negative
tbpafk	positive
teaist	negative
teamaufbau	positive
teamtea	positive
teasen	positive
technikbegeistert	negative
technoschuppen	negative
teddys	positive
teebaumöl	positive
teeglas	positive
teeniefreundin	positive
teenygirl	positive
teenygirls	negative
teetisch	positive
tehma	positive
teier	negative
teigfladen	negative
telefoieren	positive
telefonbuch	negative
telefonierender	negative
telekomprobleme	negative
telekomshops	negative
telephonieren	positive
teletubbie	negative
teller	positive
tellerrock	positive
tellytellz	negative
telt	negative
temperamentbündel	positive
tenimyu	positive
tennie	positive
tennissocken	negative
tensor	positive
tentakeln	negative
teppat	positive
teppich.	positive
teppichmesser	negative
terrarianer	negative
terrarientiere	negative
terrassentür	negative
terrassenüberdachungen	negative
terzett	negative
testwelt	negative
teufelshörnern	negative
teufelsküche	negative
tews	positive
textcontainer	positive
textilgarn	negative
textnachrichten	positive
thai	negative
thaigirl	positive
thailänderin	negative
thaimodelle	negative
theaterpädagogin	positive
thefaculty	negative
thehehe	positive
thehidden	negative
thekohas	positive
theoneandonly	negative
theredcubetv	negative
therese	positive
thermalbad	positive
thommy	positive
thresen	negative
thunersee	negative
thunfisch	positive
ticked	negative
tief.	negative
tiefkühlerbsen	negative
tiefkühlpizza	positive
tierapotheke	positive
tierdokus	positive
tiergifs	negative
tierkostümen	negative
tiermensch	negative
tierohren	negative
tiggi	negative
tihihi	negative
tiia	positive
tim	negative
timberlands	positive
timelord	positive
timon.	negative
tini	positive
tintenfass	negative
tintenherz	negative
tipp.	positive
tiramisu.	negative
tischbein	positive
tischgebet	negative
tischlampe	negative
titkoja	positive
titschen	negative
tittchen	negative
tittenava	negative
tittenbesamung	positive
tittenmassage	positive
tkhh.	positive
tkotsch	negative
toastbrot	positive
toasty	positive
toblerone	positive
tobsuchtsanfall	positive
tockner	negative
todeskater	positive
todesmüde	positive
toilettentür	negative
toki	negative
tokiohotelthanksfollowspree	positive
tolga	positive
tollige	positive
tollpatschigen	positive
tomatenbrotparty	positive
tomatig	positive
tonni	negative
tonstudio	negative
toolll	negative
tooool	positive
tooooodes	negative
topf	positive
topfenpalatschinken	negative
topmodel	negative
torchwood	positive
torso	positive
tot.	negative
totknuddeln	positive
totkrank	positive
toupieren	positive
toupiert	positive
tourgeschenk	negative
trabireiter	negative
tragegefühl	negative
trainingsanzug	positive
trainingspartnerin	negative
trainingsraum	negative
tralala	positive
tralalala	positive
trampeltier	negative
trannen	positive
transsexuelle	negative
trashig	negative
trashiger	negative
trashnight	negative
trashtazmani	negative
traube	positive
trauen	negative
trauern.	negative
trauerweide	positive
traumgebilde	positive
traumhaus	positive
traumleben	negative
traumpirat	negative
traumpärchen	negative
traumschaum	negative
traumschuhe	positive
traumwetter	negative
trauring	positive
trauum	negative
trebs	positive
trekkingtour	positive
trenchcoat	negative
trendigen	positive
trendsetter	positive
tret	negative
trette	negative
treuherzig	positive
triam40	positive
tribulations	negative
tribühne	positive
tribünendach	positive
triforce	negative
trilby	positive
trinkgeld	positive
trinkt.	negative
trinkwalder	negative
triumphierend	negative
trockenfleisch	negative
trockenfrucht	negative
trocknen	positive
trocknen.	negative
trocknungsgerät	negative
trollfrei	positive
trolololo	positive
trolololol	positive
trololololololo	negative
trommelfloh	negative
trommel|trommeln	negative
trossdem	negative
trostpreis	positive
trotzdem.	positive
trotzden	positive
troya	positive
troztem	negative
trug	negative
trulle	positive
trunken	negative
trunki	negative
trz.	negative
trägershirt	positive
trägertops	negative
träinen	positive
träne	positive
träumer	negative
trödler	positive
tröhnung	negative
tröstetest	positive
trüb	negative
trüstory	negative
tsatsiki	negative
tschaui	negative
tschuldige	positive
tschöö	positive
tschüs	positive
tschüüüs	negative
tsumiki	positive
tsuzuku	negative
tuerkis	positive
tumblr.	negative
turino	negative
tuscolo	negative
tuss	negative
tussen	negative
tussige	positive
tute|tuten	negative
tvd.	negative
tvk	negative
tvtotal	negative
twafl	positive
tweers	negative
tweetinspiration	negative
tweets	positive
tweets.	positive
twelite	negative
twewy	negative
twibas	negative
twink	positive
twitcams	positive
twitlonger	negative
twittbürger	positive
twitterabstinent	negative
twitteraccount	negative
twitterapp	negative
twitterbar	positive
twitterbio	negative
twittere	positive
twittere.	negative
twittererin	negative
twittergemeinde	positive
twitterianer	positive
twitterinen	positive
twitteristas	negative
twitterlink	negative
twitternamen	negative
twitterprofil	positive
twitterpärchen	positive
twitterrunde	negative
twittertreffen	negative
twitterwelt	positive
twittreim	negative
twonn	negative
tws	negative
typie	negative
typn	negative
tyra	positive
tyrion	positive
tz.	negative
tzatziki	positive
tzaziki	negative
tztztz	positive
tzz	negative
tzzz	positive
täc	positive
tätet	negative
tättowierten	positive
täume	negative
täusch	negative
töfftöff	negative
tölen	positive
töted	positive
tövbe	negative
tøsen	positive
tüdelü	positive
tüdelüü	negative
tünchen	positive
türenkaufen	positive
türkisblau	positive
türklinke	positive
türks	negative
türrahmen	negative
türramen	positive
türsteher	negative
ubd	positive
udn	positive
uffgeregt	negative
ufgwacht	negative
ufruume	positive
ugly	positive
uhhi	positive
uhm	negative
ukelele	positive
ukulele	positive
ullmann	positive
ultracool	positive
ulzzang	positive
um3	negative
umarmen.	positive
umarmt	negative
umbringen.	positive
umdrehn	positive
umenand	positive
umflausch	negative
umgekleidet	negative
umgerannt	positive
umgän	positive
umgürten	negative
umhängetasche	negative
umkippen	positive
umme	positive
umpacken	negative
umschmiegen	negative
umschnall	positive
umschnalldildos	positive
umsich	positive
umsichtig	negative
umsorge	positive
umzugskiste	negative
umzugsstress	positive
unaktiv	negative
unangenehm	negative
unansehnlich	positive
unaufgeräumten	negative
unbedarft	negative
unbehaart	negative
unbehaartes	negative
unbequem	negative
unbescholte	positive
unbeschreiblich.	negative
unbeschrieblich	negative
unbeweglich	negative
uncoole	positive
unddann	negative
undon	positive
undurchsichtig.	positive
uneigennützig	positive
uneinsichtig	positive
unerfreulich	negative
unfallambulanz	positive
unfollowen	negative
unfreundliche	negative
ungarin	positive
ungelogen	negative
ungeniert	positive
ungesund	negative
ungeziefer	negative
ungezogen	positive
ungeübt	positive
ungleichmässig	negative
unglücklich	negative
ungschminkt	positive
ungwohnt	negative
ungünstig	negative
unhuman	negative
uniformjacke	negative
unikat	negative
universalist	negative
universalmedizin	positive
universitätsstadt	negative
unizeug	negative
unizeugs	negative
unkommunikativ	negative
unkompliziertem	positive
unkpomplizierte	negative
unmac	negative
unnerbux	positive
unormal	negative
unrecht	negative
unromantischste	positive
unschlüssig	positive
unschön	negative
unsoo	negative
unspektakulär	negative
unspektakulärer	negative
unterfickt	negative
untergebener	negative
unterholz	positive
unterhöschen	negative
unterkuschelt	negative
unterlegen	negative
untermotorisiert	positive
unterricht	positive
unterstüzung	negative
untersuchungsheft	positive
untersuchungszimmer	negative
unvernünftig	negative
unvollkommenheit	negative
unwiderstehli	positive
unwiederstehlich	negative
unwissend	negative
unwitzig	positive
unzufriedenes	negative
unästhetisch	negative
uphoff	negative
upsi	negative
urgh	negative
urgot	positive
urinieren	positive
urlaubenden	negative
urlaubsabschluss	negative
urlaubsende	negative
urlaubsfeeling	negative
urlaubsland	negative
urlaubsort	positive
urlaubsziel	negative
urmel	positive
urplötzlich	negative
ursprungsfrage	negative
usak	negative
usdruck	negative
userdate	negative
uuhh	negative
uuuuunglaublich	negative
uzi	positive
vaan	negative
vaginas	negative
vahr	negative
valldemossa	positive
vampir	negative
vampsisters	positive
vanillefarben	negative
vanillekipferl	positive
vanilleschote	positive
vanillezucker	negative
varys	positive
vase	negative
vaseline	positive
vatter	positive
vatti	positive
vegetarierin	positive
velolove	positive
veloursleder	positive
velut	positive
vemisst	negative
vendola	negative
vene	positive
ventilator	negative
verabscheuen	negative
verarschst	positive
verbarrikadieren	positive
verbeißen	negative
verbeug	negative
verbingen	negative
verbittern	positive
verblenden	positive
verblichen	positive
verblute	positive
verdamm	positive
verdauungs	positive
verdiens	negative
verdirb	positive
verdorben	negative
verfi	positive
verfic	positive
verfickten	positive
verfluchen.	negative
verfärben	negative
verführun	negative
vergammel	positive
vergewaltiger	positive
vergnügst	negative
verhauen	positive
verhexen	negative
verhungert	positive
verhätscheln	positive
verhült	negative
verkauffe	positive
verkaufsfähig	positive
verkehrtrum	positive
verkleidest	positive
verknall	positive
verknalle	negative
verknallt	positive
verknallt.	positive
verkopfter	positive
verkriechst	positive
verkuschelt	negative
verkühlung	positive
verlangem	negative
verlauft	positive
verletzend	negative
verliebst	negative
verliebtem	negative
verliebtsein	negative
verliehrt	negative
vermagst	negative
vermesse	positive
vermissed	positive
vermissse	negative
vermisst.	positive
vermittlugnsgarantie	positive
vermut	negative
vernageln	negative
vernebelt	positive
verneig	positive
vernunftbegabt	negative
vernüftigen	positive
verpartnern	positive
verpeilt.	negative
verpeilter	negative
verpenn	negative
verpennen	negative
verpennt	positive
verpixelt	negative
verplanter	positive
verrafft	negative
verregnen	negative
verruckte	negative
verrufen	negative
verrücktesachenmachenwennmanverliebtist	negative
versaue	negative
versaute	negative
versautheit	positive
verschimmelt	positive
verschinden	negative
verschisse	positive
verschleimen	negative
verschollen	negative
verschonst	negative
verschroben	positive
verschwörungstweet	positive
versengen	positive
versicherungstyp	positive
versiffte	positive
verslein	positive
versorgst	negative
verspeisen	negative
versprechs	positive
verstaden	positive
verstecken	negative
verstehen	positive
versteinern	negative
verstochen	negative
verstritten	positive
verstöre	negative
versüssung	negative
vertilg	positive
vertrauensvoll	negative
vertreib	negative
vertrocknen	positive
verwandt.	positive
verwanschaft	positive
verweilen	positive
verwohne	negative
verwuscheln	negative
verwöhnpension	negative
verwöhnprogramm	negative
verzehrst	negative
verzichte.	negative
verziehn	positive
verziere	negative
verzierung	positive
verzweifelter	negative
verächtlich	negative
veräppelt	negative
verückter	negative
vesperbox	positive
viadreams	negative
vici	negative
vid	positive
videoantwort	positive
videoantworten	positive
videodreh	negative
videooo	negative
videopost	negative
videoproducer	negative
videowunsch	positive
vidos	negative
viech	positive
viedo	negative
vieeeeele	positive
vieeeele	negative
vielfarbig	negative
viellt	negative
vielmal	positive
vielosovie	negative
vierteilen	positive
viertklassigen	positive
viiiiiielen	negative
vika	positive
viki	positive
vild	negative
vileicht	negative
vilt	positive
vinny	negative
virl	negative
virld	negative
visagistic	positive
viserys	negative
viu	positive
vladimir	negative
vll.	negative
vodka	positive
vogelbad	positive
vogelnest	positive
vogelspielplatz	negative
vogeltränke	positive
vogelwilde	negative
voher	positive
volant	negative
voldemorts	negative
voldi	negative
volksvertret	negative
vollbaggern	negative
vollblut	negative
vollgeil	positive
vollgewichst	negative
vollglatze	negative
vollgranate	positive
vollhorst	negative
vollkeller	negative
vollkommen	positive
volllabert	positive
vollschaden	positive
vollspammen	negative
vollspast	negative
vollspastis	positive
vollstopfen	positive
volltrottel	positive
voltaren	negative
voollll	negative
vorabbewertungen	negative
voract	positive
vorahnung	negative
vorband	negative
vorbeibringst	negative
vorbeigehen	positive
vorbeischaun	negative
vorbeiziehen	positive
vorbestellt.	negative
vorbild♥	negative
vorderpfote	positive
vorgespräch	negative
vorglühen	positive
vorgruppe	positive
vorhut	negative
vorhängeschloss	negative
vorkeimen	negative
vorkochen	positive
vorm	negative
vormittag	positive
vornehmt	negative
vornimmst	negative
vorsingen	negative
vortanzen	negative
vortragsmitschnitt	positive
votest	positive
votzen	negative
voyeur	negative
vr100	negative
vreni	negative
vuw	negative
vzm	positive
vöegel	positive
völkchen	negative
vöu	negative
w23	positive
waaaaah	positive
waaaaas	positive
waaaah	positive
waaahahaha	negative
wachsmalkreide	negative
wachtel	negative
wackeldackel	positive
wackelpudding	positive
wade	positive
waffenschein	negative
waffentechnisch	positive
wagemutig	negative
wahlkabinen.	positive
wahnsinng	positive
wahnsinns	positive
wahr.	positive
waixrparty	negative
wakame	negative
waldesrand	positive
waldfrucht	negative
walnussbaum	positive
walther	negative
wambir	positive
wand.	positive
wandbild	negative
wandelbar	positive
wandern	negative
wanderurlaub	positive
wandhänger	positive
wandschrank	negative
wandsetal	negative
wandverkleidung	negative
wannebe	positive
wardinator	positive
ward’s	negative
warlander	negative
warn.	positive
wartee	negative
wartesaal	negative
wart|warte|warten	positive
waschbecken	negative
waschen.	negative
waschpulver	negative
waschsalon	positive
wasser.	positive
wasserbad	positive
wasserkaskaden	positive
wasserkocher	negative
wassermarke	negative
wassern	positive
wasserschlauch	positive
wasserstrahl	positive
watschte	negative
wattebauschen	negative
waxing	negative
wazzup	negative
we	positive
webcamchat	negative
webcamfotos	positive
webdesignerin	negative
webperlen	positive
wechselringe	positive
wecker	positive
weckton	positive
wedelst	positive
weed	negative
weeden	negative
weeil	negative
weg.	negative
wegat	negative
wegb	negative
wegbier	negative
wegbringen	negative
wegbringen.	positive
weger	positive
wegessen	negative
weggeboxt	positive
weggefeiert	negative
weggehn	negative
weggeleckt	negative
weggesetzt	positive
weglasern	negative
wegnehm	negative
wegpennen	negative
wegratzen	negative
wegziehen	negative
wehmütig	positive
wehst	positive
weht.	positive
weibas	negative
weibisch	negative
weibsbild	negative
weichzeichnen	positive
weihnachtsfest	negative
weiiiiiiss	positive
weilichskann	negative
wein.	positive
weindorf	negative
weinende	negative
weinkeller	positive
weinkenner	positive
weinstrasse	positive
weintest	negative
weirdo	positive
weish	positive
weisheit.	positive
weissbauch	positive
weissbier	negative
weissesr	negative
weiteer	negative
weitergepennt	positive
weitermachen	negative
weiterschicken	positive
weiterschlendern	negative
weiterschrauben	negative
weiterträumen	positive
wellensitische	positive
wellnessmassage	negative
wellthatescalatedquickly	negative
welpenfotos	negative
weltfrieden	negative
weltreise	positive
weltschönste	negative
welzweit	positive
wendebikini	negative
wengal	negative
wenigst	negative
wennigstens	positive
wennihrmichimrlkennenwürdet	positive
wenn’s	negative
wer	positive
werbayernmünchenmag	positive
werbebude	positive
werbegeschenk	negative
werbeidee	negative
werdest	positive
werdi	positive
werkstat	negative
werst	positive
wertigem	positive
wertschätzt	negative
werweisswieviele	negative
westi	negative
westpaket	positive
wetlook	positive
wetterkerze	negative
wetterservice	positive
wetterumschwung	negative
wetterunabhängig	positive
wettr	negative
wgds	positive
wgler	positive
whaaay	negative
whack	negative
whateva	negative
whatsappnachrichten	negative
whatwhat	positive
wheeey	negative
whelan	positive
whg	positive
whoa	negative
whäää	negative
wic	negative
wichsern	positive
wichskinder	positive
wichtig	positive
wichtiig	positive
wickeltuch	positive
wickie	positive
widde	positive
widerlich	negative
widerspenstig	positive
widerwärtig	negative
wie.	negative
wiedee	negative
wiedergebären	negative
wiedermal	positive
wiedersehen	positive
wiedl	positive
wiets	positive
wievielt	negative
wigs	positive
wigwam	negative
wihuu	positive
wiiiiie	negative
wild.	positive
wilden.	negative
wildernder	negative
wildfa	negative
wildfang	positive
wildfarben	positive
wildreis	negative
wildstylez	negative
will.	negative
willauch	negative
willem	negative
willkommem	negative
wills	positive
windstill	negative
winken.	negative
wintergrippe	positive
winterklamotte	negative
wintermüde	negative
winterpulli	positive
winterschlaf	positive
winterseite	negative
wintersocke	positive
wintersonne	negative
winterspeck	positive
wintertraining	negative
wintervorzelt	negative
winti	negative
winzermeister	negative
winzigkeit	negative
wir.	negative
wirktest	negative
wirliebenmariogötze	positive
wirs	negative
wirsch	negative
wirtschaftslehrer	negative
wischmob	negative
wischmop	negative
wishfullthinking	negative
wisoo	negative
witz	negative
witzebuch	positive
witzfigur	positive
witzige	positive
wiviele	positive
wixe	negative
wixx	positive
wixxe	negative
wixxen	negative
wixxer	negative
wixxxen	negative
wiä	negative
wkwkkwkwk	negative
wloka	negative
wneig	negative
woaa	negative
woahhhh	positive
wochen	negative
wochenede	positive
wochenenddomizil	negative
wochenendeende	positive
wodi	positive
wodkaflasche	positive
woggy	positive
wohaa	positive
wohlschmeckend	positive
wohndecken	negative
wohnkabine	negative
wohnland	positive
wohnor	negative
wohns	negative
wohnug	negative
wohnzimmerwand	negative
woistolivia	negative
wolfskopf	negative
wolke.	positive
wolkenfreier	negative
wolkenweiss	negative
wollknäule	negative
wolllust	positive
wollmäusen	positive
wollns	negative
wollt.	positive
wolten	positive
woltl	positive
wommy	positive
wonderwall	negative
wonderwoman	negative
woodkid	negative
wooooah	negative
wordpressseite	negative
wordwar	positive
worsnop	negative
worterkennung	positive
wortgewandtheit	negative
wrklich	positive
wtf.	positive
wuchenend	negative
wuddeln	negative
wukk	negative
wulli	positive
wunde	positive
wundebar	negative
wunderbaaar	negative
wundercreme	negative
wunderherrlichen	positive
wunderhund	positive
wundern	negative
wunderschöner	negative
wunderschööööön	negative
wundeschön	negative
wundeschöner	positive
wunschhalsband	positive
wunschoutfit	negative
wunschsongs	negative
wurscht	negative
wurstfachverkäufer	positive
wurstfinger	negative
wurstfingern	negative
wurstpelle	positive
wurzelimperium	positive
wuscheliger	negative
wuseln	negative
wuselnde	positive
wushi	negative
wusstes	negative
wutwürstchen	negative
wutze	negative
wwm	positive
wwmöhring	negative
wynona	negative
wàre	negative
wã¼rdest	positive
wäddää	negative
währenddem	positive
währst	positive
wälde	positive
wärdet	negative
wäri	positive
wärsch	positive
wärste	positive
wäscheberg	negative
wäschespinne	positive
wäscheständer	negative
wää	positive
wäääh	positive
wúnsche	negative
wûrde	negative
wünderschönen	positive
wüns	negative
wünscg	negative
wünsh	positive
wür	negative
würet	positive
würfele	positive
würgreiz	positive
würsch	positive
würschtel	negative
würstchenverkäufer	negative
würstchenwasser	negative
würzmischung	negative
x215cm	negative
x3333	positive
x333333	negative
xdich	negative
xdxd	positive
xih	positive
xs	negative
xt9	negative
y'know	negative
yagma	positive
yamada	positive
yamyam	negative
yaycon	negative
ye	positive
yeaaaa	positive
yeahhhhhhhh	positive
yeeay	positive
yeeear	positive
yeeeey	negative
yeehaaa	negative
yey	positive
ylva	positive
ymca	positive
yoda	negative
yogurt	negative
yolobitch	positive
yololatte	positive
yolomässig	negative
yongguks	positive
yosha	negative
youarebeautiful	negative
youngmin	negative
youtubern	positive
yupii	positive
yuppies	negative
yuri	negative
yutaka	negative
yäy	positive
yüäär	positive
z'schaffe	negative
zackzack	negative
zahlschwein	positive
zahlschweinchenausbildung	negative
zahnartzt	negative
zahnarzt.	positive
zahnbürsten	positive
zahncreme	negative
zahnspangen	negative
zahnstange	negative
zahnärzten	positive
zander	negative
zapfen	negative
zarindast	negative
zartbitterschokolade	positive
zauberfee	negative
zauberhaftigst	positive
zauberwald	positive
zaungast	negative
zayns	negative
zazabrooklyn	positive
zaziki	positive
zdz	positive
zeh	negative
zehenlutscher	negative
zehensocken	positive
zehnergruppe	negative
zeichentrickfigur	positive
zeigefinger	positive
zeih	negative
zeiit	negative
zeinfeld	positive
zeitanzeige	positive
zeitlupenknopf	negative
zeitverständnis	positive
zellennachbar	positive
zelten	positive
zeme	negative
zempin	negative
zerdrücke	negative
zerfetzen	negative
zerfickt	negative
zeri	positive
zerkratzen	negative
zerkratzt	negative
zerlegst	positive
zermatscht	negative
zermatschte	positive
zermatschtes	positive
zerplatzen	negative
zerren	negative
zerst	positive
zerstechen	positive
zerteil	positive
zertreten	positive
zerwuschelt	negative
zettel	negative
zeuch	negative
zeugen	positive
zeybek	positive
zicke.	positive
zickende	positive
ziegenbart	negative
ziegenbärtchen	negative
ziehn	negative
ziemlich	negative
ziernaht	negative
zigarettenrauch	positive
zigarreten	positive
zigeunerin	negative
ziischtig	positive
zimmerboy	negative
zimmerbrunnen	positive
zimmerfrei	negative
zimmernummer	positive
zimmerwand	positive
zimt.	negative
zinha	negative
zisammen	positive
zischtig	positive
zite	positive
zitronencreme	positive
zitronenduft	negative
zittern	negative
zmüed	negative
zockst	positive
zockt	positive
zombi	positive
zombieaugen	negative
zombiefilm	negative
zombiegeschichten	negative
zoobesuch	positive
zrugg	positive
zuahsü	positive
zuballern	negative
zubeißen	negative
zuchtstute	negative
zuckerglasur	negative
zuckerherz	negative
zuckertüte	negative
zuckriger	positive
zuckst	positive
zudröhnen	negative
zufahrtstrasse	negative
zug	positive
zugekniffen	negative
zugeknöpft	positive
zugerotzt	positive
zugfahren	positive
zuggewicht	negative
zugig	positive
zuha	negative
zukreischen	positive
zukriegen	positive
zulenken	positive
zumute	positive
zungenbändchenpiercing	negative
zupfer	negative
zureiten	positive
zurennt	negative
zurúck	negative
zurückgrüßen	positive
zurük	negative
zusammen.	negative
zusammenfalten	positive
zusammenpacken	positive
zusammenpassend	positive
zusammenquetschen	positive
zusammenschmeisst	positive
zuschauerin	negative
zuschmeissen	negative
zuspamt	positive
zutraul	positive
zuu	positive
zuver	positive
zuvergessen	negative
zuverlässi	negative
zuziehst	positive
zvväggg	negative
zweiohrküken	negative
zweitens	positive
zweitlieblings	positive
zweitschön	positive
zweitwohnung	positive
zweizimmerwohnung	negative
zwergdackelwelpen	positive
zwerghase	negative
zwergrex	negative
zwergschecken	positive
zwergwidder	negative
zwetna	positive
zwick	negative
zwiebellook	positive
zwiebelmett	negative
zwiebelrostbraten	positive
zwiebelsaft	negative
zwille	positive
zwilling.	positive
zwillis	positive
zwitschern.	positive
zwitschernd	positive
zwulf	positive
zwängen	positive
zzf4	negative
zzzz	positive
zämme	positive
zärtliche	positive
zündest	negative
zürichsee	negative
den	positive
°a°	positive
°°	negative
ä3	negative
äcon4	positive
äglichen	negative
ägypterin	positive
ähhhhhhhh	positive
ähmm	negative
ähnlichkeit	negative
ähnlichkeiten	negative
ähwas	positive
ält	negative
ärmellos	negative
ättetes	negative
äugigen	negative
äußerlich	positive
äähh	positive
ääähm	positive
çay	positive
êe	negative
ò	negative
òaó	positive
öhhhm	positive
öhm	positive
öjendorf	positive
ökobox	positive
übel	negative
überall	negative
überanstreng	negative
überbezahlter	negative
überdimensional	positive
überdrehter	negative
übereinande	positive
überfahren	positive
überfliegst	negative
überfressen	positive
überfüllen	positive
überfüllt	negative
übergeb	positive
übergeilen	positive
übergewichtig	positive
überhäuf	positive
überhäufen	positive
überlegen	positive
überlegs	positive
übernacht	positive
überra	negative
überragend	positive
überraschungsbesuche	negative
überraschungsparty	positive
überrock	negative
überrumpeln	positive
überschminke	negative
überstehen	negative
überstundenabbau	positive
übertreib	positive
überweisungszweck	negative
überwältigt	positive
überzeugende	positive
üppig	positive
üsere	negative
ütendorf	negative
üübel	negative
ړײ	negative
‘digga’	negative
‘elite’	negative
‘hast	positive
‘nem	positive
’nem	positive
▓	negative
▲	positive
☀☀	positive
☀☀☀☀☀	positive
☆☆	negative
☕☕☕	negative
☺das	positive
♥kostenlos	positive
♥lich	positive
♥liebe	positive
♥♡♥affenstarke	positive
♥♡♥♡	negative
♪	negative
✋👋✋👋🚙💨	negative
✌✨	negative
❄⛄	negative
❣	positive
❤liche	negative
❤❤❤❤❤❤❤	positive
❤👌	positive
⭐	positive
《3	negative
	negative
＞es	negative
🍀	negative
🍄	positive
🍕	negative
🎀	positive
🎉	negative
🐒	negative
🐥	positive
👏👏👏	negative
👗	positive
👶❤	positive
💇	positive
💏	positive
💗❤	positive
💛☀✨	positive
💰💰💰	negative
📷	positive
😳	negative
🙉	positive
🚬	positive
🚻mit	positive
