unrecht	negative
schlecht	negative
gemein	negative
ungünstig	negative
mangelhaft	negative
unangenehm	negative
misslich	negative
negativ	negative
dürftig	negative
unglücklich	negative
bedauernswert	negative
böse	negative
übel	negative
ekelhaft	negative
nachrangig	negative
irrig	negative
unterlegen	negative
verdorben	negative
scheusslich	negative
hässlich	negative
widerwärtig	negative
minderwertig	negative
armselig	negative
ekelerregend	negative
schlimm	negative
arm	negative
widerlich	negative
schädlich	negative
unerfreulich	negative
fies	negative
falsch	negative
geringwertig	negative
teuflisch	negative
dämonisch	negative
diabolisch	negative
satanisch	negative
lieb	positive
freundlich	positive
überlegen	positive
richtig	positive
positiv	positive
korrekt	positive
hübsch	positive
besser	positive
nett	positive
glücklich	positive
ausgezeichnet	positive
überragend	positive
sauer	negative
verletzt	negative
schwarz-weiss-fotografie	positive
schwarzweissfotografie	positive
pikiert	negative
gekränkt	negative
beleidigt	negative
eingeschnappt	negative
schwarzweissfoto	positive
schwarzweissbild	positive
schwarz-weiss-bild	positive
schwarz-weiss-foto	positive
entwürdigend	negative
boshaft	negative
bös	negative
niederträchtig	negative
feig	negative
hinterhältig	negative
hämisch	negative
maliziös	negative
süffisant	negative
hündisch	negative
böswillig	negative
hasserfüllt	negative
stiefmütterlich	negative
mau	negative
dia	positive
polaroid	positive
diapositiv	positive
diabild	positive
sofortbild	positive
polaroidbild	positive
polaroidfoto	positive
lichtbild	positive
ruchbar	negative
schnöde	negative
unversöhnlich	negative
vorwurfsvoll	negative
nutzlos	negative
aggressiv	negative
jämmerlich	negative
kümmerlich	negative
unnütz	negative
elendig	negative
erbärmlich	negative
elend	negative
flau	negative
einzelbild	positive
nichtsnutzig	negative
unnützlich	negative
angriffslustig	negative
kampfeslustig	negative
kampflustig	negative
farbfoto	positive
themenfoto	positive
farbaufnahme	positive
pressephotographie	positive
pressefotografie	positive
farbbild	positive
themenfotografie	positive
themenphotographie	positive
pressefoto	positive
porträtbild	positive
gruppenaufnahme	positive
gruppenbild	positive
schädigend	negative
abträglich	negative
hetzerisch	negative
aufwiegelnd	negative
aufhetzend	negative
demagogisch	negative
faul	negative
mephistophelisch	negative
luziferisch	negative
ungerecht	negative
einzelfoto	positive
gruppenfoto	positive
zänkisch	negative
zanksüchtig	negative
streitsüchtig	negative
infernal	negative
farbphotographie	positive
archivbild	positive
fahndungsfoto	positive
satellitenfoto	positive
satellitenbild	positive
werbephotographie	positive
archivfoto	positive
fahndungsbild	positive
farbfotografie	positive
werbefotografie	positive
giftig	negative
zwecklos	negative
destruktiv	negative
matt	negative
toxisch	negative
zerstörerisch	negative
umweltschädlich	negative
gesundheitsschädlich	negative
gesundheitsschädigend	negative
umweltschädigend	negative
schade	negative
bedauerlich	negative
zweckfrei	negative
unzweckmässig	negative
mistig	negative
oll	negative
ätzend	negative
offensiv	negative
unvorteilhaft	negative
unverträglich	negative
draufgängerisch	negative
gehässig	negative
provokativ	negative
provozierend	negative
bissig	negative
regulär	positive
aktfoto	positive
screenshot	positive
zielfoto	positive
schnappschuss	positive
papierabzug	positive
röntgenbild	positive
detailaufnahme	positive
digitalfoto	positive
erinnerungsfoto	positive
negativbild	positive
negativaufnahme	positive
unfair	negative
sinnlos	negative
unsinnig	negative
bitterböse	negative
erbost	negative
fleissig	positive
modephotographie	positive
modefotografie	positive
vorschriftsmässig	positive
ordnungsgemäss	positive
regelgemäss	positive
regelgerecht	positive
vorschriftsgemäss	positive
wertlos	negative
dahergelaufen	negative
herausfordernd	negative
kriegerisch	negative
streitlustig	negative
geschäftsschädigend	negative
anoxisch	negative
ruinös	negative
parteischädigend	negative
rufschädigend	negative
kontraproduktiv	negative
misslungen	negative
statutengemäss	positive
wortlautgemäss	positive
satzungsgemäss	positive
wortgemäss	positive
tückisch	negative
unfreundlich	negative
schwindlig	negative
fotografie	positive
ablichtung	positive
abzug	positive
unehrenhaft	negative
abgeschlagen	negative
fotoprint	positive
foto	positive
positivbild	positive
beknackt	negative
bescheiden	negative
unschädlich	positive
erledigt	negative
missraten	negative
unglückselig	negative
ehrlos	negative
scheiss	negative
beschissen	negative
lausig	negative
stümperhaft	negative
ungut	negative
unakzeptabel	negative
grottig	negative
inakzeptabel	negative
schäbig	negative
dilettantisch	negative
miserabel	negative
unschön	negative
bruchstückhaft	negative
fragmentarisch	negative
bruchstückartig	negative
bemitleidenswert	negative
beklagenswert	negative
befehlsgemäss	positive
normgemäss	positive
bestimmungsgemäss	positive
peinlich	positive
schwarz	negative
ekel erregend	negative
penibel	positive
betriebsam	positive
geschäftig	positive
agil	positive
förmlich	positive
pedantisch	positive
unedel	negative
amoralisch	negative
fälschlich	negative
irrtümlich	negative
schuldig	negative
sinnvoll	positive
sinnig	positive
tüchtig	positive
glücklos	negative
ungeeignet	negative
chancenlos	negative
erfolglos	negative
ergebnislos	negative
beispielhaft	positive
emsig	positive
eifrig	positive
arbeitsam	positive
popelig	negative
poplig	negative
edel	positive
arbeitswillig	positive
mustergültig	positive
vorbildhaft	positive
vorbildlich	positive
paradigmatisch	positive
arbeitsfreudig	positive
servil	positive
beflissen	positive
diensteifrig	positive
übereifrig	positive
notbehelfsmässig	negative
partiell	negative
notdürftig	negative
teilweise	negative
modefoto	positive
arglistig	negative
heimtückisch	negative
verträglich	positive
anrüchig	negative
unprofessionell	negative
charakterlos	negative
laienhaft	negative
gewalttätig	negative
pejorativ	negative
ineffektiv	negative
fehlerhaft	negative
widrig	negative
grauslich	negative
kriminell	negative
strafwürdig	negative
grottenschlecht	negative
leid	negative
süss	positive
lebenstüchtig	positive
tatkräftig	positive
geschäftstüchtig	positive
eilfertig	positive
gelehrig	positive
tierfotografie	positive
nacktfoto	positive
reklamefotografie	positive
tierphotographie	positive
tierfoto	positive
nacktbild	positive
reklamephotographie	positive
nacktaufnahme	positive
reklamefoto	positive
nichtig	negative
läppisch	negative
faulig	negative
verfault	negative
ärmlich	negative
froh	positive
familienfoto	positive
familienbild	positive
familienaufnahme	positive
ausgepowert	negative
groggy	negative
inadäquat	negative
günstig	positive
sinnhaft	positive
sinnreich	positive
recht	positive
menschenwürdig	positive
human	positive
menschlich	positive
moralisch	positive
menschenfreundlich	positive
halbherzig	negative
rudimentär	negative
durchbrochen	negative
halb	negative
ergänzungsbedürftig	negative
architekturbild	positive
architekturfoto	positive
gesundheitsdienlich	positive
gesund	positive
gesundheitsförderlich	positive
gesundheitsfördernd	positive
gerecht	positive
ungiftig	positive
ehrlich	positive
nützlich	positive
friedlich	positive
ekel	negative
klassenfoto	positive
klassenbild	positive
bankrott	negative
pleite	negative
insolvent	negative
zahlungsunfähig	negative
perfid	negative
perfide	negative
unangemessen	negative
verfehlt	negative
froh gestimmt	positive
frohgestimmt	positive
unfertig	negative
fair	positive
schmalspurig	negative
seelig	positive
überglücklich	positive
glückselig	positive
zuträglich	positive
verderben	negative
landschaftsfoto	positive
geniessbar	positive
bekömmlich	positive
eigen	positive
unerquicklich	negative
fertig	negative
verheerend	negative
katastrophal	negative
vernichtend	negative
sorgfältig	positive
ordentlich	positive
unschuldig	positive
gelungen	positive
ordnungsliebend	positive
sorgsam	positive
essbar	positive
sittlich	positive
unvollkommen	negative
unvollständig	negative
hinterlistig	negative
infam	negative
durchtrieben	negative
hinterfotzig	negative
defizitär	negative
lückenhaft	negative
exzellent	positive
drittklassig	negative
zweitklassig	negative
viertklassig	negative
irregulär	negative
fragwürdig	negative
glück	positive
furchtbar	negative
fürchterlich	negative
schaden	negative
fein	positive
unsportlich	negative
zweckmässig	positive
traurig	negative
wohlgesonnen	positive
unerreichbar	positive
uneinholbar	positive
unnachahmlich	positive
unübertroffen	positive
unerreicht	positive
ehrenhaft	positive
unsittlich	negative
ethisch	positive
kärglich	negative
kläglich	negative
erholsam	positive
entspannend	positive
heilsam	positive
heilend	positive
umweltverträglich	positive
naturverträglich	positive
unanständig	negative
gesinnt	positive
wohlgesinnt	positive
erholungsbedürftig	negative
urlaubsreif	negative
hochwertig	positive
verworfen	negative
verwerflich	negative
voreingenommen	negative
drollig	positive
goldig	positive
possierlich	positive
knuffig	positive
niedlich	positive
herzig	positive
putzig	positive
link	negative
humanitär	positive
philanthropisch	positive
unberechtigt	negative
verlogen	negative
lügnerisch	negative
verkehrt	negative
umgekehrt	negative
niedrig	negative
achtsam	positive
tugendlich	positive
tugendreich	positive
himmlisch	positive
herrlich	positive
endgeil	positive
mythisch	positive
legendär	positive
legendenhaft	positive
spitze	positive
klasse	positive
paradiesisch	positive
tugendhaft	positive
nieder	negative
verdaulich	positive
unzutreffend	negative
unwürdig	negative
würdelos	negative
unwahr	negative
verteufelt	negative
unautorisiert	negative
unbefugt	negative
lebensbejahend	positive
lebensfroh	positive
lebenslustig	positive
traumatisch	negative
traumatisierend	negative
erfolgreich	positive
chancenreich	positive
glückreich	positive
ergebnisreich	positive
geeignet	positive
unbedenklich	positive
liebesfähig	positive
liebevoll	positive
liebreich	positive
hinderlich	negative
zutreffend	positive
angeschlagen	negative
kriegsmüde	negative
wohltuend	positive
glückstrahlend	positive
stadtverträglich	positive
nahrhaft	positive
hautverträglich	positive
gesellschaftsverträglich	positive
wirtschaftsverträglich	positive
magenverträglich	positive
menschenverträglich	positive
trinkbar	positive
sozialverträglich	positive
probiotisch	positive
schadenfroh	negative
schurkisch	negative
garstig	negative
mies	negative
abstrus	negative
gefährlich	negative
aufrecht	positive
preisgekrönt	positive
störend	negative
selbstzerstörerisch	negative
selbstschädigend	negative
nervenschädlich	negative
augenschädigend	negative
nervenschädigend	negative
nierenschädlich	negative
leberschädlich	negative
nierenschädigend	negative
klimaschädlich	negative
leberschädigend	negative
klimaschädigend	negative
augenschädlich	negative
schrecklich	negative
unvertretbar	negative
unverdorben	positive
ausgelaugt	negative
ausgebrannt	negative
erschöpft	negative
abgespannt	negative
ausgepumpt	negative
mitgenommen	negative
entkräftet	negative
unrühmlich	negative
erfreulich	positive
gefällig	positive
adäquat	positive
edelmütig	positive
unmoralisch	negative
sittenlos	negative
vaterlandslos	negative
vergnügt	positive
fröhlich	positive
schädigen	negative
unerhört	negative
ungehörig	negative
ruiniert	negative
unannehmbar	negative
abgewrackt	negative
empörend	negative
himmelschreiend	negative
amateurhaft	negative
unfein	negative
zügellos	negative
ausschweifend	negative
unecht	negative
orgiastisch	negative
entartet	negative
heruntergekommen	negative
dekadent	negative
zugänglich	positive
niedertracht	negative
seriös	positive
ernsthaft	positive
gesetzt	positive
zytotoxisch	negative
hochgiftig	negative
nutzbringend	positive
friedliebend	positive
versauen	negative
wahr	positive
geraten	positive
zufrieden	positive
umweltbelastend	negative
umweltgefährdend	negative
umgänglich	positive
kumpelhaft	positive
jovial	positive
dankbar	positive
blaublütig	positive
aristokratisch	positive
adlig	positive
adelig	positive
prätentiös	negative
unstandesgemäss	negative
wichtigtuerisch	negative
grosskotzig	negative
prahlerisch	negative
grossspurig	negative
grossmäulig	negative
angeberisch	negative
unsachgemäss	negative
unbegründet	negative
ungerechtfertigt	negative
verschlagen	negative
intrigant	negative
kontrafaktisch	negative
verpatzen	negative
grundfalsch	negative
unkorrekt	negative
vermeintlich	negative
unerträglich	negative
regelrecht	positive
richtiggehend	positive
verfallen	negative
verrottet	negative
schimmelig	negative
verschimmelt	negative
glimpflich	positive
ungetrübt	positive
preussisch	positive
gewissenhaft	positive
verkacken	negative
vergeigen	negative
vermasseln	negative
versemmeln	negative
versieben	negative
versägen	negative
bestmöglich	positive
attraktiv	positive
eitrig	negative
schwerverletzt	negative
eiternd	negative
krankenhausreif	negative
vereitert	negative
schwerverwundet	negative
hobbyphotographie	positive
landschaftsfotografie	positive
architekturfotografie	positive
industriefotografie	positive
hobbyfotografie	positive
makrophotographie	positive
architekturphotographie	positive
reproduktionsfotografie	positive
aktphotographie	positive
makrofotografie	positive
digitalfotografie	positive
luftbildfotografie	positive
digitalphotographie	positive
reproduktionsphotographie	positive
porträtphotographie	positive
industriephotographie	positive
luftbildphotographie	positive
aktfotografie	positive
porträtfotografie	positive
landschaftsphotographie	positive
erleichtert	positive
heilfroh	positive
eklig	negative
arg	negative
eingängig	positive
unverhältnismässig	negative
unangebracht	negative
unziemlich	negative
undankbar	negative
optimal	positive
phantastisch	positive
fantastisch	positive
imageträchtig	positive
grossherzig	positive
meisterhaft	positive
meisterlich	positive
prestigeträchtig	positive
hervorragend	positive
grossartig	positive
erfolg versprechend	positive
prachtvoll	positive
wunderbar	positive
gutherzig	positive
grandios	positive
erfolgversprechend	positive
prächtig	positive
herausragend	positive
wundervoll	positive
lauter	positive
unattraktiv	negative
ungehobelt	negative
liederlich	negative
lasterhaft	negative
wüst	negative
unbescholten	positive
redlich	positive
liebenswürdig	positive
liebenswert	positive
beleidigen	negative
sintflutartig	negative
wolkenbruchartig	negative
rechtschaffen	positive
untadelig	positive
untadlig	positive
marktführend	positive
marktbeherrschend	positive
konstruktiv	positive
auszeichnen	positive
lethargisch	negative
hilfreich	positive
lädiert	negative
entzündet	negative
wund	negative
blessiert	negative
miesepetrig	negative
muffelig	negative
griesgrämig	negative
daguerreotypie	positive
freund	positive
sonnig	positive
verletzen	negative
verbindlich	positive
unverfroren	negative
impertinent	negative
unverschämt	negative
entwürdigen	negative
unaufrichtig	negative
kränken	negative
verschorft	negative
praktisch	positive
unflätig	negative
müssig	negative
überflüssig	negative
phlegmatisch	negative
unrichtig	negative
photographie	positive
zärtlich	positive
sportlich	positive
spitzfindig	negative
spöttisch	negative
spitz	negative
unästhetisch	negative
abgelaufen	negative
leutselig	positive
magenfreundlich	positive
kollegial	positive
kameradschaftlich	positive
freundschaftlich	positive
hautfreundlich	positive
fürsorglich	positive
bedienungsfreundlich	positive
kundenfreundlich	positive
partnerschaftlich	positive
wartungsfreundlich	positive
investitionsfreundlich	positive
leserfreundlich	positive
opportun	positive
passend	positive
verwundet	negative
säuerlich	negative
grundstufe	positive
mutig	positive
blutarm	negative
ranzig	negative
verderbt	negative
luderhaft	negative
barmherzig	positive
deformiert	negative
danebengegangen	negative
schiefgegangen	negative
fehlgeschlagen	negative
schiefgelaufen	negative
toll	positive
verbraucht	negative
vollmundig	negative
lautstark	negative
zynisch	negative
höhnisch	negative
schnippisch	negative
scharfzüngig	negative
ungeniessbar	negative
unbekömmlich	negative
förderlich	positive
hochklassig	positive
ungemütlich	negative
unbehaglich	negative
schlechtigkeit	negative
vorteilhaft	positive
wünschenswert	positive
sagenhaft	positive
berauschend	positive
gehoben	positive
begrüssenswert	positive
gutartig	positive
herzensgut	positive
sensationell	positive
perfekt	positive
prima	positive
unfehlbar	positive
märchenhaft	positive
okay	positive
exzeptionell	positive
genehm	positive
idyllisch	positive
erstklassig	positive
bedenkenswert	positive
traumhaft	positive
spitzenmässig	positive
elefantös	positive
ideal	positive
unübertrefflich	positive
ehrenvoll	positive
blendend	positive
gutmütig	positive
phänomenal	positive
sachlich	positive
bettelarm	negative
bedürftig	negative
bitterarm	negative
nobel	positive
hochherrschaftlich	positive
objektiv	positive
ungezogen	negative
verleumderisch	negative
schnoddrig	negative
polemisch	negative
vorlaut	negative
verfaulen	negative
verformt	negative
verlebt	negative
übermächtig	positive
gütig	positive
verbessernd	positive
überragen	positive
superior	positive
bedrückend	negative
stachlig	negative
befremdlich	negative
belastend	negative
beklemmend	negative
lästig	negative
grundübel	negative
stachelig	negative
nervig	negative
glänzend	positive
barsch	negative
abscheulich	negative
verabscheuungswürdig	negative
dienlich	positive
düster	negative
rabenschwarz	negative
pechschwarz	negative
kohlrabenschwarz	negative
unverdaulich	negative
erquicklich	positive
missbräuchlich	negative
afro-amerikanisch	negative
vornehm	positive
reich	positive
stumpf	negative
delikat	negative
fördernd	positive
blind	negative
lohnenswert	positive
brauchbar	positive
nutzbar	positive
lohnend	positive
behämmert	negative
bescheuert	negative
ritterlich	positive
umstritten	negative
strittig	negative
kontrovers	negative
bestreitbar	negative
martialisch	negative
kannibalisch	negative
barbarisch	negative
anspruchslos	negative
unbill	negative
prunkvoll	positive
pompös	positive
prunkhaft	positive
reinlich	positive
erschwinglich	positive
entsetzlich	negative
tragisch	negative
finanzierbar	positive
bezahlbar	positive
preisgünstig	positive
kostengünstig	positive
preiswert	positive
störungsbild	positive
tiefschwarz	negative
verboten	negative
farbig	negative
ungeschlacht	negative
grobschlächtig	negative
vierschrötig	negative
legende	positive
unerlaubt	negative
dunkelhäutig	negative
stümper	negative
rein	positive
rechtsliberal	positive
rechtskonservativ	positive
vitaminarm	negative
eiweissarm	negative
fettarm	negative
verarmt	negative
fleischarm	negative
wasserarm	negative
nährstoffarm	negative
kalorienarm	negative
rohstoffarm	negative
gedeihlich	positive
effektiv	positive
friedvoll	positive
schuld	negative
wohltätig	positive
caritativ	positive
mildtätig	positive
karitativ	positive
roh	negative
genügsam	negative
untauglich	negative
verschimmeln	negative
tugend	positive
rabiat	negative
erbarmungslos	negative
schändlich	negative
rüd	negative
straffällig	negative
schonungslos	negative
verbrecherisch	negative
gnadenlos	negative
mitleidslos	negative
delinquent	negative
rüde	negative
standbild	positive
frame	positive
tierliebhaber	positive
tierliebhaberin	positive
tierfreundin	positive
tiernärrin	positive
tiernarr	positive
tierfreund	positive
gift	negative
vortrefflich	positive
vorzüglich	positive
kunstfertig	positive
virtuos	positive
unbefriedigend	negative
wurfarm	negative
ungemach	negative
unkomfortabel	negative
fünf	negative
ärmel	negative
tonarm	negative
unterfüttern	negative
fangarm	negative
ästhetisch	positive
wohlfeil	positive
schuldhaft	negative
unfähig	negative
feil	positive
mitschuldig	negative
lächerlich	positive
unverrichtet	negative
genierlich	positive
genant	positive
schwärzlich	negative
russschwarz	negative
braunschwarz	negative
grauschwarz	negative
meister	positive
unmenschlich	negative
inhuman	negative
menschenunwürdig	negative
melancholisch	negative
schwermütig	negative
deliberieren	positive
unsympathisch	negative
kalkulieren	positive
unbequem	negative
beängstigend	negative
pickelig	negative
entstellt	negative
erwägen	positive
erdrückend	negative
potthässlich	negative
unförmig	negative
mulmig	negative
unansehnlich	negative
wägen	positive
bildhübsch	positive
abstossend	negative
steuer	positive
muster	positive
hart	negative
verätzen	negative
steuern	positive
steuerlast	positive
rechtsorientiert	positive
rechtsgerichtet	positive
konfirmationsfoto	positive
hochzeitsfoto	positive
hochzeitsbild	positive
konfirmationsbild	positive
gewalttat	negative
laie	negative
grausam	negative
blutig	negative
echt	positive
filmfreundin	positive
filmfreund	positive
filmliebhaber	positive
filmfan	positive
filmliebhaberin	positive
fleiss	positive
zugreifbar	positive
abrufbar	positive
blutrünstig	negative
unstimmig	negative
strafbar	negative
handgreiflich	negative
erpresserisch	negative
militant	negative
lebensfeindlich	negative
kleinkriminell	negative
dissozial	negative
tätlich	negative
asozial	negative
betrügerisch	negative
räuberisch	negative
prestige	positive
beispielgebend	positive
exemplarisch	positive
musterhaft	positive
gekonnt	positive
bestechend	positive
famos	positive
fulminant	positive
elegisch	negative
deprimiert	negative
heiter	positive
erbosen	negative
apokryph	negative
verhunzen	negative
vergiften	negative
verpfuschen	negative
verkorksen	negative
verbocken	negative
vermurksen	negative
kontaminieren	negative
zufügen	negative
antun	negative
steuergünstig	positive
verkehrsgünstig	positive
spottbillig	positive
strömungsgünstig	positive
ordnung	positive
zehnt	positive
punkteabzug	positive
zehnte	positive
punktabzug	positive
linke	negative
gewehrabzug	positive
standesgemäss	positive
sinn	positive
urlaubsfoto	positive
illegitim	negative
unrechtmässig	negative
eifer	positive
strahlend	positive
vorschrift	positive
lustbetont	positive
lustvoll	positive
rechtsseitig	positive
tücke	negative
feudalistisch	positive
königlich	positive
altadelig	positive
feudal	positive
altadlig	positive
kleinadlig	positive
royal	positive
kleinadelig	positive
qualitätsvoll	positive
qualitätvoll	positive
grausen	negative
zweifelhaft	negative
kunstliebhaberin	positive
briefmarkensammlerin	positive
sportfreundin	positive
musikliebhaber	positive
musikfreund	positive
weinliebhaberin	positive
weinliebhaber	positive
weinfreund	positive
philatelistin	positive
sportsfreund	positive
philatelist	positive
sportsfreundin	positive
kunstfreund	positive
kunstfreundin	positive
musikliebhaberin	positive
kunstliebhaber	positive
sportfreund	positive
weinfreundin	positive
briefmarkensammler	positive
musikfreundin	positive
berechtigt	positive
treffen	negative
anfechtbar	negative
fraglich	negative
angreifbar	negative
deprimierend	negative
entsagend	positive
entsagungsvoll	positive
abstinent	positive
zank	negative
fürstlich	positive
unzüchtig	negative
unkeusch	negative
paradigma	positive
gesundheitsabträglich	negative
betretbar	positive
euphorie	positive
hochgefühl	positive
entrücktheit	positive
verzückung	positive
ekstase	positive
hochstimmung	positive
trigger	positive
ruinieren	negative
vernutzen	negative
verkrüppeln	negative
lackmeiern	negative
oberflächlich	negative
befahrbar	positive
begehbar	positive
fahrbar	positive
unzuständig	negative
anhaben	negative
leidtragend	negative
betroffen	negative
leid tragend	negative
malus	positive
verdriesslich	negative
zerbeult	negative
kaiserlich	positive
hochadelig	positive
kaiserlich-königlich	positive
hochadlig	positive
höfisch	positive
freiherrlich	positive
standesherrlich	positive
auserwählt	positive
vorbestimmt	positive
erkoren	positive
prädestiniert	positive
treffend	positive
trefflich	positive
sachgemäss	positive
schifffahrtsabgabe	positive
fehlbelegungsabgabe	positive
sozialabgaben	positive
abschöpfung	positive
einfuhrabgabe	positive
truppenabzug	positive
abgabenlast	positive
ausgleichsabgabe	positive
rauchabzug	positive
behilflich	positive
faulen	negative
fäulen	negative
drangvoll	negative
nervtötend	negative
abgeklärt	positive
distinguiert	positive
appetitlich	positive
gepflegt	positive
unschuld	positive
vergällen	negative
verleiden	negative
streit	negative
versöhnlich	positive
ekelgefühl	negative
abscheu	negative
provozieren	negative
untüchtig	negative
neuwertig	positive
wertig	positive
begütert	positive
betucht	positive
gutbetucht	positive
gut betucht	positive
trüb	negative
situiert	positive
trübe	negative
philanthrop	positive
vorbild	positive
menschenfreundin	positive
menschenfreund	positive
begründet	positive
gerechtfertigt	positive
kriegsglück	positive
spielgewinn	positive
frank	positive
menschenfeindlich	negative
hilfsbereit	positive
defensiv	positive
trostlos	negative
todtraurig	negative
todunglücklich	negative
trist	negative
trübselig	negative
bitter	negative
verbittert	negative
betrübt	negative
adrett	positive
herausfordern	negative
vertrauenswürdig	positive
vorgetäuscht	negative
gespielt	negative
gefälscht	negative
vermiesen	negative
rühmlich	positive
vollkommen	positive
lebensgefährlich	negative
lebensbedrohend	negative
risikobehaftet	negative
lebensbedrohlich	negative
riskant	negative
risikoreich	negative
vertretbar	positive
mythos	positive
unvoreingenommen	positive
schimmeln	negative
entzündungshemmend	positive
antiphlogistisch	positive
tauglich	positive
treffsicher	positive
ex	positive
ansprechend	positive
schrecken	negative
geil	positive
krass	positive
fett	positive
mensch	positive
hoffähig	positive
statthaft	positive
gerechtigkeit	positive
exfreund	positive
exfreundin	positive
exliebe	positive
liebhaber	positive
bibliophiler	positive
bibliophile	positive
volksfreundin	positive
geschäftsfreundin	positive
geschäftsfreund	positive
schachfreund	positive
lover	positive
naturliebhaberin	positive
heimatfreund	positive
gartenfreundin	positive
karnevalistin	positive
karnevalist	positive
naturliebhaber	positive
schachfreundin	positive
loverin	positive
liebhaberin	positive
naturfreund	positive
heimatfreundin	positive
naturfreundin	positive
gartenfreund	positive
volksfreund	positive
übereinstimmend	positive
unbefleckt	positive
sinngetreu	positive
cool	positive
ausgewogen	positive
differenziert	positive
dusel	positive
glücksfall	positive
konkordant	positive
konform	positive
umsichtig	positive
moderat	positive
massvoll	positive
gemässigt	positive
einsam	negative
triumph	positive
wonne	positive
lebensglück	positive
unehrlich	negative
sicher	positive
bedenklich	negative
pflanzenverträglich	positive
antibiotisch	positive
landschaftsverträglich	positive
klimaverträglich	positive
dufte	positive
knorke	positive
stark	positive
astrein	positive
bekümmert	negative
wehmütig	negative
enttäuscht	negative
reumütig	negative
tränenreich	negative
betrüblich	negative
tieftraurig	negative
trübsinnig	negative
anwendungsorientiert	positive
angewandt	positive
anwendungsbezogen	positive
unbehindert	positive
ungehindert	positive
gelingen	positive
überwerfen	negative
modern	negative
vermodern	negative
verspielen	negative
eingehend	positive
säuberlich	positive
unordentlich	negative
erprobt	positive
bleiberecht	positive
grundrecht	positive
verfassungsrecht	positive
aufenthaltsrecht	positive
sinnentstellend	negative
niederrangig	negative
rangnieder	negative
gelogen	negative
erlogen	negative
probat	positive
erfolgsverwöhnt	positive
wettbewerbsfähig	positive
vielversprechend	positive
aussichtsreich	positive
konkurrenzfähig	positive
erfolgsgewöhnt	positive
liebreizend	positive
unwiderstehlich	positive
begehrenswert	positive
verführerisch	positive
kokett	positive
scharmant	positive
charmant	positive
lieblich	positive
unglück	negative
letal	negative
brandgefährlich	negative
tödlich	negative
hochgefährlich	negative
kinogängerin	positive
kinoliebhaberin	positive
kinofan	positive
kinoliebhaber	positive
kinogänger	positive
fragil	positive
feingeschnitten	positive
kolloidal	positive
fein geschnitten	positive
kolloid	positive
zerbrechlich	positive
arbeitswille	positive
arbeitsfreude	positive
vollständig	positive
befugt	positive
sinngemäss	positive
frage	negative
keusch	positive
eisenbahnfreund	positive
sachgerecht	positive
pech	negative
freiheit	positive
lecker	negative
köstlich	negative
wohlschmeckend	negative
verkommen	negative
schmackhaft	negative
halten	positive
glücksgefühl	positive
patent	positive
vorrang	positive
schamlos	negative
profilieren	positive
obszön	negative
ordinär	negative
vulgär	negative
wählbar	positive
unappetitlich	negative
ungepflegt	negative
verschalen	negative
wohltemperiert	positive
fachgerecht	positive
empfehlenswert	positive
einvernehmlich	positive
wohl temperiert	positive
ratsam	positive
demgemäss	positive
dementsprechend	positive
gütlich	positive
paradies	positive
fachgemäss	positive
zweck	positive
freudlos	negative
feindlich	negative
patentrecht	positive
klar	positive
anständig	positive
unbarmherzig	negative
passierbar	positive
seelsorgerlich	positive
seelsorglich	positive
seelsorgerisch	positive
vorrecht	positive
allgemein verbindlich	positive
allgemeinverbindlich	positive
eignen	positive
weitgefächert	positive
schutzgut	positive
breitgefächert	positive
monopolstellung	positive
rechtsgut	positive
monopol	positive
verrotten	negative
gären	negative
unheil verheissend	negative
spukhaft	negative
schauerhaft	negative
furchterregend	negative
unheilvoll	negative
gespenstisch	negative
unheilverheissend	negative
gespensterhaft	negative
angst erregend	negative
schauerlich	negative
schaudervoll	negative
geisterhaft	negative
schauderhaft	negative
angsterregend	negative
unheilschwanger	negative
furcht erregend	negative
unbewacht	positive
gemeinfrei	positive
nominell	negative
wahrhaftig	positive
aufnahmefähig	positive
wahrhaft	positive
helfen	positive
vorgeblich	negative
trügerisch	negative
täuschend	negative
chance	positive
unachtsam	negative
widerrufsrecht	positive
jagdrecht	positive
einbürgerungsrecht	positive
teilbar	positive
tatkraft	positive
korrekturbedürftig	negative
verlagsrecht	positive
druckfähig	positive
fündig	positive
erlebbar	positive
reaktionsfähig	positive
siegreich	positive
mischbar	positive
zukunftsfähig	positive
perspektivreich	positive
waffenfähig	positive
singbar	positive
magnetisierbar	positive
marktfähig	positive
lagerfähig	positive
tanzbar	positive
kombinierbar	positive
börsenfähig	positive
bespielbar	positive
beihilfefähig	positive
erstattungsfähig	positive
panzerbrechend	positive
anrechnungsfähig	positive
erlernbar	positive
abzugsfähig	positive
geländegängig	positive
lötfähig	positive
verzeihend	positive
gnädig	positive
huldreich	positive
zweitbeste	positive
allerbeste	positive
rassig	positive
betörend	positive
charismatisch	positive
vorzeigbar	positive
gefahr	negative
feinkörnig	positive
duftig	positive
feingemahlen	positive
filigran	positive
bedrohlich	negative
torgefährlich	negative
existenzbedrohend	negative
explosionsgefährlich	negative
gefahrvoll	negative
verrucht	negative
frivol	negative
pikant	negative
ehre	positive
lebensuntüchtig	negative
erhaben	positive
erfreuen	positive
unverbindlich	negative
cineast	positive
cineastin	positive
kumpel	positive
beschwingt	positive
ausgelassen	positive
quietschvergnügt	positive
arglist	negative
heimtücke	negative
offen	positive
naturgemäss	positive
tragbar	positive
exponieren	positive
hervortun	positive
sündhaft	negative
sündig	negative
kumpan	positive
jugendfreund	positive
zeitgerecht	positive
hausfreund	positive
schulfreundin	positive
hausfreundin	positive
schulfreund	positive
jugendfreundin	positive
duzfreundin	positive
duzfreund	positive
umweltgerecht	positive
entwicklungsgemäss	positive
gebührend	positive
zünftig	positive
nachahmenswert	positive
wohlproportioniert	positive
situationsgerecht	positive
behindertengerecht	positive
praxisgerecht	positive
zweckgemäss	positive
bewölkt	negative
wolkig	negative
faltenreich	positive
unverbindlichkeit	positive
titel	positive
unzumutbar	negative
pracht	positive
rechtsverbindlich	positive
benutzerrecht	positive
selbstbestimmungsrecht	positive
sonderrecht	positive
eigenrecht	positive
selbstverwaltungsrecht	positive
vogteirecht	positive
gemeingebrauch	positive
patronatsrecht	positive
gewohnheitsrecht	positive
ausnahmerecht	positive
schlüsselgewalt	positive
bildrecht	positive
hoheitsrecht	positive
vorschlagsrecht	positive
richterrecht	positive
lebensrecht	positive
existenzrecht	positive
anwartschaftsrecht	positive
bezugsrecht	positive
münzrecht	positive
entscheidungsrecht	positive
vertriebsrecht	positive
lizenzrecht	positive
faustrecht	positive
gebrauchsmuster	positive
besitzrecht	positive
handelsrecht	positive
mitwirkungsrecht	positive
freiheitsrecht	positive
persönlichkeitsrecht	positive
herrschaftsrecht	positive
vermarktungsrecht	positive
besatzungsrecht	positive
weisungsrecht	positive
exklusivrecht	positive
gesellschaftsrecht	positive
öffentlichkeitsrecht	positive
promotionsrecht	positive
heimrecht	positive
nomos	positive
zugriffsrecht	positive
schürfrecht	positive
umgangsrecht	positive
gasreich	positive
variationsreich	positive
schwerreich	positive
vergaberecht	positive
gutsituiert	positive
naturrecht	positive
strassenverkehrsrecht	positive
stinkreich	positive
presserecht	positive
torreich	positive
claim	positive
kaufkräftig	positive
souveränitätsrecht	positive
züchtigungsrecht	positive
initiativrecht	positive
zollrecht	positive
widerstandsrecht	positive
zahlungskräftig	positive
nährstoffreich	positive
wohlhabend	positive
fettreich	positive
vitaminreich	positive
eisenreich	positive
bilderreich	positive
variantenreich	positive
figurenreich	positive
rohstoffreich	positive
verkehrsrecht	positive
wasserreich	positive
eiweissreich	positive
ballaststoffreich	positive
formenreich	positive
individualrecht	positive
kalorienreich	positive
schmuddelig	negative
wahrheitsgemäss	positive
wahrheitsgetreu	positive
erträglich	positive
behaglich	positive
hochzufrieden	positive
unzufrieden	negative
gemütlich	positive
wohlmeinend	positive
schützend	positive
treu sorgend	positive
behütend	positive
treusorgend	positive
gutgemeint	positive
energisch	positive
berufspraktisch	positive
lebenspraktisch	positive
altpreussisch	positive
schimmel	negative
südpreussisch	positive
ostpreussisch	positive
westpreussisch	positive
wohlgeformt	positive
wohl geformt	positive
beste	positive
super	positive
top	positive
anziehend	positive
wunder	positive
kleidsam	positive
klotzig	negative
klobig	negative
verwachsen	negative
buckelig	negative
plump	negative
bucklig	negative
hervorragen	positive
not leidend	negative
notleidend	negative
arbeitsunwillig	negative
ozonschädigend	negative
ozonschädlich	negative
leichtfertig	negative
genusssüchtig	negative
plebejisch	negative
zotig	negative
energiegeladen	positive
experimentierfreudig	positive
findig	positive
streitig	negative
flach	negative
produktiv	positive
moral	positive
lobenswert	positive
löblich	positive
menschenverachtend	negative
praxis	positive
prädikatisieren	positive
initiativ	positive
aktionistisch	positive
aufwieglerisch	positive
unternehmungslustig	positive
bepreisen	positive
taggen	positive
insultieren	negative
verunglimpfen	negative
anämisch	negative
flamme	positive
amigo	positive
luder	negative
kurschatten	positive
studienfreund	positive
jugendliebe	positive
übrig	positive
sommerlich-sonnig	positive
verpflichtend	positive
gehaltvoll	positive
anrecht	positive
rechtsanspruch	positive
reichhaltig	positive
reputierlich	positive
gediegen	positive
sitte	positive
sensation	positive
kollege	positive
recht subjekt	positive
ordnungsrecht	positive
reichsrecht	positive
prozessrecht	positive
kündigungsrecht	positive
vertragsrecht	positive
recht kompetenz	positive
unannehmlichkeit	negative
trouble	negative
superreich	positive
verfahrensrecht	positive
schulrecht	positive
überreich	positive
steinreich	positive
neureich	positive
kapitalkräftig	positive
recht inhalt	positive
theoretisch	negative
unpraktisch	negative
pragmatisch	positive
praxisbezogen	positive
verheilt	positive
genesen	positive
gesundet	positive
verehrungswürdig	positive
hehr	positive
unterstützend	positive
mannschaftstauglich	positive
subsidiär	positive
mannschaftsdienlich	positive
verstrichen	negative
väterlich	positive
mütterlich	positive
wohlwollend	positive
partnerschaft	positive
kameradschaft	positive
betulich	positive
glorreich	positive
ruhmvoll	positive
ruhmreich	positive
ungeheuer	negative
unheimlich	negative
idyll	positive
fabelhaft	positive
tollwütig	positive
doll	positive
aufgebraucht	negative
verbrauchen	negative
adel	positive
strahlen	positive
elefant	positive
hinnehmbar	positive
erstrebenswert	positive
phänomen	positive
eminent	positive
traum	positive
passabel	positive
malerisch	positive
arkadisch	positive
sanftmütig	positive
märchen	positive
wärmebedürftig	negative
schutzbedürftig	negative
geistesklar	positive
erlaucht	positive
gesucht	positive
ausgesucht	positive
vorurteilsfrei	positive
vorurteilslos	positive
mildernd	positive
begünstigend	positive
verlottert	negative
alptraumhaft	negative
schaurig	negative
alarmierend	negative
schrecken erregend	negative
gespenstig	negative
alptraumartig	negative
vergammelt	negative
schreckenerregend	negative
besorgniserregend	negative
grauenerregend	negative
verlumpt	negative
grauen erregend	negative
würdig	positive
resistent	positive
immun	positive
gedankenvoll	negative
würdevoll	positive
ehrenwert	positive
honorabel	positive
ehrbar	positive
honett	positive
bestechlich	negative
werkeigen	positive
werkseigen	positive
ureigen	positive
ureigenst	positive
körperimmanent	positive
körpereigen	positive
unparteiisch	positive
rüstig	positive
krank	negative
quietschfidel	positive
clean	positive
kerngesund	positive
ängstigen	negative
käuflich	negative
vermögend	positive
gesetzeswerk	positive
korrupt	negative
honorig	positive
neutral	positive
unbestechlich	positive
schiffbar	positive
gangbar	positive
betriebseigen	positive
erweiterbar	positive
erweiterungsfähig	positive
ausbaufähig	positive
arteigen	positive
immanent	positive
staatseigen	positive
stadteigen	positive
gemeindeeigen	positive
verlagseigen	positive
schuleigen	positive
hauseigen	positive
leibeigen	positive
bordeigen	positive
bundeseigen	positive
firmeneigen	positive
landeseigen	positive
konzerneigen	positive
leiblich	positive
zelleigen	positive
vereinseigen	positive
volkseigen	positive
unternehmenseigen	positive
entstellen	negative
pickel	negative
oligotroph	negative
befriedigend	positive
süsslich	positive
zuckersüss	positive
sehen	positive
natur	positive
irrwitzig	negative
hirnrissig	negative
aberwitzig	negative
komfortabel	positive
tentakel	negative
parteiisch	negative
gruselig	negative
furchteinflössend	negative
verwahrlost	negative
verschwitzt	negative
beunruhigend	negative
grossmeister	positive
macker	positive
stecher	positive
untrainiert	negative
nüchtern	positive
instandsetzbar	positive
renovierbar	positive
fatal	negative
desaströs	negative
verhängnisvoll	negative
reissen	negative
wohltun	positive
wohl tun	positive
verkaufsfördernd	positive
wachstumsfördernd	positive
leistungsfördernd	positive
dilettantin	negative
dilettant	negative
heilen	positive
umwelt	positive
intersubjektiv	negative
tendenziös	negative
handlich	positive
hoch	positive
benutzbar	positive
handhabbar	positive
bärenstark	positive
verwertbar	positive
erneuerbar	positive
internetfähig	positive
speicherbar	positive
abbaubar	positive
aufladbar	positive
praktikabel	positive
auswertbar	positive
abbauwürdig	positive
erschliessbar	positive
netzwerkfähig	positive
bedienbar	positive
verarbeitbar	positive
anbaufähig	positive
unselig	negative
krude	negative
unheilig	negative
krud	negative
entmutigend	negative
demoralisierend	negative
kapitalertragssteuer	positive
kfz-steuer	positive
kraftfahrzeugsteuer	positive
quellensteuer	positive
bedröppelt	negative
begossen	negative
gelackmeiert	negative
altmeister	positive
wohlig	positive
konjunkturverträglich	positive
verwunden	negative
solide	positive
solid	positive
niederschmetternd	negative
vorsteuer	positive
verkehrsteuer	positive
branntweinsteuer	positive
besitzsteuer	positive
verbrauchssteuer	positive
benzinsteuer	positive
abgeltungsteuer	positive
bundessteuer	positive
landessteuer	positive
gemeinschaftsteuer	positive
kapitalertragsteuer	positive
sondersteuer	positive
gemeindesteuer	positive
sträflich	negative
tadelnswert	negative
vertragen	negative
schmierig	negative
empören	negative
ominös	negative
startbereit	negative
bezugsfertig	negative
schlüsselfertig	negative
startfertig	negative
staatskonform	positive
verfassungstreu	positive
beziehbar	negative
startklar	negative
verfassungsgemäss	positive
verfassungskonform	positive
erreichbar	negative
unschicklich	negative
ungeschliffen	negative
ungehemmt	negative
zerlumpt	negative
abgerissen	negative
lumpig	negative
gammelig	negative
gammlig	negative
objektsteuer	positive
personalsteuer	positive
quotationssteuer	positive
subjektsteuer	positive
repartitionssteuer	positive
direkte steuer	positive
realsteuer	positive
indirekte steuer	positive
druckfertig	negative
paarungsbereit	negative
druckreif	negative
dienstbereit	negative
paarungswillig	negative
einsatzbereit	negative
humorig	positive
brüskieren	negative
schmähen	negative
hinterlist	negative
überschwang	positive
wohltäter	positive
wohltäterin	positive
übermut	positive
zölibatär	positive
seligkeit	positive
freudentaumel	positive
lehrmeister	positive
lehrmeisterin	positive
hemmungslos	negative
ungezügelt	negative
viele	positive
vielerlei	positive
mancherlei	positive
beschämt	negative
fadenscheinig	negative
infamie	negative
niederträchtigkeit	negative
vorgeschoben	negative
gewaltbereit	negative
bereitstehend	negative
kampfbereit	negative
fahrbereit	negative
betriebsbereit	negative
baureif	negative
gebrauchsfertig	negative
halbfertig	negative
humorvoll	positive
scharf	positive
vergnügen	positive
befreit	positive
allegro	positive
lustig	positive
erlöst	positive
versehren	negative
deplaziert	negative
deplatziert	negative
ungeschützt	negative
exzessiv	negative
unseriös	negative
getragen	positive
schöpfungsmythos	positive
schöpfungsbericht	positive
flugbereit	negative
gewagt	negative
gefährdend	negative
selbstmörderisch	negative
ungesichert	negative
