schlecht	negative
zweitklassig	negative
negativ	negative
unglücklich	negative
böse	negative
minderwertig	negative
armselig	negative
falsch	negative
unschön	negative
mies	negative
satanisch	negative
teuflisch	negative
dämonisch	negative
diabolisch	negative
feig	negative
feige	negative
lieb	positive
phantastisch	positive
schön	positive
richtig	positive
erstklassig	positive
gut	positive
positiv	positive
ausgezeichnet	positive
exzellent	positive
grossartig	positive
sauer	negative
hinterhältig	negative
verletzt	negative
beleidigt	negative
gekränkt	negative
pikiert	negative
eingeschnappt	negative
fleissig	positive
bösartig	negative
entwürdigend	negative
niederträchtig	negative
boshaft	negative
bös	negative
beispielhaft	positive
tüchtig	positive
arbeitsam	positive
eifrig	positive
emsig	positive
böswillig	negative
mustergültig	positive
vorbildlich	positive
vorbildhaft	positive
paradigmatisch	positive
betriebsam	positive
geschäftig	positive
agil	positive
hämisch	negative
maliziös	negative
edel	positive
übel	negative
nutzlos	negative
aggressiv	negative
sinnvoll	positive
sinnig	positive
arbeitswillig	positive
aktiv	positive
tatkräftig	positive
arbeitsfreudig	positive
übereifrig	positive
servil	positive
beflissen	positive
diensteifrig	positive
unnütz	negative
süffisant	negative
gemein	negative
hündisch	negative
hasserfüllt	negative
stiefmütterlich	negative
unversöhnlich	negative
nachtragend	negative
ungerecht	negative
nichtsnutzig	negative
unnützlich	negative
fein	positive
angriffslustig	negative
kampfeslustig	negative
kampflustig	negative
sinnhaft	positive
sinnreich	positive
lebenstüchtig	positive
hetzerisch	negative
aufwiegelnd	negative
aufhetzend	negative
demagogisch	negative
geschäftstüchtig	positive
eilfertig	positive
gelehrig	positive
schädlich	negative
vorwurfsvoll	negative
infernal	negative
unschädlich	positive
zwecklos	negative
mau	negative
moralisch	positive
zänkisch	negative
zanksüchtig	negative
streitsüchtig	negative
verträglich	positive
luziferisch	negative
mephistophelisch	negative
faul	negative
sinnlos	negative
unsinnig	negative
unfair	negative
abträglich	negative
schädigend	negative
zweckfrei	negative
unzweckmässig	negative
sittlich	positive
schnöde	negative
offensiv	negative
mistig	negative
oll	negative
ätzend	negative
draufgängerisch	negative
gehässig	negative
provokativ	negative
bissig	negative
provozierend	negative
gerecht	positive
zuträglich	positive
nützlich	positive
friedlich	positive
ethisch	positive
unakzeptabel	negative
misslungen	negative
aussergewöhnlich	positive
prächtig	positive
prachtvoll	positive
fair	positive
ungünstig	negative
regulär	positive
exzeptionell	positive
ausserordentlich	positive
tugendlich	positive
endgeil	positive
tugendreich	positive
mythisch	positive
himmlisch	positive
legendär	positive
legendenhaft	positive
spitze	positive
herrlich	positive
klasse	positive
paradiesisch	positive
tugendhaft	positive
ungut	negative
tückisch	negative
glücklich	positive
akzeptabel	positive
gelungen	positive
kümmerlich	negative
jämmerlich	negative
unerreichbar	positive
flau	negative
uneinholbar	positive
unnachahmlich	positive
unübertroffen	positive
unerreicht	positive
fantastisch	positive
grandios	positive
wertlos	negative
dahergelaufen	negative
herausfordernd	negative
forsch	negative
kriegerisch	negative
streitlustig	negative
freundlich	positive
unehrenhaft	negative
regelgemäss	positive
regelgerecht	positive
vorschriftsmässig	positive
ordnungsgemäss	positive
vorschriftsgemäss	positive
unedel	negative
ruchbar	negative
beknackt	negative
statutengemäss	positive
wortlautgemäss	positive
satzungsgemäss	positive
wortgemäss	positive
aufrichtig	positive
attraktiv	positive
elendig	negative
erbärmlich	negative
elend	negative
gesundheitsdienlich	positive
gesund	positive
gesundheitsförderlich	positive
gesundheitsfördernd	positive
abgeschlagen	negative
hochwertig	positive
gefällig	positive
edelmütig	positive
unvorteilhaft	negative
amoralisch	negative
ehrlich	positive
arglistig	negative
heimtückisch	negative
inakzeptabel	negative
missraten	negative
bescheiden	negative
brutal	negative
unfreundlich	negative
gutartig	positive
adlig	positive
adelig	positive
aufrecht	positive
ehrlos	negative
scheiss	negative
unschuldig	positive
beschissen	negative
gewalttätig	negative
zweckmässig	positive
schuldig	negative
lausig	negative
stümperhaft	negative
grottig	negative
schäbig	negative
dilettantisch	negative
miserabel	negative
blaublütig	positive
aristokratisch	positive
günstig	positive
chancenlos	negative
glücklos	negative
erfolglos	negative
ergebnislos	negative
ungeeignet	negative
unverträglich	negative
befehlsgemäss	positive
normgemäss	positive
bestimmungsgemäss	positive
nutzbringend	positive
friedliebend	positive
geraten	positive
genehm	positive
bestmöglich	positive
geniessbar	positive
bekömmlich	positive
wohltuend	positive
bitterböse	negative
erbost	negative
essbar	positive
eingängig	positive
chancenreich	positive
glückreich	positive
ergebnisreich	positive
erfolgreich	positive
geeignet	positive
optimal	positive
giftig	negative
gutherzig	positive
erfolgversprechend	positive
grossherzig	positive
herausragend	positive
hervorragend	positive
erfolg versprechend	positive
imageträchtig	positive
meisterhaft	positive
meisterlich	positive
prestigeträchtig	positive
wundervoll	positive
wunderbar	positive
preisgekrönt	positive
perfid	negative
perfide	negative
ehrenhaft	positive
matt	negative
seriös	positive
ernsthaft	positive
gesetzt	positive
schwarz	negative
destruktiv	negative
hochklassig	positive
durchtrieben	negative
hinterfotzig	negative
hinterlistig	negative
infam	negative
toxisch	negative
zerstörerisch	negative
ungiftig	positive
gesundheitsschädlich	negative
gesundheitsschädigend	negative
umweltschädigend	negative
umweltschädlich	negative
entspannend	positive
heilend	positive
umweltverträglich	positive
naturverträglich	positive
erholsam	positive
heilsam	positive
lauter	positive
unbescholten	positive
redlich	positive
rechtschaffen	positive
marktführend	positive
untadelig	positive
untadlig	positive
marktbeherrschend	positive
anrüchig	negative
unprofessionell	negative
charakterlos	negative
laienhaft	negative
pejorativ	negative
ineffektiv	negative
fehlerhaft	negative
widrig	negative
schlimm	negative
grauslich	negative
kriminell	negative
strafwürdig	negative
grottenschlecht	negative
leid	negative
süss	positive
schwindlig	negative
barmherzig	positive
angenehm	positive
toll	positive
verdaulich	positive
unbedenklich	positive
geschäftsschädigend	negative
anoxisch	negative
ruinös	negative
parteischädigend	negative
rufschädigend	negative
kontraproduktiv	negative
hilfreich	positive
stadtverträglich	positive
nahrhaft	positive
hautverträglich	positive
gesellschaftsverträglich	positive
wirtschaftsverträglich	positive
magenverträglich	positive
menschenverträglich	positive
trinkbar	positive
sozialverträglich	positive
probiotisch	positive
unangemessen	negative
inadäquat	negative
wünschenswert	positive
sagenhaft	positive
berauschend	positive
gehoben	positive
begrüssenswert	positive
herzensgut	positive
sensationell	positive
perfekt	positive
prima	positive
unfehlbar	positive
märchenhaft	positive
okay	positive
idyllisch	positive
bedenkenswert	positive
traumhaft	positive
spitzenmässig	positive
elefantös	positive
ideal	positive
besser	positive
unübertrefflich	positive
ehrenvoll	positive
blendend	positive
überragend	positive
gutmütig	positive
phänomenal	positive
prunkvoll	positive
pompös	positive
prunkhaft	positive
nobel	positive
hochherrschaftlich	positive
eminent	positive
popelig	negative
poplig	negative
famos	positive
fulminant	positive
subjektiv	negative
verfehlt	negative
vornehm	positive
feingeschnitten	positive
fein geschnitten	positive
fälschlich	negative
irrtümlich	negative
irrig	negative
fertig	negative
erledigt	negative
ausgepowert	negative
groggy	negative
voreingenommen	negative
liebesfähig	positive
liebevoll	positive
liebreich	positive
angebracht	positive
unsportlich	negative
mutig	positive
fragwürdig	negative
irregulär	negative
annehmbar	positive
absurd	negative
abstrus	negative
passend	positive
opportun	positive
sportlich	positive
objektiv	positive
martialisch	negative
kannibalisch	negative
barbarisch	negative
auszeichnen	positive
drollig	positive
niedlich	positive
goldig	positive
herzig	positive
possierlich	positive
putzig	positive
knuffig	positive
adäquat	positive
angemessen	positive
dienlich	positive
unberechtigt	negative
förderlich	positive
stilsicher	positive
stilgerecht	positive
geschmackvoll	positive
stilvoll	positive
tragbar	positive
urlaubsreif	negative
erholungsbedürftig	negative
unannehmbar	negative
legende	positive
brauchbar	positive
unvertretbar	negative
link	negative
fördernd	positive
nutzbar	positive
lohnenswert	positive
lohnend	positive
hinnehmbar	positive
glück	positive
unangebracht	negative
wählbar	positive
verlogen	negative
lügnerisch	negative
kleidsam	positive
vertretbar	positive
zutreffend	positive
unbefugt	negative
unautorisiert	negative
niedrig	negative
vermeintlich	negative
umgekehrt	negative
angeblich	negative
verkehrt	negative
nieder	negative
unzutreffend	negative
unwürdig	negative
würdelos	negative
unrecht	negative
appetitlich	positive
gepflegt	positive
roh	negative
muster	positive
unwahr	negative
rabiat	negative
adrett	positive
schonungslos	negative
gnadenlos	negative
brachial	negative
handgreiflich	negative
mitleidslos	negative
erbarmungslos	negative
rüde	negative
rüd	negative
tugend	positive
ritterlich	positive
liebenswürdig	positive
liebenswert	positive
angeschlagen	negative
kriegsmüde	negative
unbegründet	negative
vortrefflich	positive
vorzüglich	positive
virtuos	positive
kunstfertig	positive
bodenlos	negative
karitativ	positive
wohltätig	positive
caritativ	positive
mildtätig	positive
anziehend	positive
hart	negative
unaufrichtig	negative
recht	positive
empörend	negative
himmelschreiend	negative
gedeihlich	positive
friedfertig	positive
effektiv	positive
friedvoll	positive
unpassend	negative
ästhetisch	positive
passabel	positive
meister	positive
grundlos	negative
unrühmlich	negative
unerhört	negative
ungehörig	negative
konstruktiv	positive
ausgelaugt	negative
ausgebrannt	negative
erschöpft	negative
abgespannt	negative
ausgepumpt	negative
mitgenommen	negative
entkräftet	negative
verdorben	negative
ansehnlich	positive
blutig	negative
vaterlandslos	negative
grausam	negative
unstandesgemäss	negative
beispiel	positive
ungerechtfertigt	negative
unsachgemäss	negative
blutrünstig	negative
militant	negative
tätlich	negative
qualitätsvoll	positive
qualitätvoll	positive
abgewrackt	negative
amateurhaft	negative
ansprechend	positive
vorzeigbar	positive
apart	positive
liebreizend	positive
unwiderstehlich	positive
rassig	positive
begehrenswert	positive
verführerisch	positive
kokett	positive
scharmant	positive
charmant	positive
lieblich	positive
unecht	negative
verteufelt	negative
prestige	positive
königlich	positive
altadelig	positive
feudal	positive
altadlig	positive
kleinadlig	positive
feudalistisch	positive
royal	positive
kleinadelig	positive
bestechend	positive
gekonnt	positive
nichtig	negative
läppisch	negative
froh	positive
verschlagen	negative
intrigant	negative
wahr	positive
musterhaft	positive
beispielgebend	positive
exemplarisch	positive
fürstlich	positive
prätentiös	negative
grosskotzig	negative
grossspurig	negative
wichtigtuerisch	negative
prahlerisch	negative
grossmäulig	negative
angeberisch	negative
paradigma	positive
sinn	positive
standesherrlich	positive
kaiserlich	positive
hochadelig	positive
kaiserlich-königlich	positive
hochadlig	positive
höfisch	positive
freiherrlich	positive
grundfalsch	negative
unkorrekt	negative
kontrafaktisch	negative
unverhältnismässig	negative
unziemlich	negative
unbillig	negative
energisch	positive
entsagend	positive
enthaltsam	positive
entsagungsvoll	positive
abstinent	positive
experimentierfreudig	positive
aufrührerisch	positive
findig	positive
aufwieglerisch	positive
energiegeladen	positive
regelrecht	positive
richtiggehend	positive
niedertracht	negative
geil	positive
dynamisch	positive
verfault	negative
faulig	negative
neuwertig	positive
wertig	positive
gütig	positive
geringwertig	negative
produktiv	positive
froh gestimmt	positive
frohgestimmt	positive
initiativ	positive
aktionistisch	positive
unternehmungslustig	positive
unfein	negative
betörend	positive
charismatisch	positive
eifer	positive
fragil	positive
kolloidal	positive
kolloid	positive
zerbrechlich	positive
seelig	positive
überglücklich	positive
glückselig	positive
vorbild	positive
zärtlich	positive
auserkoren	positive
erkoren	positive
prädestiniert	positive
auserwählt	positive
vorbestimmt	positive
fleiss	positive
menschenwürdig	positive
human	positive
menschlich	positive
unattraktiv	negative
menschenfreundlich	positive
undankbar	negative
grob	negative
behilflich	positive
eitrig	negative
schwerverletzt	negative
eiternd	negative
krankenhausreif	negative
vereitert	negative
schwerverwundet	negative
unverfroren	negative
impertinent	negative
unverschämt	negative
standesgemäss	positive
traurig	negative
abgeklärt	positive
korrekt	positive
distinguiert	positive
feinkörnig	positive
duftig	positive
feingemahlen	positive
filigran	positive
untüchtig	negative
wohl geformt	positive
wohlgeformt	positive
müssig	negative
überflüssig	negative
drittklassig	negative
viertklassig	negative
beleidigen	negative
unrichtig	negative
schiefgelaufen	negative
danebengegangen	negative
schiefgegangen	negative
fehlgeschlagen	negative
spöttisch	negative
spitz	negative
spitzfindig	negative
lädiert	negative
entzündet	negative
wund	negative
blessiert	negative
schaden	negative
erschwinglich	positive
graziös	positive
anmutig	positive
finanzierbar	positive
bezahlbar	positive
hilfsbereit	positive
preisgünstig	positive
kostengünstig	positive
preiswert	positive
glückstrahlend	positive
mythos	positive
fett	positive
wohlgesonnen	positive
krass	positive
berechtigt	positive
wohlig	positive
unsittlich	negative
gesinnt	positive
wohlgesinnt	positive
cool	positive
entwürdigen	negative
gerechtfertigt	positive
sachgemäss	positive
pracht	positive
vollmundig	negative
lautstark	negative
zynisch	negative
höhnisch	negative
schnippisch	negative
scharfzüngig	negative
verletzen	negative
verschorft	negative
kränken	negative
sitte	positive
übereinstimmend	positive
statthaft	positive
hoffähig	positive
wunderschön	positive
dekorativ	positive
bildschön	positive
schmuck	positive
ausgewogen	positive
belämmert	negative
behämmert	negative
bescheuert	negative
stark	positive
unverdorben	positive
differenziert	positive
konkordant	positive
konform	positive
umsichtig	positive
moderat	positive
massvoll	positive
gemässigt	positive
schädigen	negative
zufrieden	positive
dufte	positive
knorke	positive
astrein	positive
verwundet	negative
griesgrämig	negative
miesepetrig	negative
muffelig	negative
ungezogen	negative
glimpflich	positive
ungetrübt	positive
verleumderisch	negative
schnoddrig	negative
polemisch	negative
vorlaut	negative
unbefleckt	positive
wohlfeil	positive
bewährt	positive
erprobt	positive
hinderlich	negative
probat	positive
feil	positive
lethargisch	negative
zugänglich	positive
begründet	positive
umgänglich	positive
säuerlich	negative
kumpelhaft	positive
jovial	positive
moral	positive
befugt	positive
rabenschwarz	negative
pechschwarz	negative
kohlrabenschwarz	negative
unbarmherzig	negative
begründbar	positive
sachgerecht	positive
rein	positive
unschuld	positive
originell	positive
afro-amerikanisch	negative
missbräuchlich	negative
akzeptieren	positive
paradies	positive
wohltemperiert	positive
fachgerecht	positive
empfehlenswert	positive
einvernehmlich	positive
wohl temperiert	positive
ratsam	positive
demgemäss	positive
dementsprechend	positive
gütlich	positive
fachgemäss	positive
behaglich	positive
gemütlich	positive
keusch	positive
himmel	positive
umstritten	negative
strittig	negative
feinschmeckerisch	positive
kulinarisch	positive
vernichtend	negative
verheerend	negative
katastrophal	negative
phlegmatisch	negative
kontrovers	negative
bestreitbar	negative
schuld	negative
geruhsam	positive
nominell	negative
gelingen	positive
anspruchslos	negative
untauglich	negative
ungeniessbar	negative
unbekömmlich	negative
freund	positive
schadenfroh	negative
schurkisch	negative
garstig	negative
fies	negative
deformiert	negative
verbindlich	positive
vorgeblich	negative
trügerisch	negative
täuschend	negative
steuergünstig	positive
spottbillig	positive
sonnig	positive
tauglich	positive
erträglich	positive
aussichtsreich	positive
erfolgsverwöhnt	positive
wettbewerbsfähig	positive
vielversprechend	positive
konkurrenzfähig	positive
erfolgsgewöhnt	positive
zweitbeste	positive
allerbeste	positive
arbeitswille	positive
arbeitsfreude	positive
leutselig	positive
magenfreundlich	positive
kollegial	positive
kameradschaftlich	positive
freundschaftlich	positive
hautfreundlich	positive
fürsorglich	positive
bedienungsfreundlich	positive
nett	positive
kundenfreundlich	positive
partnerschaftlich	positive
wartungsfreundlich	positive
investitionsfreundlich	positive
leserfreundlich	positive
erlaucht	positive
gesucht	positive
ausgesucht	positive
auserlesen	positive
ausersehen	positive
tatkraft	positive
stümper	negative
verboten	negative
farbig	negative
naturgemäss	positive
dunkelhäutig	negative
unerlaubt	negative
tiefschwarz	negative
vorteilhaft	positive
umweltgerecht	positive
zeitgerecht	positive
entwicklungsgemäss	positive
gebührend	positive
zünftig	positive
nachahmenswert	positive
wohlproportioniert	positive
situationsgerecht	positive
behindertengerecht	positive
praxisgerecht	positive
zweckgemäss	positive
gewalttat	negative
billig	positive
störend	negative
chance	positive
furchtbar	negative
fürchterlich	negative
genügsam	negative
schuldhaft	negative
unerträglich	negative
unfähig	negative
komfortabel	positive
bequem	positive
barsch	negative
befriedigend	positive
unverdaulich	negative
eignen	positive
zweck	positive
verbrecherisch	negative
mitschuldig	negative
delinquent	negative
traumatisch	negative
schändlich	negative
traumatisierend	negative
straffällig	negative
gelegen	positive
verkehrsgünstig	positive
strömungsgünstig	positive
unverrichtet	negative
ertragbar	positive
selbstzerstörerisch	negative
selbstschädigend	negative
aufnahmefähig	positive
erfolg	positive
zufriedenstellend	positive
teilbar	positive
beste	positive
super	positive
top	positive
wunder	positive
mörderisch	negative
höllisch	negative
beweglich	positive
druckfähig	positive
fündig	positive
erlebbar	positive
reaktionsfähig	positive
siegreich	positive
mischbar	positive
zukunftsfähig	positive
perspektivreich	positive
waffenfähig	positive
singbar	positive
magnetisierbar	positive
marktfähig	positive
lagerfähig	positive
tanzbar	positive
kombinierbar	positive
börsenfähig	positive
bespielbar	positive
beihilfefähig	positive
erstattungsfähig	positive
panzerbrechend	positive
anrechnungsfähig	positive
erlernbar	positive
abzugsfähig	positive
geländegängig	positive
lötfähig	positive
nervenschädlich	negative
nervenschädigend	negative
nierenschädlich	negative
nierenschädigend	negative
augenschädigend	negative
klimaschädlich	negative
leberschädigend	negative
klimaschädigend	negative
leberschädlich	negative
augenschädlich	negative
hervorragen	positive
antiphlogistisch	positive
entzündungshemmend	positive
lebensuntüchtig	negative
sinnlich	positive
hübsch	positive
hässlich	negative
zytotoxisch	negative
hochgiftig	negative
düster	negative
adel	positive
bürgerlich	negative
umweltbelastend	negative
umweltgefährdend	negative
pflanzenverträglich	positive
antibiotisch	positive
landschaftsverträglich	positive
klimaverträglich	positive
schwärzlich	negative
russschwarz	negative
braunschwarz	negative
grauschwarz	negative
gefährlich	negative
rühmlich	positive
frank	positive
laie	negative
arbeitsunwillig	negative
sensation	positive
schrecklich	negative
echt	positive
unstimmig	negative
eklig	negative
strafbar	negative
erpresserisch	negative
lebensfeindlich	negative
kleinkriminell	negative
dissozial	negative
arg	negative
asozial	negative
betrügerisch	negative
räuberisch	negative
kämpferisch	positive
passiv	negative
ehre	positive
unangenehm	negative
idyll	positive
phänomen	positive
fabelhaft	positive
schmeichelhaft	positive
tollwütig	positive
doll	positive
erhaben	positive
glänzend	positive
treffend	positive
trefflich	positive
elefant	positive
verbessernd	positive
erstrebenswert	positive
traum	positive
malerisch	positive
überragen	positive
arkadisch	positive
sanftmütig	positive
märchen	positive
apokryph	negative
illegitim	negative
unrechtmässig	negative
ordnung	positive
vertrauenswürdig	positive
stumpf	negative
verderben	negative
unästhetisch	negative
formen	positive
unehrlich	negative
zugreifbar	positive
abrufbar	positive
vorschrift	positive
unterstützend	positive
mannschaftstauglich	positive
mannschaftsdienlich	positive
subsidiär	positive
zweifelhaft	negative
anfechtbar	negative
unzuständig	negative
angreifbar	negative
fraglich	negative
bestechlich	negative
zank	negative
griffig	positive
peinlich	positive
grazil	positive
penibel	positive
pedantisch	positive
förmlich	positive
korrupt	negative
käuflich	negative
lebenslustig	positive
lebensfroh	positive
lebensbejahend	positive
scharf	positive
dankbar	positive
schmuckvoll	positive
zölibatär	positive
blind	negative
erbosen	negative
streit	negative
provozieren	negative
vergnügt	positive
strahlend	positive
leitbild	positive
wunschbild	positive
leitstern	positive
irrwitzig	negative
hirnrissig	negative
aberwitzig	negative
humanitär	positive
philanthropisch	positive
parteiisch	negative
gesundheitsabträglich	negative
vertragen	positive
versöhnlich	positive
erweiterbar	positive
erweiterungsfähig	positive
ausbaufähig	positive
fröhlich	positive
unvoreingenommen	positive
grossmeister	positive
profilieren	positive
herausfordern	negative
intersubjektiv	negative
tendenziös	negative
lobenswert	positive
löblich	positive
erleichtert	positive
heilfroh	positive
vorgetäuscht	negative
gespielt	negative
gefälscht	negative
exempel	positive
treffsicher	positive
verehrungswürdig	positive
hehr	positive
heil	positive
reputierlich	positive
gediegen	positive
ehrbar	positive
glorreich	positive
ehrenwert	positive
ruhmvoll	positive
achtbar	positive
ruhmreich	positive
renovierbar	positive
instandsetzbar	positive
prunk	positive
bärenstark	positive
wohltun	positive
wohl tun	positive
sinngetreu	positive
defensiv	positive
würdig	positive
sexy	positive
krud	negative
krude	negative
klar	positive
verheilt	positive
genesen	positive
gesundet	positive
altmeister	positive
würdevoll	positive
honett	positive
honorabel	positive
unanständig	negative
rechtsliberal	positive
rechtskonservativ	positive
hervortun	positive
exponieren	positive
verworfen	negative
verwerflich	negative
verkaufsfördernd	positive
wachstumsfördernd	positive
leistungsfördernd	positive
benutzbar	positive
handlich	positive
handhabbar	positive
verwertbar	positive
erneuerbar	positive
internetfähig	positive
speicherbar	positive
abbaubar	positive
aufladbar	positive
praktikabel	positive
auswertbar	positive
erschliessbar	positive
netzwerkfähig	positive
bedienbar	positive
verarbeitbar	positive
anbaufähig	positive
tücke	negative
abbauwürdig	positive
ordentlich	positive
sorgfältig	positive
unansehnlich	negative
ordnungsliebend	positive
sorgsam	positive
resistent	positive
immun	positive
verzeihend	positive
gnädig	positive
huldreich	positive
formschön	positive
formvollendet	positive
sinnentstellend	negative
niederrangig	negative
rangnieder	negative
gelogen	negative
erlogen	negative
geistesklar	positive
charme	positive
scharm	positive
honorig	positive
erreichbar	negative
staatskonform	positive
verfassungstreu	positive
verfassungsgemäss	positive
verfassungskonform	positive
viele	positive
allerlei	positive
vielerlei	positive
mancherlei	positive
sinngemäss	positive
frage	negative
unblutig	positive
rüstig	positive
krank	negative
quietschfidel	positive
clean	positive
kerngesund	positive
lehrmeister	positive
lehrmeisterin	positive
fadenscheinig	negative
deplaziert	negative
deplatziert	negative
rechtsorientiert	positive
rechtsgerichtet	positive
reizend	positive
farbkarte	positive
rechenexempel	positive
farbmuster	positive
rechenbeispiel	positive
inhuman	negative
menschenunwürdig	negative
unmenschlich	negative
bepreisen	positive
prädikatisieren	positive
taggen	positive
vorgeschoben	negative
schöpfungsmythos	positive
schöpfungsbericht	positive
getragen	positive
humorlos	positive
schimmelig	negative
verschimmelt	negative
verfallen	negative
verrottet	negative
achtsam	positive
wahrhaftig	positive
wahrhaft	positive
korrekturbedürftig	negative
gegenbeispiel	positive
versuchsmuster	positive
entwurfsmuster	positive
beispielsfall	positive
klangbeispiel	positive
arbeitsmuster	positive
notenbeispiel	positive
fallbeispiel	positive
paradebeispiel	positive
filmbeispiel	positive
tiermodell	positive
musterbeispiel	positive
textmuster	positive
bildbeispiel	positive
labormuster	positive
textbeispiel	positive
negativbeispiel	positive
anwendungsbeispiel	positive
zahlenbeispiel	positive
strickmuster	positive
hörbeispiel	positive
lehrbeispiel	positive
gift	negative
sachfremd	negative
ungelegen	negative
unseriös	negative
heiligenlegende	positive
gründungsmythos	positive
dolchstosslegende	positive
unverdient	negative
kampferprobt	positive
krisenerprobt	positive
altbewährt	positive
kampferfahren	positive
traditionsreich	positive
krisenerfahren	positive
verformt	negative
natur	positive
arglist	negative
heimtücke	negative
kuschlig	positive
kuschelig	positive
linke	negative
beispielfall	positive
modellfall	positive
präzedenzfall	positive
unflätig	negative
zerstören	negative
heilen	positive
umwelt	positive
rechtsseitig	positive
verätzen	negative
zivil	positive
regelkonform	positive
bibeltreu	positive
lizenzkonform	positive
angepasst	positive
systemkonform	positive
archetyp	positive
archetypus	positive
urtyp	positive
urform	positive
ausgereift	positive
mythe	positive
unredlich	negative
vorbestraft	negative
abgelaufen	negative
ranzig	negative
verderbt	negative
luderhaft	negative
preussisch	positive
gewissenhaft	positive
bedenklich	negative
wahrheitsgemäss	positive
wahrheitsgetreu	positive
ernst	positive
unerbittlich	negative
konjunkturverträglich	positive
schachgrossmeister	positive
schachgrossmeisterin	positive
grossmeisterin	positive
lauschig	positive
einladend	positive
heimelig	positive
wohnlich	positive
sintflutartig	negative
wolkenbruchartig	negative
tischlermeisterin	positive
schreinermeister	positive
tischlermeister	positive
schreinermeisterin	positive
rekordhalterin	positive
rekordler	positive
rekordhalter	positive
rekordlerin	positive
streitig	negative
original	positive
unmoralisch	negative
sittenlos	negative
entrücktheit	positive
verzückung	positive
ekstase	positive
euphorie	positive
hochgefühl	positive
hochstimmung	positive
meisterin	positive
vorlage	positive
fest	negative
modell	positive
prototyp	positive
ungepflegt	negative
unappetitlich	negative
norm	positive
datenmodell	positive
urbild	positive
denkmodell	positive
standardmodell	positive
osi-modell	positive
atommodell	positive
vorreiterrolle	positive
maschinenmodell	positive
emsigkeit	positive
beflissenheit	positive
flach	negative
verbraucht	negative
spielgewinn	positive
vierschrötig	negative
ungeschlacht	negative
grobschlächtig	negative
malermeisterin	positive
orgelbaumeister	positive
malermeister	positive
friseurmeister	positive
lehrherr	positive
zimmermeister	positive
schiessmeister	positive
lehrherrin	positive
gildemeister	positive
fleischermeister	positive
maurermeisterin	positive
schiessmeisterin	positive
schneidermeisterin	positive
maurermeister	positive
schmiedemeisterin	positive
gildemeisterin	positive
postmeisterin	positive
küchenmeister	positive
zimmermeisterin	positive
schlossermeister	positive
fechtmeisterin	positive
friseurmeisterin	positive
orgelbaumeisterin	positive
fechtmeister	positive
handwerksmeisterin	positive
küchenmeisterin	positive
bäckermeister	positive
handwerksmeister	positive
schmiedemeister	positive
braumeister	positive
schneidermeister	positive
schlossermeisterin	positive
fleischermeisterin	positive
bäckermeisterin	positive
steinmetzmeister	positive
steinmetzmeisterin	positive
postmeister	positive
braumeisterin	positive
titelverteidiger	positive
rechtmässig	positive
legitim	positive
jugendmeister	positive
weltmeister	positive
landesmeister	positive
landesmeisterin	positive
serienmeisterin	positive
ballettmeisterin	positive
titelverteidigerin	positive
europameisterin	positive
vizemeister	positive
europameister	positive
weltmeisterin	positive
serienmeister	positive
ballettmeister	positive
seniorenmeisterin	positive
vizemeisterin	positive
seniorenmeister	positive
jugendmeisterin	positive
mannschaftsmeister	positive
mannschaftsmeisterin	positive
verlebt	negative
vorurteilslos	positive
vorurteilsfrei	positive
kriegsglück	positive
damenhaft	positive
insultieren	negative
verunglimpfen	negative
menschenverachtend	negative
hinterlist	negative
solide	positive
solid	positive
beinhart	negative
knallhart	negative
polizeihauptmeister	positive
schachmeister	positive
amateurmeister	positive
ddr-meister	positive
unbestechlich	positive
stereotyp	positive
traumbild	positive
schönheitsideal	positive
idealstadt	positive
bewegungsmuster	positive
idealfall	positive
idealtyp	positive
bildungsideal	positive
idealtypus	positive
handlungsmuster	positive
unparteiisch	positive
schneidig	positive
dusel	positive
glücksfall	positive
untrainiert	negative
absolut	positive
triumph	positive
wonne	positive
lebensglück	positive
eisenhart	negative
stahlhart	negative
steinhart	negative
abziehen	negative
vergiften	negative
haltbar	positive
zufügen	negative
kontaminieren	negative
lackmeiern	negative
antun	negative
kaltblütig	negative
seelenruhig	negative
kaltschnäuzig	negative
abgezockt	negative
titelhalter	positive
champion	positive
titelhalterin	positive
strapaziös	negative
entbehrungsreich	negative
schweisstreibend	negative
kräftezehrend	negative
eigen	positive
gerechtigkeit	positive
naturgetreu	positive
massstabsgetreu	positive
massstäblich	positive
stimmig	positive
abgestimmt	positive
massgerecht	positive
rechtschaffenheit	positive
fairness	positive
unglück	negative
stimmfähig	positive
weisungsberechtigt	positive
weisungsbefugt	positive
heimatberechtigt	positive
wohnberechtigt	positive
wahlberechtigt	positive
süsslich	positive
zuckersüss	positive
pech	negative
glücksgefühl	positive
heillos	negative
kopflos	negative
uferlos	negative
vernutzen	negative
ruinieren	negative
verkrüppeln	negative
anhaben	negative
fleischlich	positive
pickelig	negative
entstellt	negative
potthässlich	negative
unförmig	negative
bildhübsch	positive
sittlichkeit	positive
sport	positive
kalt	negative
mühevoll	negative
kaltherzig	negative
verfaulen	negative
hartgesotten	negative
ausgekocht	negative
hartherzig	negative
stressig	negative
abgebrüht	negative
anstrengend	negative
zunftmeisterin	positive
werkmeisterin	positive
quartiermeisterin	positive
quartiermeister	positive
zunftmeister	positive
stallmeister	positive
werkmeister	positive
stallmeisterin	positive
fördern	positive
passen	positive
lohnen	positive
untragbar	negative
mundgerecht	positive
massgeschneidert	positive
nüchtern	positive
sportiv	positive
athletisch	positive
irritierend	negative
verwirrend	negative
zumutbar	positive
irreführend	negative
fehlleitend	negative
nutzungsberechtigt	positive
teilnahmeberechtigt	positive
sorgeberechtigt	positive
stimmberechtigt	positive
anspruchsberechtigt	positive
vollberechtigt	positive
erbberechtigt	positive
vertretungsberechtigt	positive
spielberechtigt	positive
erziehungsberechtigt	positive
treffen	negative
dilettantin	negative
dilettant	negative
unbrauchbar	negative
verantwortbar	positive
aushaltbar	positive
unerschrocken	positive
furchtlos	positive
wagemutig	positive
heldenhaft	positive
waghalsig	positive
angstlos	positive
heldisch	positive
kühn	positive
heroisch	positive
schöngeistig	positive
feingeistig	positive
laster	negative
hoch	positive
angezeigt	positive
protokollarisch	positive
ungekocht	negative
verabscheuungswürdig	negative
abscheulich	negative
unbehaglich	negative
ungemütlich	negative
kardinaltugend	positive
einnehmend	positive
gewinnend	positive
gewinnbar	positive
förderungswürdig	positive
verheissungsvoll	positive
verlockend	positive
sozialprestige	positive
tapfer	positive
wacker	positive
preisstabil	negative
wertstabil	negative
richtungsstabil	negative
melancholisch	negative
schwermütig	negative
unkultiviert	negative
unzivilisiert	negative
startbereit	negative
bezugsfertig	negative
schlüsselfertig	negative
beziehbar	negative
startklar	negative
startfertig	negative
abgrundtief	negative
plump	negative
empören	negative
effekt	positive
majestätisch	positive
leidlich	positive
taugen	positive
unproduktiv	negative
weich	positive
harsch	negative
altmeisterin	positive
nestor	positive
hörsinn	positive
gehör	positive
gehörsinn	positive
sträflich	negative
tadelnswert	negative
lehrer	positive
lehrerin	positive
ansprechen	positive
reckenhaft	positive
blutverschmiert	negative
bestialisch	negative
qualvoll	negative
entsetzlich	negative
tragisch	negative
scheusslich	negative
trübe	negative
trüb	negative
image	positive
sicher	positive
druckfertig	negative
paarungsbereit	negative
druckreif	negative
dienstbereit	negative
paarungswillig	negative
einsatzbereit	negative
elegisch	negative
deprimiert	negative
sexgierig	positive
schwanzgesteuert	positive
sexhungrig	positive
unsanft	negative
abgehärtet	negative
erfreulich	positive
unbefriedigend	negative
unbequem	negative
unkomfortabel	negative
couragiert	positive
beherzt	positive
geruchssinn	positive
geruch	positive
gewaltbereit	negative
bereitstehend	negative
kampfbereit	negative
fahrbereit	negative
betriebsbereit	negative
baureif	negative
gebrauchsfertig	negative
halbfertig	negative
energie	positive
glanz	positive
flor	positive
blumenpracht	positive
glamour	positive
charisma	positive
deprimierend	negative
rau	negative
verwunden	negative
zügellos	negative
ausschweifend	negative
dekadent	negative
rüpelhaft	negative
raubeinig	negative
entartet	negative
orgiastisch	negative
heruntergekommen	negative
ruppig	negative
leidtragend	negative
betroffen	negative
leid tragend	negative
unerfreulich	negative
freudig	positive
mut	positive
bereit	negative
unfertig	positive
ruiniert	negative
frigid	negative
gemeinschaftssinn	positive
zerbeult	negative
gerechtigkeitssinn	positive
bedeutung	positive
schönheitssinn	positive
gemeinsinn	positive
ästhetik	positive
gerechtigkeitsgefühl	positive
geschmackssinn	positive
spürsinn	positive
tastsinn	positive
lebenssinn	positive
sehsinn	positive
gleichgewichtssinn	positive
orientierungssinn	positive
tierliebhaber	positive
tiernärrin	positive
tiernarr	positive
tierfreund	positive
tierliebhaberin	positive
tierfreundin	positive
heiter	positive
infamie	negative
niederträchtigkeit	negative
einsam	negative
flugbereit	negative
misslich	negative
allein	negative
wüst	negative
liederlich	negative
lasterhaft	negative
ungehobelt	negative
todtraurig	negative
trist	negative
trostlos	negative
todunglücklich	negative
trübselig	negative
bitter	negative
betrübt	negative
verbittert	negative
brüskieren	negative
schmähen	negative
unsinn	negative
stichhaltig	positive
