töten	negative
gemein	negative
nachtragend	negative
hinterlistig	negative
beschädigt	negative
vergewaltigen	negative
verderben	negative
mangelhaft	negative
verrucht	negative
vergehen	negative
arrogant	negative
verbrecherisch	negative
krieg	negative
hinterhältig	negative
verlogen	negative
hass	negative
zerstören	negative
schimpfen	negative
übel	negative
unehrlich	negative
vernichten	negative
hölle	negative
wütend	negative
mord	negative
scheisse	negative
empört	negative
empören	negative
unverständlich	negative
verbrechen	negative
listig	negative
kaputt	negative
verdorben	negative
kompliziert	negative
hässlich	negative
misslingen	negative
problematisch	negative
affäre	negative
missbrauch	negative
gefährlich	negative
irreführend	negative
klagen	negative
verärgert	negative
betrügen	negative
feindlich	negative
falsch	negative
defekt	negative
gewalt	negative
schrecklich	negative
betrug	negative
unmoralisch	negative
dumm	negative
hassen	negative
unbeliebt	negative
verrat	negative
aggressiv	negative
verdammt	negative
verpatzen	negative
versauen	negative
versemmeln	negative
versieben	negative
versägen	negative
vergeigen	negative
vermasseln	negative
verkacken	negative
suff	negative
alkoholismus	negative
trunksucht	negative
alkoholmissbrauch	negative
alkoholsucht	negative
alkoholabhängigkeit	negative
trinksucht	negative
alkoholkrankheit	negative
täuschung	negative
trug	negative
irreführung	negative
finte	negative
mogelei	negative
schiebung	negative
schummel	negative
mauschelei	negative
schmu	negative
schummelei	negative
mist	negative
fälschung	negative
trick	negative
kniff	negative
verdeckung	negative
fälschen	negative
verhüllung	negative
wahlbetrug	negative
wahlmanipulation	negative
bluff	negative
hokuspokus	negative
daneben gehen	negative
schiefgehen	negative
schief gehen	negative
danebengehen	negative
schief laufen	negative
fehlschlagen	negative
schieflaufen	negative
fehl schlagen	negative
edel	positive
lachen	positive
lieben	positive
begehrt	positive
hoffnung	positive
jubeln	positive
ehrlich	positive
lieb	positive
freundlich	positive
effektiv	positive
schätzen	positive
allerbeste	positive
begeistert	positive
faszinierend	positive
anständig	positive
schön	positive
brillant	positive
fest	positive
gut	positive
fabelhaft	positive
aufrichtig	positive
motivieren	positive
erholung	positive
frohlocken	positive
lächeln	positive
freuen	positive
nett	positive
glücklich	positive
freude	positive
elegant	positive
schatz	positive
liebe	positive
ausgezeichnet	positive
qualitätvoll	positive
hervorragend	positive
anbeten	positive
wünschen	positive
fröhlichkeit	positive
tugend	positive
höflich	positive
beliebt	positive
froh	positive
grossartig	positive
güte	positive
bezaubernd	positive
jubel	positive
erstaunlich	positive
diskret	positive
bequem	positive
begeisterung	positive
einwandfrei	positive
attraktiv	positive
angenehm	positive
berühmt	positive
vergöttern	positive
ladegut	positive
ladungsgut	positive
schwindel	negative
blendwerk	negative
importgut	positive
betrugsfall	negative
kuckucksei	negative
selbstbetrug	negative
nepp	negative
hochstapelei	negative
scharlatanerie	negative
steuerbetrug	negative
beschiss	negative
vorspiegelung	negative
mogelpackung	negative
doppelspiel	negative
verarschung	negative
unkorrektheit	negative
anlagebetrug	negative
augenwischerei	negative
versteckspiel	negative
versicherungsbetrug	negative
selbsttäuschung	negative
korruption	negative
betrügerei	negative
verschleierung	negative
kreditbetrug	negative
dung	negative
losung	negative
importware	positive
exportgut	positive
luftfracht	positive
handelsgut	positive
industriegut	positive
archivgut	positive
schiffsfracht	positive
blutstuhl	negative
fettstuhl	negative
klabusterbeere	negative
hundekot	negative
kuhfladen	negative
verhunzen	negative
bruch	negative
festabend	positive
abendveranstaltung	positive
abendgesellschaft	positive
soiree	positive
abend	positive
fein	positive
zerlöchert	negative
vernichtet	negative
zerstört	negative
perforiert	negative
fracht	positive
frachtgut	positive
stückgut	positive
transportware	positive
cargo	positive
transportgut	positive
kargo	positive
exportware	positive
adlig	positive
adelig	positive
massenmord	negative
massenvernichtung	negative
stuhlgang	negative
aa	negative
exkrement	negative
kot	negative
kaka	negative
kacke	negative
blaublütig	positive
aristokratisch	positive
stuhl	negative
böse	negative
nachstellung	negative
kaffeesucht	negative
koffeinmissbrauch	negative
koffeinabhängigkeit	negative
nikotinsucht	negative
koffeinsucht	negative
nikotinmissbrauch	negative
zigarettenabhängigkeit	negative
nikotinabhängigkeit	negative
gewalttat	negative
verstoss	negative
abbruch	negative
stalking	negative
gräuel	negative
gräueltat	negative
schnarren	negative
anschnarren	negative
beraubung	negative
spionage	negative
spionagetätigkeit	negative
agententätigkeit	negative
kabale	negative
diebstahl	negative
intrige	negative
ränke	negative
raub	negative
aufrecht	positive
abtragung	negative
verkorksen	negative
verpfuschen	negative
verbocken	negative
vermurksen	negative
geburtstagsfeier	positive
geburtstagsparty	positive
geburtstagsfete	positive
geburtstagsfest	positive
abbau	negative
anschnauzen	negative
anblaffen	negative
anschnauben	negative
anknurren	negative
anblasen	negative
anzischen	negative
anfauchen	negative
eisenhart	positive
stahlhart	positive
steinhart	positive
verfolgung	negative
appetitlich	positive
gepflegt	positive
zerrüttet	negative
schrottreif	negative
ramponiert	negative
zerissen	negative
reparaturbedürftig	negative
korrosiv	negative
eingefallen	negative
schadhaft	negative
aufhetzend	negative
demagogisch	negative
hetzerisch	negative
aufwiegelnd	negative
abriss	negative
anziehend	positive
zerschlagen	negative
niederreissung	negative
einbruch	negative
demontage	negative
hetze	negative
adrett	positive
unaufrichtig	negative
drogensucht	negative
tablettenabhängigkeit	negative
drogenabhängigkeit	negative
tablettenmissbrauch	negative
drogenmissbrauch	negative
tablettensucht	negative
sexualdelikt	negative
missetat	negative
untat	negative
kriegsverbrechen	negative
gewaltverbrechen	negative
kriegsgräuel	negative
gewaltdelikt	negative
sittlichkeitsverbrechen	negative
strassenverkehrsdelikt	negative
verkehrsdelikt	negative
ästhetisch	positive
adipositas	negative
fettsucht	negative
anorexie	negative
anorexia nervosa	negative
lebenslustig	positive
annehmen	positive
lebensfroh	positive
lebensbejahend	positive
ganz	positive
bös	negative
lügnerisch	negative
ansehnlich	positive
verleiden	negative
vergällen	negative
abschlachten	negative
massaker	negative
gemetzel	negative
abschlachtung	negative
gemorde	negative
blutvergiessen	negative
blutbad	negative
fleissig	positive
feig	negative
feige	negative
indigniert	negative
entrüstet	negative
bruchstückhaft	negative
fragmentarisch	negative
bruchstückartig	negative
klavierabend	positive
theaterabend	positive
hochzeitsfest	positive
hochzeitsfeier	positive
hochzeitsfeierlichkeit	positive
dünkelhaft	negative
blasiert	negative
aufgeblasen	negative
verleumdung	negative
begünstigung	negative
ungelenkig	positive
fix	positive
steif	positive
reissen	negative
schänden	negative
vermiesen	negative
beihilfe	negative
ungelenk	positive
gegeben	positive
feststehend	positive
unsittlich	negative
zänkisch	negative
zanksüchtig	negative
streitsüchtig	negative
esssucht	negative
magersucht	negative
tricksen	negative
überschreitung	negative
überschreiten	negative
ansprechend	positive
schliessen	positive
destruktion	negative
zerstörung	negative
coup	negative
rodung	negative
zerlegung	negative
abholzung	negative
ausrotten	negative
ausrottung	negative
zerstückelung	negative
hart	positive
vorzeigbar	positive
anschlag	negative
spekulieren	positive
kinderprostitution	negative
zwangsprostitution	negative
menschenrechtsverletzung	negative
hehlerei	negative
menschenhandel	negative
eigentumsdelikt	negative
erpressung	negative
überfall	negative
naziverbrechen	negative
rechtsbeugung	negative
bagatelldelikt	negative
strafsache	negative
hausfriedensbruch	negative
unterlassungssünde	negative
urheberrechtsverletzung	negative
vertragsbruch	negative
verfassungsbruch	negative
steuerdelikt	negative
kapitalverbrechen	negative
geldwäsche	negative
amoklauf	negative
schmuggel	negative
entführung	negative
tötungsdelikt	negative
drogendelikt	negative
faul	negative
apart	positive
liebreizend	positive
unwiderstehlich	positive
rassig	positive
begehrenswert	positive
verführerisch	positive
kokett	positive
scharmant	positive
charmant	positive
lieblich	positive
witz	negative
loslatzen	positive
loslachen	positive
losbrüllen	positive
losplatzen	positive
herausplatzen	positive
losprusten	positive
verschwendungssucht	negative
stierhunger	negative
prasserei	negative
bulimie	negative
schabernack	negative
gag	negative
jux	negative
ulk	negative
scherz	negative
klamauk	negative
uz	negative
beispielhaft	positive
betriebsam	positive
geschäftig	positive
agil	positive
fragwürdig	negative
unbeschädigt	positive
intakt	positive
romanze	negative
tüchtig	positive
missbrauchen	negative
unattraktiv	negative
übertretung	negative
liebelei	negative
liebesabenteuer	negative
liebesgeschichte	negative
liebschaft	negative
unsinn	negative
eifrig	positive
arbeitsam	positive
emsig	positive
fröhlich	positive
rummel	positive
patzen	negative
tat	negative
königlich	positive
altadlig	positive
kleinadlig	positive
feudalistisch	positive
altadelig	positive
feudal	positive
royal	positive
kleinadelig	positive
vergnügt	positive
mustergültig	positive
vorbildlich	positive
vorbildhaft	positive
paradigmatisch	positive
unverdorben	positive
menschenfreundlich	positive
messe	positive
rechtsbruch	negative
vernichtung	negative
eliminieren	negative
straftat	negative
eliminierung	negative
gesetzesverstoss	negative
delikt	negative
auslöschung	negative
tückisch	negative
sittenlos	negative
unterstellen	positive
ausrechnen	positive
froh gestimmt	positive
frohgestimmt	positive
wohlgesonnen	positive
halb	negative
dünken	positive
juchzen	positive
jauchzen	positive
link	negative
heimtückisch	negative
arglistig	negative
platzen	negative
entsorgung	negative
notbehelfsmässig	negative
partiell	negative
notdürftig	negative
teilweise	negative
betriebsfeier	positive
winzerfest	positive
betriebsfest	positive
erntedank	positive
erntedankfest	positive
trauerfeier	positive
jubiläum	positive
fete	positive
familienfest	positive
richtfest	positive
familienfeier	positive
mummenschanz	positive
abschiedsfeier	positive
weinfest	positive
aufrichte	positive
jubiläumsfeier	positive
trauerfeierlichkeit	positive
abschiedsparty	positive
party	positive
maskenfest	positive
unangemessen	negative
inadäquat	negative
selbstverliebt	negative
eingebildet	negative
tippen	positive
arbeitswillig	positive
aktiv	positive
verbrennung	negative
raten	positive
ahnen	positive
wittern	positive
zusammenreimen	positive
schwanen	positive
befürchten	positive
erahnen	positive
abhängigkeit	negative
verfaulen	negative
tatkräftig	positive
arbeitsfreudig	positive
servil	positive
beflissen	positive
diensteifrig	positive
übereifrig	positive
erbgut	positive
königsgut	positive
krongut	positive
kronland	positive
offensiv	negative
hochherrschaftlich	positive
nobel	positive
unanständig	negative
menschenwürdig	positive
human	positive
menschlich	positive
holprig	positive
staksig	positive
betuppen	negative
mogeln	negative
schummeln	negative
zerschlagung	negative
aktenvernichtung	negative
ausmerzung	negative
abtötung	negative
bücherverbrennung	negative
extinktion	negative
glück	positive
verfehlt	negative
draufgängerisch	negative
gehässig	negative
provokativ	negative
bissig	negative
provozierend	negative
suizid	negative
selbstmord	negative
selbsttötung	negative
freitod	negative
fälschlich	negative
irrtümlich	negative
irrig	negative
fürstlich	positive
standesherrlich	positive
kaiserlich	positive
hochadelig	positive
kaiserlich-königlich	positive
hochadlig	positive
höfisch	positive
freiherrlich	positive
sexsucht	negative
arbeitssucht	negative
spielsucht	negative
sauer	negative
betörend	positive
charismatisch	positive
dankbar	positive
aufgebracht	negative
geharnischt	negative
teuflisch	negative
dämonisch	negative
diabolisch	negative
satanisch	negative
spass	negative
beknackt	negative
ungerecht	negative
solide	positive
solid	positive
prächtig	positive
prachtvoll	positive
verletzt	negative
lebenstüchtig	positive
fez	negative
gekränkt	negative
beleidigt	negative
pikiert	negative
eingeschnappt	negative
geschäftstüchtig	positive
eilfertig	positive
gelehrig	positive
angriffslustig	negative
kampfeslustig	negative
kampflustig	negative
erleichtert	positive
heilfroh	positive
umlegen	negative
faulen	negative
fäulen	negative
unfein	negative
one-night-stand	negative
sicher	positive
kappes	negative
sinnvoll	positive
sinnig	positive
flachs	negative
flause	negative
mätzchen	negative
allotria	negative
kinderei	negative
begehung	positive
mutmassen	positive
wähnen	positive
vermuten	positive
bösartig	negative
unfertig	negative
wohltuend	positive
feingeschnitten	positive
fein geschnitten	positive
ehren	positive
halbherzig	negative
meierei	positive
halten	positive
ablösung	negative
rudimentär	negative
durchbrochen	negative
ergänzungsbedürftig	negative
anteilig	negative
meucheln	negative
kaltmachen	negative
killen	negative
morden	negative
immobil	positive
vornehm	positive
unelastisch	positive
hexensabbat	positive
freudenfest	positive
einweihungsfeier	positive
sommerfest	positive
stadtfest	positive
jahrhundertfeier	positive
erntefest	positive
schlachtfest	positive
jubelfeier	positive
fussballfest	positive
julfest	positive
strassenfest	positive
schützenfest	positive
adventsfeier	positive
burgfest	positive
begräbnisfeierlichkeit	positive
sängerfest	positive
herbstfest	positive
budenzauber	positive
turnfest	positive
nikolausfeier	positive
stiftungsfest	positive
umtrunk	positive
totenfeier	positive
sportfest	positive
patronatsfest	positive
walpurgisnacht	positive
religiöses fest	positive
trachtenfest	positive
siegesfeier	positive
filmfest	positive
volksfest	positive
kommers	positive
schulfest	positive
eröffnungsfeier	positive
gedenkfeier	positive
fiesta	positive
frühlingsfest	positive
dorffest	positive
weihnachtsfeier	positive
kinderfest	positive
kirchenfest	positive
abschlussfeier	positive
krönungsfeierlichkeit	positive
grundsteinlegung	positive
silvester	positive
festival	positive
illusion	negative
edelmütig	positive
polterabend	positive
hybrid	negative
geckenhaft	negative
anmassend	negative
altklug	negative
besserwisserisch	negative
beinhart	positive
knallhart	positive
friedlich	positive
perfid	negative
perfide	negative
unglücklich	negative
sittlich	positive
verschlagen	negative
intrigant	negative
traurig	negative
kiki	negative
gesinnt	positive
wohlgesinnt	positive
renommiert	positive
zerhauen	negative
zerkloppen	negative
mau	negative
erbhof	positive
ortsfest	positive
hieratisch	positive
boshaft	negative
niederträchtig	negative
meierhof	positive
sinnhaft	positive
sinnreich	positive
mumpitz	negative
bockmist	negative
stuss	negative
schwachfug	negative
quatsch	negative
unfug	negative
nonsens	negative
humbug	negative
blödsinn	negative
schwachsinn	negative
freibeuterei	negative
seeräuberei	negative
piraterie	negative
hacienda	positive
hazienda	positive
herrenhof	positive
fronhof	positive
herausfordernd	negative
forsch	negative
kriegerisch	negative
streitlustig	negative
sucht	negative
suchtverhalten	negative
suchterkrankung	negative
betriebsspionage	negative
werksspionage	negative
firmenspionage	negative
wild	negative
gefällig	positive
schwer erziehbar	negative
schwererziehbar	negative
starr	positive
verworfen	negative
verwerflich	negative
unbeschadet	positive
unzerstört	positive
flau	negative
verschimmeln	negative
unästhetisch	negative
zerlöchern	negative
umgekehrt	negative
verkehrt	negative
vermeintlich	negative
angeblich	negative
erwarten	positive
erhängen	negative
böswillig	negative
schlecht	negative
stilsicher	positive
stilgerecht	positive
geschmackvoll	positive
stilvoll	positive
entwürdigend	negative
unversöhnlich	negative
mögen	positive
komfortabel	positive
pleite gehen	negative
pleitieren	negative
bankrottieren	negative
felsenfest	positive
bombensicher	positive
vision	negative
hämisch	negative
maliziös	negative
phantombild	negative
verherrlichung	positive
phantom	negative
seppuku	negative
harakiri	negative
gickeln	positive
trugbild	negative
faulig	negative
verfault	negative
folter	negative
zollen	positive
verspielen	negative
schändung	negative
zerteppern	negative
zerdeppern	negative
zertrümmern	negative
kokainmissbrauch	negative
kokainabhängigkeit	negative
heroinmissbrauch	negative
kokainsucht	negative
heroinabhängigkeit	negative
heroinsucht	negative
folterung	negative
vergewaltigung	negative
grienen	positive
auffliegen	negative
beutezug	negative
autodiebstahl	negative
raubzug	negative
automobildiebstahl	negative
taschenspielertrick	negative
kunstgriff	negative
unfallflucht	negative
unbeweglich	positive
finesse	negative
unvollkommen	negative
übertreten	negative
dienstvergehen	negative
ordnungswidrigkeit	negative
landfriedensbruch	negative
rechtswidrigkeit	negative
rechtsverstoss	negative
kavaliersdelikt	negative
sakrileg	negative
vertragsverletzung	negative
unvollständig	negative
grandios	positive
herausragend	positive
exzellent	positive
funktionstüchtig	positive
lauffähig	positive
funktionsfähig	positive
betriebsfähig	positive
unzüchtig	negative
feierlichkeit	positive
unerbittlich	positive
verfallen	negative
überwerfen	negative
austricksen	negative
unflexibel	positive
entrinnen	negative
dezentralisierung	negative
dezentralisieren	negative
dezentralisation	negative
hochwertig	positive
ablaufen	negative
defizitär	negative
lückenhaft	negative
feier	positive
festivität	positive
festlichkeit	positive
unedel	negative
verschandeln	negative
hochnäsig	negative
überheblich	negative
abgehoben	negative
herablassend	negative
unkeusch	negative
verwünscht	negative
vermaledeit	negative
verflucht	negative
verflixt	negative
verdämmern	negative
schaffen	positive
modern	negative
vermodern	negative
fuchsteufelswild	negative
zornig	negative
fuchsig	negative
erzürnt	negative
beschummeln	negative
infam	negative
durchtrieben	negative
hinterfotzig	negative
deformiert	negative
hochklassig	positive
vortrefflich	positive
vorzüglich	positive
moralisch	positive
lustbetont	positive
lustvoll	positive
terrorismus	negative
unschuldig	positive
humanitär	positive
philanthropisch	positive
genozid	negative
völkermord	negative
süffisant	negative
hündisch	negative
hasserfüllt	negative
stiefmütterlich	negative
schimmeln	negative
unerklärbar	negative
unerklärlich	negative
frivol	negative
pikant	negative
anstössig	negative
halt	negative
verhältnis	negative
bescheuert	negative
belämmert	negative
behämmert	negative
ausländerfeindlich	negative
enteilen	negative
geliebt	positive
masche	negative
dreh	negative
zügellos	negative
rittergut	positive
kirchengut	positive
schlossgut	positive
unflätig	negative
mustergut	positive
reichsgut	positive
familiengut	positive
kammergut	positive
weingut	positive
klostergut	positive
bauerngut	positive
anerkannt	positive
unschädlich	positive
versagen	negative
zerknallen	negative
irregulär	negative
bevorzugen	positive
unfreundlich	negative
ausschweifend	negative
nichterfüllung	negative
absprung	negative
abspringen	negative
nichteinhaltung	negative
abkoppelung	negative
abkopplung	negative
ausgliedern	negative
ausgliederung	negative
unzutreffend	negative
unrecht	negative
orgiastisch	negative
unwahr	negative
körperverletzung	negative
geisselung	negative
bluttat	negative
quälerei	negative
auspeitschung	negative
dekadent	negative
entartet	negative
heruntergekommen	negative
anzüglich	negative
strassenraub	negative
bankraub	negative
ladendiebstahl	negative
industriespionage	negative
menschenraub	negative
wirtschaftsspionage	negative
produktpiraterie	negative
infiltration	negative
identitätsdiebstahl	negative
plünderungszug	negative
gegenspionage	negative
pferdediebstahl	negative
handtaschenraub	negative
plünderung	negative
grenzüberschreitung	negative
unergründlich	negative
unerfindlich	negative
xenophob	negative
fremdenfeindlich	negative
rassistisch	negative
ruchbar	negative
ausklinkung	negative
stopp	negative
aussergewöhnlich	positive
giggeln	positive
gackern	positive
giggern	positive
verkehr	negative
unerreichbar	positive
süss	positive
matt	negative
unecht	negative
hilfreich	positive
unberechtigt	negative
uneinholbar	positive
unübertroffen	positive
unnachahmlich	positive
unerreicht	positive
gemeingefährlich	negative
unbarmherzig	positive
verträglich	positive
prätentiös	negative
verkommen	negative
ethisch	positive
seitensprung	negative
eskapade	negative
wichtigtuerisch	negative
grossspurig	negative
grossmäulig	negative
grosskotzig	negative
prahlerisch	negative
angeberisch	negative
unbefugt	negative
unautorisiert	negative
liebesaffäre	negative
liaison	negative
techtelmechtel	negative
aufhängen	negative
doof	negative
blöd	negative
dämlich	negative
dull	negative
seelig	positive
glückselig	positive
überglücklich	positive
hoffnungsfunke	positive
lichtblick	positive
hoffnungsschimmer	positive
hoffnungsstrahl	positive
behaglich	positive
gemütlich	positive
hängen	negative
täuschen	negative
strahlen	positive
grundfalsch	negative
unkorrekt	negative
kontrafaktisch	negative
bringen	negative
holocaust	negative
abschirmung	negative
abfall	negative
straucheln	negative
emanzipation	negative
hochachten	positive
würdigen	positive
ästimieren	positive
strömungsabriss	negative
sezession	negative
vereinsamung	negative
quarantäne	negative
freisetzung	negative
wasserabspaltung	negative
frank	positive
schäferstündchen	negative
zuträglich	positive
sex	negative
geschlechtsverkehr	negative
koitus	negative
beischlaf	negative
sexualakt	negative
coitus	negative
gv	negative
geschlechtsakt	negative
fick	negative
undankbar	negative
falle	negative
exzeptionell	positive
ausserordentlich	positive
ungefährdet	positive
überzeugt	positive
legendär	positive
klasse	positive
tugendlich	positive
endgeil	positive
tugendreich	positive
mythisch	positive
himmlisch	positive
legendenhaft	positive
spitze	positive
herrlich	positive
paradiesisch	positive
tugendhaft	positive
abschneiden	negative
henken	negative
aufknüpfen	negative
deflation	negative
tarnung	negative
schleifung	negative
bilanzfälschung	negative
geschichtsfälschung	negative
urkundenfälschung	negative
wahlfälschung	negative
halluzination	negative
paarung	negative
isolierung	negative
berechenbar	positive
isolation	negative
geruhsam	positive
zugänglich	positive
pharisäisch	negative
bigott	negative
scheinheilig	negative
leiden	positive
unberechenbar	negative
hochhalten	positive
segregation	negative
abspaltung	negative
abtrennung	negative
lostrennung	negative
separation	negative
loslösung	negative
judenfeindlich	negative
antisemitisch	negative
unangebracht	negative
drollig	positive
wohlgeformt	positive
wohl geformt	positive
verschalen	negative
verstreichen	negative
liquidation	negative
liquidierung	negative
morphiumsucht	negative
verrinnen	negative
anbetung	positive
vergötterung	positive
verbindung	negative
unkalkulierbar	negative
erfreulich	positive
landgut	positive
ausruhen	positive
nichtstun	positive
faulenzen	positive
leimen	negative
gerecht	positive
standfest	positive
liederlich	negative
lasterhaft	negative
ungehobelt	negative
wüst	negative
liebesfähig	positive
liebevoll	positive
liebreich	positive
missliebig	negative
verhasst	negative
strahlend	positive
gesundheitsdienlich	positive
gesund	positive
unbegründet	negative
prunkvoll	positive
pompös	positive
prunkhaft	positive
stranden	negative
atemberaubend	positive
atemraubend	positive
versterben	negative
verscheiden	negative
ablinken	negative
behumpsen	negative
kungeln	negative
mauscheln	negative
hinterziehen	negative
unterschlagen	negative
behumsen	negative
linken	negative
gemocht	positive
niedlich	positive
goldig	positive
herzig	positive
possierlich	positive
putzig	positive
knuffig	positive
gesundheitsförderlich	positive
gesundheitsfördernd	positive
grob	negative
grinsen	positive
gebibbel	positive
kichern	positive
geiern	positive
gegeier	positive
gegrinse	positive
gibbeln	positive
gekicher	positive
unpassend	negative
verrotten	negative
gären	negative
grundlos	negative
unerhört	negative
ungehörig	negative
gutshof	positive
hofgut	positive
qualitätsvoll	positive
umgänglich	positive
geschätzt	positive
anstellen	negative
kumpelhaft	positive
jovial	positive
anwesen	positive
umschwärmt	positive
umworben	positive
vergöttert	positive
geehrt	positive
unbegreiflich	negative
unbegreifbar	negative
geschichte	negative
friedliebend	positive
unfassbar	negative
grausamkeit	negative
präferieren	positive
richtig	positive
schwierig	negative
preisgekrönt	positive
bestechend	positive
famos	positive
fulminant	positive
herbeiwünschen	positive
herbeisehnen	positive
fassen	positive
verlangen	positive
freudig	positive
verwickelt	negative
schimmelig	negative
verschimmelt	negative
verrottet	negative
unansehnlich	negative
gerechtigkeit	positive
aussetzen	negative
ersichtlich	positive
fair	positive
erhöhung	positive
druckfest	positive
kabbalistisch	negative
zeitüberschreitung	negative
transzendenz	negative
übersättigung	negative
vertrauenswürdig	positive
vergnügen	positive
nützlich	positive
verworren	negative
verwoben	negative
schwindlig	negative
vielschichtig	negative
verzwickt	negative
komplex	negative
verzwackt	negative
vertrackt	negative
beziehungsreich	negative
offenkundig	positive
offensichtlich	positive
offenbar	positive
manifest	positive
sichtlich	positive
einschlagen	negative
verdrecken	negative
gelungen	positive
akzeptabel	positive
unstandesgemäss	negative
ungerechtfertigt	negative
unsachgemäss	negative
unrichtig	negative
scheissdreck	negative
scheibenkleister	negative
kalkulierbar	positive
brechen	negative
geniessbar	positive
bekömmlich	positive
bröseln	negative
krümeln	negative
eingängig	positive
unverhältnismässig	negative
unziemlich	negative
unbillig	negative
rechtschaffenheit	positive
fairness	positive
ausfressen	negative
verzapfen	negative
stramm	positive
essbar	positive
grenzübertritt	negative
ausfall	negative
glückstrahlend	positive
glorifizierung	positive
glorifikation	positive
euthanasie	negative
wohlig	positive
freund	positive
seriös	positive
vierschrötig	negative
ungeschlacht	negative
grobschlächtig	negative
flop	negative
trauerspiel	negative
reinfall	negative
debakel	negative
desaster	negative
armageddon	negative
fiasko	negative
gesetzt	positive
bitterböse	negative
erbost	negative
schmiergeldaffäre	negative
bestechungsaffäre	negative
sonnig	positive
verbindlich	positive
lebensgefährlich	negative
lebensbedrohend	negative
risikobehaftet	negative
lebensbedrohlich	negative
riskant	negative
risikoreich	negative
aussetzer	negative
bestmöglich	positive
beschmunzeln	positive
wollen	positive
zufrieden	positive
streich	negative
verunglücken	negative
zerstampfen	negative
ungeliebt	negative
weltberühmt	positive
adel	positive
befriedigend	positive
bürgerlich	negative
ernsthaft	positive
formen	positive
begattung	negative
deckakt	negative
prellen	negative
mordfall	negative
heiter	positive
nutzbringend	positive
geraten	positive
genehm	positive
unverschämt	negative
unverfroren	negative
impertinent	negative
wahrnehmungstäuschung	negative
sinnestäuschung	negative
vorwurfsvoll	negative
verschiebung	negative
optimal	positive
wasserqualität	positive
wassergüte	positive
herwünschen	positive
gutherzig	positive
phantastisch	positive
fantastisch	positive
imageträchtig	positive
erfolgversprechend	positive
grossherzig	positive
meisterhaft	positive
meisterlich	positive
prestigeträchtig	positive
erfolg versprechend	positive
wundervoll	positive
wunderbar	positive
poltern	negative
zetern	negative
erträglich	positive
floppen	negative
missraten	negative
stümpern	negative
dilettieren	negative
pfuschen	negative
aussetzung	negative
verformt	negative
saublöd	negative
stupide	negative
einfältig	negative
saudumm	negative
tumb	negative
beschränkt	negative
töricht	negative
saudoof	negative
stupid	negative
graziös	positive
anmutig	positive
liquidieren	negative
unbequem	negative
verbraucht	negative
strangulation	negative
kindermord	negative
doppelmord	negative
ritualmord	negative
ehrenmord	negative
fememord	negative
meuchelmord	negative
tyrannenmord	negative
raubmord	negative
judenmord	negative
brudermord	negative
giftmord	negative
lynchmord	negative
justizmord	negative
enthauptung	negative
auftragsmord	negative
ausspielen	negative
glücksgefühl	positive
formell	positive
nutzlos	negative
zernichten	negative
formschön	positive
formvollendet	positive
wettern	negative
behandlungsgut	positive
kulturgut	positive
gemeingut	positive
sammlungsgut	positive
rüstungsgut	positive
gefahrgut	positive
investitionsgut	positive
versorgungsgut	positive
massenstückgut	positive
volksgut	positive
liedgut	positive
massengut	positive
einschlag	negative
unliebsam	negative
zufriedenstellend	positive
zwei	positive
ertragbar	positive
lauter	positive
hinrichten	negative
exekutieren	negative
schmierig	negative
analsex	negative
entjungferung	negative
oralverkehr	negative
defloration	negative
analverkehr	negative
oralsex	negative
neppen	negative
übervorteilen	negative
hinwegtäuschen	negative
hereinlegen	negative
fremdgehen	negative
hintergehen	negative
hörnen	negative
bluffen	negative
verlegung	negative
unfair	negative
gutartig	positive
schmunzeln	positive
baustopp	negative
black-out	negative
bauabbruch	negative
blackout	negative
abschaltung	negative
ansetzen	positive
menschenfeindlich	negative
versprechen	positive
hoffen	positive
umweltverträglich	positive
naturverträglich	positive
erholsam	positive
entspannend	positive
heilsam	positive
heilend	positive
holzeinschlag	negative
holzschlag	negative
unbescholten	positive
fehlschlag	negative
abschalten	negative
redlich	positive
flussüberquerung	negative
leutselig	positive
magenfreundlich	positive
kollegial	positive
kameradschaftlich	positive
freundschaftlich	positive
hautfreundlich	positive
fürsorglich	positive
bedienungsfreundlich	positive
kundenfreundlich	positive
partnerschaftlich	positive
wartungsfreundlich	positive
investitionsfreundlich	positive
leserfreundlich	positive
sonnenbaden	positive
erfrischung	positive
erfrischen	positive
sonnenbad	positive
laster	negative
fehlleistung	negative
scheitern	negative
atlantiküberquerung	negative
problemvoll	negative
unzufrieden	negative
abgelaufen	negative
rechtschaffen	positive
marktführend	positive
marktbeherrschend	positive
untadelig	positive
untadlig	positive
liebenswürdig	positive
liebenswert	positive
verlebt	negative
auszeichnen	positive
bewundert	positive
verehrt	positive
viel gefragt	positive
vielgefragt	positive
präferenz	positive
bildschön	positive
wunderschön	positive
schmuck	positive
vorliebe	positive
dekorativ	positive
judenfeindlichkeit	negative
judenhass	negative
dreier	negative
gruppensex	negative
telefonsex	negative
kopulation	negative
nummer	negative
schädlich	negative
mordtat	negative
ermordung	negative
flüssig	negative
unsinnig	negative
sinnlos	negative
hochstimmung	positive
euphorie	positive
hochgefühl	positive
entrücktheit	positive
verzückung	positive
ekstase	positive
zurückwollen	positive
möchten	positive
zudenken	positive
erwünschen	positive
beabsichtigen	positive
erhoffen	positive
tücke	negative
belieben	positive
sprengen	negative
heimtücke	negative
arglist	negative
alkoholrausch	negative
trunkenheit	negative
betrunkenheit	negative
ranzig	negative
verderbt	negative
luderhaft	negative
günstig	positive
wut	negative
ehrenhaft	positive
kuschlig	positive
kuschelig	positive
hilfsbereit	positive
locker	negative
funkstille	negative
lohnstopp	negative
deaktivierung	negative
abfederung	negative
einstellungsstopp	negative
aufnahmestopp	negative
bremsung	negative
preisstopp	negative
zerfressen	negative
indiskret	negative
zerfransen	negative
wegwünschen	positive
zweckmässig	positive
fragil	positive
kolloidal	positive
kolloid	positive
zerbrechlich	positive
ablehnen	negative
einschätzbar	positive
abgang	negative
sendung	negative
gelingen	positive
problem	negative
scharm	positive
charme	positive
akzeptieren	positive
ergebnisreich	positive
erfolgreich	positive
glückreich	positive
chancenreich	positive
geeignet	positive
unterbruch	negative
einhalt	negative
unterbrechung	negative
ungiftig	positive
hexenverfolgung	negative
pogrom	negative
christenverfolgung	negative
judenverfolgung	negative
spitzfindig	negative
spöttisch	negative
spitz	negative
unappetitlich	negative
ungepflegt	negative
zwecklos	negative
silberkonfirmation	positive
goldkonfirmation	positive
silberne konfirmation	positive
goldene konfirmation	positive
taktvoll	positive
überquerung	negative
überqueren	negative
zusammenbruch	negative
malmen	negative
kleinkriegen	negative
einstampfen	negative
kaputtmachen	negative
beschädigen	negative
zunichtemachen	negative
devastieren	negative
randalieren	negative
verheeren	negative
zerfräsen	negative
zerpflügen	negative
auslöschen	negative
ätzen	negative
zerschiessen	negative
demolieren	negative
verwüsten	negative
zusammenschlagen	negative
zernagen	negative
einhauen	negative
bomben	negative
einstossen	negative
zersingen	negative
hinterlist	negative
zerstechen	negative
crash	negative
ikonoklasmus	negative
kahlschlag	negative
entwaldung	negative
bildersturm	negative
charakterfest	positive
integer	positive
verdaulich	positive
unbedenklich	positive
sünde	negative
verkehrsverstoss	negative
falschgeld	negative
wert	positive
ehebruch	negative
reizend	positive
scheiss	negative
zerfurchen	negative
amüsieren	positive
einwerfen	negative
wirtschaftsverträglich	positive
magenverträglich	positive
menschenverträglich	positive
stadtverträglich	positive
trinkbar	positive
sozialverträglich	positive
probiotisch	positive
nahrhaft	positive
hautverträglich	positive
gesellschaftsverträglich	positive
ansprechen	positive
bereicherung	negative
prominent	positive
eminent	positive
spamming	negative
instrumentalisierung	negative
besuch	negative
heimelig	positive
lauschig	positive
einladend	positive
wohnlich	positive
unkompliziert	positive
wertschätzen	positive
einsatz	negative
wohltätig	positive
mildtätig	positive
caritativ	positive
karitativ	positive
melancholisch	negative
schwermütig	negative
skandal	negative
spionageaffäre	negative
korruptionsaffäre	negative
finanzaffäre	negative
spendenaffäre	negative
abhöraffäre	negative
hundert-jahr-feier	positive
gartenparty	positive
ehejubiläum	positive
abifeier	positive
hundertjahrfeier	positive
tausendjahrfeier	positive
hochzeitstag	positive
gartenfest	positive
1000-jahr-feier	positive
abiturfeier	positive
absendung	negative
einsendung	negative
schicken	negative
abschicken	negative
eisenhochzeit	positive
goldhochzeit	positive
diamantene hochzeit	positive
silberhochzeit	positive
goldene hochzeit	positive
eiserne hochzeit	positive
diamanthochzeit	positive
silberne hochzeit	positive
unerfreulich	negative
entwurzeln	negative
imitation	negative
glimpflich	positive
ungetrübt	positive
überlisten	negative
zärtlich	positive
umstritten	negative
strittig	negative
lebensqualität	positive
plagiat	negative
unakzeptabel	negative
misslungen	negative
toll	positive
scharfsinnig	positive
kontrovers	negative
bestreitbar	negative
gutherzigkeit	positive
grossmut	positive
amtsmissbrauch	negative
machtmissbrauch	negative
kindesmissbrauch	negative
nehmen	positive
falsifikat	negative
missglücken	negative
reputierlich	positive
gediegen	positive
rein	positive
beschwingt	positive
kumpanei	negative
unnütz	negative
regulär	positive
übertölpeln	negative
ungeschützt	negative
zerfall	negative
ausgelassen	positive
quietschvergnügt	positive
infernal	negative
vetternwirtschaft	negative
vorteilsnahme	negative
nepotismus	negative
entzündung	negative
verfall	negative
bodenqualität	positive
oberflächengüte	positive
textqualität	positive
gewässergüte	positive
ungünstig	negative
nichtsnutzig	negative
unnützlich	negative
leibfeindlich	negative
feindselig	negative
antideutsch	negative
kirchenfeindlich	negative
antiklerikal	negative
wünschenswert	positive
sagenhaft	positive
berauschend	positive
gehoben	positive
begrüssenswert	positive
herzensgut	positive
sensationell	positive
perfekt	positive
prima	positive
unfehlbar	positive
märchenhaft	positive
okay	positive
idyllisch	positive
erstklassig	positive
bedenkenswert	positive
traumhaft	positive
spitzenmässig	positive
elefantös	positive
ideal	positive
deutschfeindlich	negative
besser	positive
unübertrefflich	positive
ehrenvoll	positive
blendend	positive
überragend	positive
gutmütig	positive
phänomenal	positive
körperfeindlich	negative
feindschaftlich	negative
letal	negative
brandgefährlich	negative
tödlich	negative
hochgefährlich	negative
amoralisch	negative
schuldig	negative
liebhaben	positive
zweifellos	positive
zweifelsfrei	positive
unbezweifelbar	positive
feinkörnig	positive
duftig	positive
feingemahlen	positive
filigran	positive
glühend	positive
fesselnd	positive
begeisternd	positive
guerilla	negative
zerplatzen	negative
vollmundig	negative
lautstark	negative
zynisch	negative
höhnisch	negative
schnippisch	negative
scharfzüngig	negative
hervorragen	positive
machen	positive
mutig	positive
standhaft	positive
billigkeit	positive
verwüstung	negative
selbstzerstörung	negative
waldrodung	negative
sprengung	negative
umweltzerstörung	negative
verschrottung	negative
demolition	negative
implosion	negative
kriegszerstörung	negative
brandrodung	negative
sprengzündung	negative
segmentierung	negative
lebensraumzerstörung	negative
abwrackung	negative
selbstentzündung	negative
zertrümmerung	negative
primfaktorzerlegung	negative
entrüsten	negative
anschmieren	negative
bescheissen	negative
explosion	negative
tagesgeschäft	negative
schiessen	negative
verbinden	positive
mephistophelisch	negative
luziferisch	negative
heuchlerisch	negative
elegisch	negative
deprimiert	negative
original	positive
durchfall	negative
unlöslich	negative
triumphieren	positive
pleite	negative
domschatz	positive
kirchenschatz	positive
guerillakrieg	negative
unangenehm	negative
schmeichelhaft	positive
kläffen	negative
verbrennen	negative
gelitten	positive
leidenschaftlich	positive
hochkomplex	negative
facettenreich	negative
vergnügtheit	positive
kringeln	positive
zuvorkommend	positive
entgegenkommend	positive
strohdumm	negative
strohdoof	negative
trottelhaft	negative
dusslig	negative
idiotenhaft	negative
dusselig	negative
idiotisch	negative
trottelig	negative
wohlgefallen	positive
ausschütten	positive
glaubhaftigkeit	positive
integrität	positive
ritterlichkeit	positive
auslachen	positive
verlachen	positive
ergötzen	positive
foppen	negative
firmenjubiläum	positive
bühnenjubiläum	positive
betriebsjubiläum	positive
vereinsjubiläum	positive
stadtjubiläum	positive
gründungsjubiläum	positive
dinnerparty	positive
cocktailparty	positive
silvesterparty	positive
jam	positive
thronjubiläum	positive
geburtstag	positive
dienstjubiläum	positive
lan-party	positive
entlassungsfeier	positive
trickreich	negative
listenreich	negative
fintenreich	negative
gnadenhochzeit	positive
petersilienhochzeit	positive
rosenhochzeit	positive
aufnahme	negative
aufenthalt	negative
weinen	negative
ehre	positive
gelächter	positive
zusammenfügen	negative
zusammenfügung	negative
nominell	negative
gewagt	negative
gefährdend	negative
ungesichert	negative
selbstmörderisch	negative
düpieren	negative
tragbar	positive
gefallen	positive
stabil	positive
naherholung	positive
floating	positive
vorgeblich	negative
trügerisch	negative
täuschend	negative
kappe	negative
köpfen	negative
renovierungsbedürftig	negative
sanierungsbedürftig	negative
pfuscherei	negative
pfusch	negative
pfuschwerk	negative
murks	negative
dachhimmel	negative
gitterrost	negative
fehlleitend	negative
gütig	positive
keifen	negative
erlegen	negative
vierteilen	negative
gebundenheit	negative
keimbahn	positive
abkanzeln	negative
anscheissen	negative
runtermachen	negative
anranzen	negative
heruntermachen	negative
runterputzen	negative
herunterkanzeln	negative
abkapiteln	negative
steinigen	negative
lynchen	negative
vergasen	negative
kreuzigen	negative
rädern	negative
entspannung	positive
umkämpft	positive
bejubeln	positive
sinnlich	positive
selbstliebe	positive
vaterlandsliebe	positive
nächstenliebe	positive
pickelig	negative
entstellt	negative
gottesliebe	positive
hübsch	positive
potthässlich	negative
unförmig	negative
rassenhass	negative
minne	positive
mitmenschlichkeit	positive
eros	positive
mutterliebe	positive
missvergnügt	negative
kriegsbegeisterung	positive
superstimmung	positive
angefressen	negative
grundübel	negative
bombenstimmung	positive
schwärmerei	positive
fanatismus	positive
enthusiasmus	positive
ausklagen	negative
idealismus	positive
einklagen	negative
schiffbruch	negative
umbringen	negative
dahinraffen	negative
massakrieren	negative
hinwegraffen	negative
niedermetzeln	negative
ertränken	negative
ersäufen	negative
suizidieren	negative
ermorden	negative
selbst töten	negative
zurückwünschen	positive
heftig	positive
zurechtstutzen	negative
zurechtweisen	negative
energisch	positive
gegengewalt	negative
brachialgewalt	negative
terror	negative
tageskasse	negative
tageseinnahme	negative
chancenlos	negative
glücklos	negative
erfolglos	negative
ergebnislos	negative
ungeeignet	negative
einbringung	negative
wonne	positive
heil	positive
lebensglück	positive
triumph	positive
schrecken	negative
zusagen	positive
angemessen	positive
adäquat	positive
unproblematisch	positive
sinn	positive
fortwünschen	positive
friedfertig	positive
friedvoll	positive
brutalität	negative
ungezogen	negative
bestimmt	positive
furios	positive
schnoddrig	negative
polemisch	negative
vorlaut	negative
verleumderisch	negative
definit	positive
absagen	negative
absehen	positive
positiv	positive
schädigend	negative
abträglich	negative
schuldentilgung	negative
amortisation	negative
denken	positive
zweckfrei	negative
unzweckmässig	negative
profanieren	negative
destruieren	negative
entstellen	negative
unehrenhaft	negative
grundsolid	positive
grundsolide	positive
eingriff	negative
verkleidung	negative
arbeitsplatzabbau	negative
rationalisierung	negative
wegrationalisierung	negative
beschäftigungsabbau	negative
personalabbau	negative
abgeklärt	positive
ritterlich	positive
erbmasse	positive
bilden	positive
gewaltverherrlichung	positive
maskerade	negative
umfassen	positive
disziplin	negative
undurchschaubar	negative
deprimierend	negative
abdeckung	negative
bedrohung	negative
dienlich	positive
treffen	negative
kostümierung	negative
maskierung	negative
intervention	negative
eingreifen	negative
einschreiten	negative
inspizierung	negative
inspizieren	negative
beobachtung	negative
beobachten	negative
aprilscherz	negative
qualität	positive
tierliebhaber	positive
tiernärrin	positive
tiernarr	positive
tierfreund	positive
tierliebhaberin	positive
tierfreundin	positive
dns	positive
notorisch	positive
schadenfroh	negative
schurkisch	negative
garstig	negative
fies	negative
mies	negative
allbekannt	positive
zug	negative
einsetzung	negative
dna	positive
erbsubstanz	positive
desoxyribonukleinsäure	positive
erbmaterial	positive
genom	positive
originell	positive
schmiergeldzahlung	negative
bestechung	negative
fata morgana	negative
zerrbild	negative
zersplittern	negative
rasend	positive
verstellen	negative
misserfolg	negative
akt	negative
mistig	negative
oll	negative
ätzend	negative
leidtragend	negative
betroffen	negative
leid tragend	negative
frenetisch	positive
angelegenheit	negative
komplizieren	negative
verbrecher	negative
applikation	negative
demagogie	negative
volksverhetzung	negative
hochkompliziert	negative
agitation	negative
verständlich	positive
lacher	positive
parole	negative
konstruktiv	positive
löschung	negative
kettenbruch	negative
zauberhaft	positive
anwendung	negative
fiebern	positive
spiel	negative
fordern	positive
tilgung	negative
taktlos	negative
essen	negative
stolz	positive
festhalten	positive
entschieden	positive
entschlossen	positive
frage	negative
demotivieren	negative
ungeschrieben	positive
flagrant	positive
postulieren	positive
unkomfortabel	negative
produzieren	positive
unterbringung	negative
resolut	positive
inspirieren	positive
behilflich	positive
geklärt	positive
sammlung	negative
unsinnigkeit	negative
treff	negative
aufsässigkeit	negative
aufmüpfigkeit	negative
zärtlichkeit	negative
neuwertig	positive
wertig	positive
zusammentreffen	negative
siegesgewiss	positive
siegessicher	positive
siegesbewusst	positive
arg	negative
arglistigkeit	negative
apokryph	negative
erbittert	negative
streit	negative
angebracht	positive
übernahme	negative
verärgern	negative
macke	negative
ertragssicher	positive
vorherbestimmt	positive
fraglos	positive
untrüglich	positive
unzweifelhaft	positive
deterministisch	positive
todsicher	positive
schändlich	negative
beherbergung	negative
einkleidung	negative
feind	negative
kriegsglück	positive
kardinaltugend	positive
anführung	negative
zurücknehmen	positive
familienfeindlich	negative
technikfeindlich	negative
umweltfeindlich	negative
frauenfeindlich	negative
torfstechen	negative
kohleabbau	negative
kohleförderung	negative
torfstich	negative
torfabbau	negative
kohlenförderung	negative
verwendung	negative
korrelation	negative
effekt	positive
mahlzeit	negative
mahl	negative
rechnen	positive
sammeltätigkeit	negative
wiedernehmen	positive
sammelaktion	negative
zutreffend	positive
aufbewahrung	negative
campagne	negative
verwahrung	negative
versorgung	negative
herrichtung	negative
vorbereitung	negative
selbstbefriedigung	negative
kampagne	negative
haupttätigkeit	negative
bereitstellung	negative
lagerung	negative
vorkehrung	negative
hauptaktivität	negative
kerntätigkeit	negative
onanie	negative
gestellung	negative
masturbation	negative
aktion	negative
verfehlung	negative
leitung	negative
etikettenschwindel	negative
schwindelgefühl	negative
unvorteilhaft	negative
entheiligen	negative
entweihen	negative
werk	negative
sportart	negative
klug	positive
verschluss	negative
schliessung	negative
inakzeptabel	negative
verwischung	negative
misslich	negative
demonstration	negative
verjagen	negative
vertreibung	negative
fortjagen	negative
einholung	negative
aufholen	negative
einholen	negative
vortäuschen	negative
kombination	negative
präsentation	negative
auseinandersetzung	negative
nahestehen	positive
sympathisieren	positive
bindung	negative
konflikt	negative
filmliebhaberin	positive
entwerfen	positive
filmfreundin	positive
filmfreund	positive
filmliebhaber	positive
filmfan	positive
zorn	negative
trübe	negative
negativ	negative
erhaben	positive
losungswort	negative
kennwort	negative
zank	negative
einsam	negative
geil	positive
dezimalzahl	negative
dezimalbruch	negative
bruchzahl	negative
trüb	negative
spielgewinn	positive
gefahr	negative
trottel	negative
idiot	negative
unterschiedlichkeit	negative
unterschied	negative
disparität	negative
vermehren	positive
mehren	positive
fortpflanzen	positive
kieferbruch	negative
fingerbruch	negative
armbruch	negative
beinbruch	negative
schlüsselbeinbruch	negative
nasenbeinbruch	negative
rippenbruch	negative
leistenbruch	negative
schädelbruch	negative
fussbruch	negative
ungleichheit	negative
überladung	positive
überfrachtung	positive
waggonladung	positive
containerladung	positive
planen	positive
christenfeindlich	negative
regimefeindlich	negative
republikfeindlich	negative
gesellschaftsfeindlich	negative
behindertenfeindlich	negative
minderheitenfeindlich	negative
kaiserfeindlich	negative
religionsfeindlich	negative
männerfeindlich	negative
fortschrittsfeindlich	negative
parteifeindlich	negative
wissenschaftsfeindlich	negative
reformfeindlich	negative
demokratiefeindlich	negative
volksfeindlich	negative
kunstfeindlich	negative
regierungsfeindlich	negative
islamfeindlich	negative
israelfeindlich	negative
schwulenfeindlich	negative
bildungsfeindlich	negative
kulturfeindlich	negative
lustfeindlich	negative
staatsfeindlich	negative
verfassungsfeindlich	negative
geistfeindlich	negative
annehmbar	positive
friede	positive
vielgeliebt	positive
bedrohlich	negative
torgefährlich	negative
existenzbedrohend	negative
explosionsgefährlich	negative
gefahrvoll	negative
fressen	negative
vergiften	negative
entgegennehmen	positive
ehrlos	negative
bescheiden	negative
allein	negative
kleidsam	positive
staunen	positive
anstand	positive
legende	positive
glücklichkeit	positive
frech	negative
überraschend	positive
zweifelhaft	negative
förderlich	positive
beschissen	negative
lausig	negative
stümperhaft	negative
ungut	negative
grottig	negative
schäbig	negative
dilettantisch	negative
miserabel	negative
unschön	negative
belachen	positive
brauchbar	positive
trostlos	negative
todtraurig	negative
todunglücklich	negative
trist	negative
trübselig	negative
bitter	negative
verbittert	negative
betrübt	negative
betätigung	negative
annahme	negative
aufdringlichkeit	negative
anfechtbar	negative
gewalttätig	negative
zerbröseln	negative
zerkrümeln	negative
tankwagen	negative
tanklastwagen	negative
tanklaster	negative
besuchen	negative
einladung	negative
angreifbar	negative
fraglich	negative
hinnehmbar	positive
nutzbar	positive
fördernd	positive
lohnenswert	positive
lohnend	positive
rahmen	positive
einrahmen	positive
einfassen	positive
austragung	negative
eingabe	negative
unverträglich	negative
bewegung	negative
sperrung	negative
ungemütlich	negative
unbehaglich	negative
zumutbar	positive
hochgeschätzt	positive
bemalung	negative
zugreifbar	positive
abrufbar	positive
recht	positive
gewiss	positive
lapsus	negative
eigenwilligkeit	negative
tun	negative
kunstfertig	positive
virtuos	positive
bewerbung	negative
griffig	positive
eintüten	negative
vertüten	negative
ziehen	negative
aushaltbar	positive
herstellen	positive
liebkosung	negative
reinigung	negative
beschädigung	negative
schritt	negative
bergarbeit	negative
ölförderung	negative
erdölförderung	negative
bergbau	negative
begeistern	positive
goldschatz	positive
erfahrungsschatz	positive
staatsschatz	positive
bodenschatz	positive
zerbeult	negative
konsequent	positive
einladen	negative
ersticken	negative
leistung	negative
dateneingabe	negative
schwäche	positive
handeln	negative
säuberung	negative
fahndung	negative
nichtbenutzung	negative
abwarten	negative
arrangierung	negative
warten	negative
rechtshandlung	negative
ränkespiel	negative
nichtgebrauch	negative
verspottung	negative
zuhören	negative
rechtsakt	negative
markierung	negative
geschäftstätigkeit	negative
sachbeschädigung	negative
handelsaktivität	negative
kennzeichnung	negative
affekthandlung	negative
hören	negative
affekttat	negative
geschäftsaktivität	negative
aufmunterung	negative
aufheiterung	negative
ermittlung	negative
handelstätigkeit	negative
verhöhnung	negative
machenschaft	negative
ausrichtung	negative
sacken	negative
frohsinn	positive
abnahme	negative
förderung	negative
regelgemäss	positive
regelgerecht	positive
vorschriftsgemäss	positive
fünf	negative
vorschriftsmässig	positive
ordnungsgemäss	positive
geniessen	positive
eintragung	negative
voraussagbar	positive
vorhersagbar	positive
ausladen	negative
muster	positive
andersartigkeit	negative
sportlich	positive
kolonialkrieg	negative
vernichtungskrieg	negative
sachsenkrieg	negative
bandenkrieg	negative
partisanenkrieg	negative
angriffskrieg	negative
weltkrieg	negative
kleinkrieg	negative
religionskrieg	negative
eroberungskrieg	negative
luftkrieg	negative
bürgerkrieg	negative
glaubenskrieg	negative
bombenkrieg	negative
ringkrieg	negative
koalitionskrieg	negative
seekrieg	negative
opiumkrieg	negative
handelskrieg	negative
atomkrieg	negative
grenzkrieg	negative
befreiungskrieg	negative
grabenkrieg	negative
krimkrieg	negative
fortsetzungskrieg	negative
landkrieg	negative
sezessionskrieg	negative
stammeskrieg	negative
blitzkrieg	negative
abnutzungskrieg	negative
bauernkrieg	negative
stellvertreterkrieg	negative
revolutionskrieg	negative
unabhängigkeitskrieg	negative
stellungskrieg	negative
historischer krieg	negative
verteidigungskrieg	negative
städtekrieg	negative
einigungskrieg	negative
klonkrieg	negative
freiheitskrieg	negative
erbfolgekrieg	negative
zweifrontenkrieg	negative
gebirgskrieg	negative
gefragt	positive
jubilieren	positive
panne	negative
fauxpas	negative
missgeschick	negative
ungeschick	negative
malheur	negative
faible	positive
lieblingsschauspieler	positive
herausspringen	negative
lieblingsschauspielerin	positive
täter	negative
entzücken	positive
erheiterung	positive
brüllen	positive
galant	positive
debil	negative
begriffsstutzig	negative
geistesschwach	negative
unterbelichtet	negative
ignorant	negative
schwachsinnig	negative
verzweiflung	negative
verderb	negative
ungemach	negative
passioniert	positive
ärgerlich	negative
enthusiastisch	positive
jagd	negative
obsessiv	positive
verve	positive
verfolgungsjagd	negative
gelangweilt	negative
geschmeidig	positive
idealistisch	positive
tadellos	positive
schwärmerisch	positive
aspiration	positive
dusel	positive
glücksfall	positive
wahr	positive
verformen	positive
einmarsch	negative
täterin	negative
straftäter	negative
delinquentin	negative
straftäterin	negative
delinquent	negative
sport	negative
prusten	positive
wiehern	positive
feixen	positive
auflachen	positive
unbeirrbar	positive
rentieren	negative
barmherzig	positive
verfügungsgewalt	negative
waffengewalt	negative
polizeigewalt	negative
legislativgewalt	negative
heftigkeit	negative
amtsgewalt	negative
feindeshand	negative
vehemenz	negative
exekutive	negative
herrschaftsgewalt	negative
entscheidungsgewalt	negative
naturgewalt	negative
hoheitsgewalt	negative
judikative	negative
regierungsgewalt	negative
abgeschlagen	negative
schmähen	negative
objektiv	positive
einrichtung	negative
weihnachten	positive
erstickung	negative
schelten	negative
abreissen	negative
schlüsselgewalt	negative
brutal	negative
zeugen	positive
fraktur	negative
knochenbruch	negative
tätigkeit	negative
weihnachtsfest	positive
weihnachtstag	positive
weihnachtsfeiertag	positive
weihnacht	positive
mittwochabend	positive
winterabend	positive
sonntagabend	positive
sommerabend	positive
wahlabend	positive
freitagabend	positive
samstagabend	positive
montagabend	positive
donnerstagabend	positive
abendstunde	positive
vortragsabend	positive
dienstagabend	positive
silvesterabend	positive
eröffnungsabend	positive
langweilen	negative
zuladung	positive
herauskommen	negative
kunstliebhaberin	positive
kunstfreund	positive
kunstliebhaber	positive
briefmarkensammlerin	positive
sportfreundin	positive
musikliebhaber	positive
musikfreund	positive
weinliebhaberin	positive
weinliebhaber	positive
weinfreund	positive
philatelistin	positive
sportsfreund	positive
philatelist	positive
sportsfreundin	positive
kunstfreundin	positive
musikliebhaberin	positive
sportfreund	positive
weinfreundin	positive
briefmarkensammler	positive
musikfreundin	positive
gewaltanwendung	negative
flugzeugladung	positive
bombenlast	positive
schiffsladung	positive
wagenladung	positive
ladeeinheit	positive
erquicklich	positive
schmeicheln	positive
abbröseln	negative
abbröckeln	negative
versuch	negative
abbildung	negative
abschlagen	negative
stopfen	positive
schöngeistig	positive
feingeistig	positive
entwickeln	positive
anklagen	negative
umschliessen	positive
presserummel	positive
medienrummel	positive
sexuelle orientierung	positive
konzipieren	positive
konzeptualisieren	positive
wählbar	positive
meister	positive
liebäugeln	positive
anfahren	negative
enthaltsam	positive
entsagungsvoll	positive
abstinent	positive
entsagend	positive
seelenmesse	positive
totenmesse	positive
entraten	negative
abschwören	negative
kaltblütig	positive
dichten	positive
verstopfen	positive
abdichten	positive
solo	negative
requiem	positive
seelenruhig	positive
kaltschnäuzig	positive
abgezockt	positive
führung	negative
anmeldung	negative
giften	negative
zusammenstauchen	negative
deckeln	negative
fluchen	negative
motzen	negative
auspusten	negative
geheimnisverrat	negative
hochverrat	negative
landesverrat	negative
saus	positive
enzymdefekt	negative
inferno	negative
gendefekt	negative
ladehemmung	negative
erklagen	negative
lamentieren	negative
murren	negative
wehklagen	negative
verklagen	negative
jammern	negative
geschützt	positive
erschlagen	negative
niederstechen	negative
abmurksen	negative
enthaupten	negative
totschlagen	negative
hinmorden	negative
erschiessen	negative
erstechen	negative
betretbar	positive
erledigen	negative
unglück	negative
einschläfern	negative
bestehen	positive
kleinlastwagen	negative
kleinlaster	negative
gelenkig	negative
versenkung	negative
rau	negative
begehbar	positive
fahrbar	positive
befahrbar	positive
erzeugen	positive
vertretbar	positive
fabrizieren	positive
schweisstreibend	positive
kräftezehrend	positive
strapaziös	positive
entbehrungsreich	positive
arbeit	negative
guss	negative
rüpelhaft	negative
raubeinig	negative
ruppig	negative
ausschank	negative
öffnung	negative
erdrücken	negative
energiegeladen	positive
geste	negative
einräumung	negative
beitrag	negative
abmeldung	negative
ergeben	negative
schur	negative
einsargen	negative
abpacken	negative
cellophanieren	negative
konfektionieren	negative
einschweissen	negative
bekümmert	negative
schreiben	negative
wiederherstellung	negative
störung	negative
ausgelassenheit	negative
ausdenken	positive
untertagebau	negative
salzabbau	negative
erzabbau	negative
braunkohleabbau	negative
kiesabbau	negative
funktion	negative
rahmung	negative
auftrag	negative
lektüre	negative
treiben	positive
unternehmung	negative
wissenschaft	negative
organisierung	negative
beurkundung	negative
investitionstätigkeit	negative
verklebung	negative
überwachungstätigkeit	negative
metallbearbeitungstätigkeit	negative
aushandlung	negative
rätselraten	negative
publikationstätigkeit	negative
fehlhandlung	negative
transaktion	negative
schreibtätigkeit	negative
ermöglichung	negative
tathandlung	negative
künstlerische handlung	negative
spendung	negative
marketingaktivität	negative
unterminierung	negative
umtriebe	negative
mischen	negative
wundertat	negative
aufrichtung	negative
geistesleben	negative
erteilung	negative
kenntnisnahme	negative
missionstätigkeit	negative
priorisierung	negative
sachbearbeitertätigkeit	negative
freischaltung	negative
erzählen	negative
abdrucknahme	negative
ordnungsgemässes vorgehen	negative
prüftätigkeit	negative
vertriebsaktivität	negative
aussendung	negative
geschäftshandlung	negative
servicetätigkeit	negative
einschleusung	negative
penetration	negative
erledigung	negative
rückgängigmachung	negative
auslassung	negative
beratertätigkeit	negative
kultische handlung	negative
luftholen	negative
lochung	negative
heldentat	negative
unterschreitung	negative
handlungssequenz	negative
kulturleben	negative
schlafengehen	negative
erzeugung	negative
spezialtätigkeit	negative
gewaltaktion	negative
rückmeldung	negative
reisetätigkeit	negative
ingenieurtätigkeit	negative
forschungstätigkeit	negative
mitnahme	negative
weglassung	negative
arbeitstätigkeit	negative
einarbeitung	negative
forschungsaktivität	negative
rauchen	negative
freizeitaktivität	negative
übermalung	negative
öffentlicher akt	negative
drucklegung	negative
konzerttätigkeit	negative
patentierung	negative
zwangshandlung	negative
suche	negative
parallelisierung	negative
einschleppung	negative
versatz	negative
sonnenaktivität	negative
hilfstätigkeit	negative
unterlegung	negative
beweinung	negative
siedlungstätigkeit	negative
zurückdrängung	negative
politische handlung	negative
kontaktaufnahme	negative
mobilisation	negative
trainertätigkeit	negative
kulthandlung	negative
zurücklassung	negative
aufnahmetätigkeit	negative
formatierung	negative
kampfhandlung	negative
befeuerung	negative
abstich	negative
grosstat	negative
subversion	negative
fanal	negative
zappelig	negative
zurückstecken	negative
nichteinmischung	negative
ausladung	negative
truppenabbau	negative
truppenreduzierung	negative
anrüchig	negative
unprofessionell	negative
charakterlos	negative
laienhaft	negative
pejorativ	negative
ineffektiv	negative
fehlerhaft	negative
widrig	negative
schlimm	negative
grauslich	negative
kriminell	negative
strafwürdig	negative
grottenschlecht	negative
leid	negative
überziehung	negative
wucht	negative
abrupfen	negative
verfolgen	negative
betrüblich	negative
tieftraurig	negative
wehmütig	negative
enttäuscht	negative
bedrückt	negative
reumütig	negative
tränenreich	negative
trübsinnig	negative
reaktion	negative
abfallentsorgung	negative
abfallbeseitigung	negative
müllbeseitigung	negative
müllentsorgung	negative
pracht	positive
explodieren	negative
detonieren	negative
bersten	negative
gereichen	negative
profitieren	negative
verzinsen	negative
amortisieren	negative
halbwild	negative
hervorbringen	positive
hektisch	negative
weiterführung	negative
schwarz	negative
strafverfolgung	negative
gedeihlich	positive
verleumden	negative
diskreditierung	negative
diffamierung	negative
gickern	positive
passabel	positive
kopplung	negative
koppelung	negative
registriert	positive
prestige	positive
findig	positive
aufwieglerisch	positive
experimentierfreudig	positive
aufrührerisch	positive
vorschub	negative
grazil	positive
opportun	positive
passend	positive
verschiessen	negative
souverän	positive
rohrbruch	negative
schienenbruch	negative
fadenbruch	negative
radbruch	negative
verhetzung	negative
aufwiegelung	negative
meistbegünstigung	negative
unmenschlich	negative
inhuman	negative
menschenunwürdig	negative
absatzeinbruch	negative
absatzrückgang	negative
moral	negative
trinkwasserqualität	positive
gekonnt	positive
beispielgebend	positive
exemplarisch	positive
musterhaft	positive
invasion	negative
unterhalten	positive
belagerung	negative
okkupation	negative
verwandtschaft	negative
gewinnend	positive
einnehmend	positive
erfasst	positive
ausgewiesen	positive
eingetragen	positive
eingeschrieben	positive
ungerechtigkeit	negative
operator	negative
niederlage	negative
leidlich	positive
exportschlager	positive
grundhörigkeit	negative
kolonat	negative
vorlage	negative
darstellen	positive
american airlines	negative
verdauung	negative
lohnen	negative
einnahme	negative
begünstigen	positive
ausätschen	positive
pech	negative
ätschen	positive
philanthrop	positive
menschenfreund	positive
menschenfreundin	positive
pesach	positive
christnacht	positive
heiligabend	positive
pessachfest	positive
passah	positive
christabend	positive
passahfest	positive
weihnachtsabend	positive
labsal	positive
marktversagen	negative
entsagen	negative
einlenken	negative
besetzung	negative
lieblingsmusik	positive
lieblingsfarbe	positive
lieblingsobjekt	positive
lieblingssache	positive
schmuckvoll	positive
aushalten	positive
beispiel	positive
orthodox	positive
paradigma	positive
campingstuhl	negative
staatsmännisch	positive
elektrischer stuhl	negative
kirchenstuhl	negative
polsterstuhl	negative
rohrstuhl	negative
bischofsstuhl	negative
richterstuhl	negative
korbstuhl	negative
kinderstuhl	negative
liegestuhl	negative
bürostuhl	negative
regiestuhl	negative
schiedsrichterstuhl	negative
schreibtischstuhl	negative
holzstuhl	negative
drehstuhl	negative
behandlungsstuhl	negative
gartenstuhl	negative
klappstuhl	negative
feldstuhl	negative
bootsmannstuhl	negative
ministersessel	negative
direktorensessel	negative
lehnstuhl	negative
klavierstuhl	negative
rollstuhl	negative
nachtstuhl	negative
küchenstuhl	negative
deckstuhl	negative
schaukelstuhl	negative
einsacken	negative
tamtam	positive
betriebsamkeit	positive
geschäftigkeit	positive
proportion	negative
fertig machen	negative
majestätisch	positive
fertigmachen	negative
kalt	positive
verwandtschaftsbeziehung	negative
sippschaft	negative
eigenmächtigkeit	negative
lieblingsbeschäftigung	positive
hilfe	negative
kaltherzig	positive
mühevoll	positive
entfernung	negative
vorziehen	positive
hartherzig	positive
verstöpseln	positive
zukorken	positive
stöpseln	positive
zustöpseln	positive
korken	positive
verkorken	positive
anstrengend	positive
stressig	positive
ausgekocht	positive
problematik	negative
verlustieren	positive
hartgesotten	positive
abgebrüht	positive
produktiv	positive
militärlastwagen	negative
pritschenwagen	negative
schwertransporter	negative
tieflader	negative
lastzug	negative
band	negative
illegitim	negative
unrechtmässig	negative
streben	positive
privilegieren	positive
bevorteilen	positive
bevorrechtigen	positive
verdrahtung	negative
problemstellung	negative
initiativ	positive
aktionistisch	positive
unternehmungslustig	positive
weichen	negative
befreiung	negative
grenzfrage	negative
bekehren	positive
unterstützung	negative
gefangennahme	negative
lebensgefahr	negative
eingehen	positive
einpacken	negative
einhüllen	negative
hüllen	negative
umhüllen	negative
voraussetzen	positive
vorwegnehmen	positive
vorausnehmen	positive
supponieren	positive
lethargisch	negative
wohl tun	positive
wohltun	positive
aktivität	negative
lebensmüde	negative
preisstabil	positive
wertstabil	positive
richtungsstabil	positive
subjektiv	negative
unbefriedigend	negative
einwickeln	negative
einschliessen	positive
humorig	positive
bürokratieabbau	negative
sozialabbau	negative
kapazitätsabbau	negative
steuervergünstigungsabbau	negative
stellenabbau	negative
versand	negative
versendung	negative
verfrachtung	negative
einbringen	negative
einfall	negative
handlung	negative
forschungsgeschichte	negative
epigraphik	negative
epigrafik	negative
wissenschaftsgeschichte	negative
humorvoll	positive
entsperrung	negative
auslösen	positive
hervorrufen	positive
verursachen	positive
erbringen	negative
ladung	positive
problemlos	positive
aufriss	negative
lustig	positive
stocksteif	positive
zahm	positive
ungezähmt	negative
lancierung	negative
tragen	positive
plump	negative
rausspucken	negative
rauskotzen	negative
kotzen	negative
göbeln	negative
ausspucken	negative
reihern	negative
auskotzen	negative
speien	negative
schmuddelig	negative
distinguiert	positive
stipendium	negative
abschreiben	negative
brummer	negative
fassbar	positive
wintereinbruch	negative
kurseinbruch	negative
kälteeinbruch	negative
ex	positive
vergucken	negative
zubinden	positive
verehren	positive
eifer	positive
abstand	negative
eroberung	negative
freudlos	negative
unzuständig	negative
einbinden	negative
ausweinen	negative
ausheulen	negative
anisotropie	negative
interdependenz	negative
erbuntertänigkeit	negative
hörigkeit	negative
temperaturabhängigkeit	negative
dispersion	negative
plakat	negative
aushang	negative
attentat	negative
brandstiftung	negative
brandanschlag	negative
mordanschlag	negative
drogenhandel	negative
drogenschmuggel	negative
schleusung	negative
stürmung	negative
menschenschmuggel	negative
verschleppung	negative
deportation	negative
erstürmung	negative
ablassen	negative
wimmern	negative
vorbild	positive
ankommen	positive
unsportlich	negative
absperren	positive
nachgeben	negative
abschliessen	positive
generieren	positive
zuziehen	positive
grössenrelation	negative
grössenverhältnis	negative
umgeben	positive
einspielen	negative
exfreundin	positive
exliebe	positive
exfreund	positive
distanz	negative
heimatfreund	positive
naturfreund	positive
heimatfreundin	positive
naturfreundin	positive
gartenfreund	positive
bibliophiler	positive
bibliophile	positive
geschäftsfreundin	positive
geschäftsfreund	positive
schachfreund	positive
lover	positive
naturliebhaberin	positive
gartenfreundin	positive
karnevalistin	positive
karnevalist	positive
naturliebhaber	positive
schachfreundin	positive
loverin	positive
volksfreundin	positive
volksfreund	positive
liebhaberin	positive
liebhaber	positive
ostern	positive
automobilsalon	positive
büchermesse	positive
autosalon	positive
buchmesse	positive
personifizieren	positive
aufleuchten	positive
expressgut	negative
story	negative
expresssendung	negative
ableiten	positive
einreissen	negative
starrköpfig	positive
rigid	positive
rigoros	positive
rigide	positive
ackern	positive
aufmerksam	positive
umgrenzen	positive
abrackern	positive
schuften	positive
mühen	positive
abmühen	positive
rackern	positive
fronen	positive
abplagen	positive
kirmes	positive
jahrmarkt	positive
osterfest	positive
kerwe	positive
ostertag	positive
gelage	positive
besäufnis	positive
gezeche	positive
ostermesse	positive
schwarze messe	positive
primiz	positive
hochamt	positive
nachmesse	positive
weihnachtsmesse	positive
blockieren	positive
ns-verbrecherin	negative
plündrerin	negative
plünderin	negative
gewalttäterin	negative
gewaltverbrecherin	negative
naziverbrecherin	negative
plündrer	negative
naziverbrecher	negative
betrüger	negative
plünderer	negative
ns-verbrecher	negative
prellerin	negative
preller	negative
gewalttäter	negative
betrügerin	negative
gewaltverbrecher	negative
einklinken	positive
lastwagen	negative
brummi	negative
lastkraftwagen	negative
lkw	negative
truck	negative
parität	negative
sondersendung	negative
zustande bringen	positive
zuverlässig	positive
unsicher	negative
nachmachen	positive
zuknallen	positive
zuschlagen	positive
machtverhältnis	negative
miteinander	negative
vernetzung	negative
machtverteilung	negative
rollenverteilung	negative
verlinkung	negative
rollenbeziehung	negative
gemeinschaft	negative
auflodern	positive
aufflackern	positive
umranden	positive
vorbehalten	positive
kapitulieren	negative
herleiten	positive
zuballern	positive
zusperren	positive
zuschliessen	positive
zukitten	positive
verkitten	positive
erklärbar	positive
erklärlich	positive
inbrünstig	positive
abschiessen	negative
entreissen	negative
konvertieren	positive
abweisen	negative
phlegmatisch	negative
zuklappen	positive
einfallsreich	positive
erfindungsreich	positive
ideenreich	positive
gesprächsbereit	positive
harpunieren	negative
kompromissbereit	positive
zuwerfen	positive
vertauschen	negative
verwechseln	negative
wuchtig	positive
instrumentieren	positive
aufreissen	negative
entringen	negative
geschockt	negative
schockiert	negative
verslumen	negative
giftig	negative
allegro	positive
angreifen	negative
lawinensicher	positive
frostsicher	positive
kugelsicher	positive
trittsicher	positive
uneinnehmbar	positive
betriebssicher	positive
mündelsicher	positive
abwerfen	negative
abweichen	negative
hindernis	negative
abkommen	negative
wirken	positive
entleiben	negative
flott	positive
anhalten	positive
zurückweichen	negative
gründen	positive
unbehindert	positive
ungehindert	positive
würde	positive
gestalten	positive
anmuten	positive
zerrupfen	negative
holen	positive
gleichheit	negative
papyrologie	negative
wortgeschichte	negative
altertumswissenschaft	negative
postsendung	negative
entsendung	negative
nachnahme	negative
rücksendung	negative
exportsendung	negative
rohrpostsendung	negative
briefsendung	negative
winseln	negative
verpacken	negative
hypostasieren	positive
befreit	positive
erlöst	positive
orchestrieren	positive
konstituieren	positive
bildhauern	positive
bildhauen	positive
entgegenfiebern	positive
schaltung	negative
mediatisieren	positive
zugeknöpft	positive
stammesgeschichte	negative
phylogenese	negative
phylogenie	negative
muffelig	negative
griesgrämig	negative
miesepetrig	negative
erheischen	positive
heischen	positive
empfehlen	positive
schlepper	negative
voreingenommen	negative
drogenproblem	negative
flüchtlingsfrage	negative
grundfrage	negative
schachproblem	negative
flüchtlingsproblem	negative
ausländerfrage	negative
schachaufgabe	negative
ausländerproblem	negative
grundproblem	negative
drogenproblematik	negative
hauptproblem	negative
kernproblem	negative
sennerei	positive
freimachen	positive
losbrechen	negative
abbrechen	negative
behalten	positive
beweinen	negative
scharf	positive
schluchzen	negative
dolchstoss	negative
anschlagzettel	negative
erkoren	positive
prädestiniert	positive
auserkoren	positive
auserwählt	positive
vorbestimmt	positive
zurückhalten	positive
waffenschmuggel	negative
steuerhinterziehung	negative
atomschmuggel	negative
flugzeugentführung	negative
fahrerflucht	negative
schutzgelderpressung	negative
frauenhandel	negative
hinterziehung	negative
raubüberfall	negative
banküberfall	negative
unterschlagung	negative
sklavenhandel	negative
handstreich	negative
kindesentführung	negative
blocken	positive
liebesfilm	negative
verknüpfung	negative
untüchtig	negative
kontakt	negative
aufnehmen	positive
wühlen	positive
zugehen	positive
anerkennen	positive
einstellung	negative
wertlos	negative
dahergelaufen	negative
rätsel	negative
bezug	negative
schamlos	negative
bankrott	negative
einschaltung	negative
vulgär	negative
obszön	negative
ordinär	negative
erleiden	positive
vollkommen	positive
eintragen	negative
eisenbahnfreund	positive
mensch	positive
versäumen	negative
modemesse	positive
industriemesse	positive
fachmesse	positive
herbstmesse	positive
antiquitätenmesse	positive
mustermesse	positive
frühjahrsmesse	positive
computermesse	positive
kunstmesse	positive
handelsmesse	positive
spielwarenmesse	positive
offiziersmesse	positive
musikmesse	positive
flexibel	negative
messfeier	positive
unkultiviert	negative
versiegeln	positive
unzivilisiert	negative
durchfallen	negative
vegetieren	positive
gehören	positive
übersehbar	positive
vertun	negative
rechtsbeziehung	negative
masse-leistungs-verhältnis	negative
isotopenverhältnis	negative
leistungsgewicht	negative
isotopensignatur	negative
rechtsverhältnis	negative
entscheidbar	positive
charivari	positive
abgehärtet	positive
weich	negative
vorgetäuscht	negative
gespielt	negative
gefälscht	negative
mörsern	negative
befestigen	negative
musikfestival	positive
pfingstfest	positive
musikfest	positive
pfingsten	positive
filmfestspiele	positive
jazzfestival	positive
nikolaustag	positive
nikolaus	positive
filmfestival	positive
jazzfest	positive
neunmalklug	negative
siebengescheit	negative
zudrücken	positive
symbiose	negative
ebenbürtigkeit	negative
dienstverhältnis	negative
nebeneinander	negative
aussenbeziehung	negative
schuldverhältnis	negative
beamtenverhältnis	negative
verwandtschaftsverhältnis	negative
qualitative beziehung	negative
gleichrangigkeit	negative
auslandsbeziehung	negative
wechselbeziehung	negative
relation	negative
mietverhältnis	negative
herrschaftsverhältnis	negative
ausbildungsverhältnis	negative
vertragsverhältnis	negative
hierarchie	negative
zweierbeziehung	negative
kommunikation	negative
geschäftsbeziehung	negative
juristische beziehung	negative
konkurrenz	negative
abhängigkeitsverhältnis	negative
zusammenleben	negative
aussenhandelsbeziehung	negative
phrasierung	negative
beschäftigungsverhältnis	negative
liebesverhältnis	negative
mathematische beziehung	negative
komplizenschaft	negative
kundenbeziehung	negative
versicherungsverhältnis	negative
zeitverhältnis	negative
arbeitsverhältnis	negative
wirtschaftsbeziehung	negative
sprachliche relation	negative
lehnsverhältnis	negative
zwischenmenschliche beziehung	negative
vertrauensverhältnis	negative
angestelltenverhältnis	negative
wuseln	positive
zunähen	positive
rödeln	positive
arroganz	positive
anmassung	positive
selbstherrlichkeit	positive
überheblichkeit	positive
zufliegen	positive
dichtmachen	positive
folgern	positive
verkapseln	positive
zustossen	positive
abduzieren	positive
induzieren	positive
zunageln	positive
zuriegeln	positive
deduzieren	positive
zuklinken	positive
rückschliessen	positive
vorstellen	positive
freundin	positive
zumachen	positive
harsch	positive
verfehlen	negative
fleiss	positive
mobil	negative
zerfleischen	negative
wegreissen	negative
auseinanderreissen	negative
anfügung	negative
anbringen	negative
anbringung	negative
verschlampen	negative
brandstifterin	negative
feuerlegerin	negative
feuerleger	negative
brandstifter	negative
rupfen	negative
unbefleckt	positive
versumpfen	negative
verwahrlosen	negative
bankrotteur	negative
eindringling	negative
lude	negative
dieb	negative
verlottern	negative
bankrotteurin	negative
diebin	negative
einbrecher	negative
langfinger	negative
einbrecherin	negative
pleitier	negative
zuhälter	negative
pimp	negative
unterordnen	positive
befestigung	negative
dynamisch	positive
verpassen	negative
statutengemäss	positive
wortgemäss	positive
satzungsgemäss	positive
wortlautgemäss	positive
leuchten	positive
vergaloppieren	negative
unterlaufen	positive
perforieren	negative
durchlöchern	negative
gleichartigkeit	negative
einfordern	positive
verspekulieren	negative
geschichtsschreibung	negative
historiografie	negative
geschichtswissenschaft	negative
historiographie	negative
entbehren	negative
abschminken	negative
behaupten	positive
anstellung	negative
erleichtern	positive
beweglich	negative
passierbar	positive
entäussern	negative
bahnen	positive
zurücktreten	negative
fasten	negative
anrichten	positive
scheinen	positive
untätigkeit	positive
elastisch	negative
allgemein verbindlich	positive
allgemeinverbindlich	positive
destruktiv	negative
behagen	positive
mitsollen	positive
bewähren	positive
loslösen	negative
vertragen	positive
wegbrechen	negative
anschliessen	positive
unbewacht	positive
gemeinfrei	positive
rausbringen	negative
sparen	positive
flackern	positive
entsteigen	negative
echt	positive
musizieren	positive
komponieren	positive
öffnen	negative
beraten	positive
kommunalisieren	positive
erde	negative
öden	negative
anöden	negative
emporsteigen	negative
beruhigt	positive
trieb	positive
unsanft	negative
vertippen	positive
einsparen	positive
einbilden	negative
aufgeben	negative
frei	positive
abstellen	positive
wechseln	negative
beanspruchen	positive
gedankenvoll	negative
schwärmen	positive
zufallen	positive
antippen	positive
reklamieren	positive
verbitten	positive
erpressen	positive
ausbitten	positive
ausbedingen	positive
zurückfordern	positive
zurückverlangen	positive
herumraten	positive
rätseln	positive
herumrätseln	positive
erraten	positive
argwöhnen	positive
pflegeleicht	positive
plieren	negative
abwasserentsorgung	negative
übermut	positive
krass	positive
vertonen	positive
ebene	positive
weltgeschichte	negative
hexenverbrennung	negative
selbstverbrennung	negative
sonnenbrand	negative
automation	negative
automatisierung	negative
universalgeschichte	negative
fett	positive
überschwang	positive
aufstecken	negative
greinen	negative
flennen	negative
plärren	negative
heulen	negative
verteufelt	negative
seligkeit	positive
freudentaumel	positive
umweltproblem	negative
verletzungsproblem	negative
verkehrsproblem	negative
abgrenzungsproblem	negative
geldproblem	negative
teilproblem	negative
wirtschaftsfrage	negative
alkoholproblem	negative
strukturproblem	negative
neutralitätsproblem	negative
lizenzproblem	negative
kommunikationsproblem	negative
sicherheitsproblem	negative
verständnisproblem	negative
versorgungsproblem	negative
frauenfrage	negative
leib-seele-problem	negative
beziehungsproblem	negative
finanzproblem	negative
welthunger	negative
sprachproblem	negative
gesundheitsproblem	negative
kapazitätsproblem	negative
eheproblem	negative
transportproblem	negative
entsorgungsproblem	negative
entscheidungsproblem	negative
alltagsproblem	negative
optimierungsproblem	negative
qualitätsproblem	negative
schnittstellenproblem	negative
müllproblem	negative
einzelfallproblem	negative
menschenrechtsfrage	negative
platzproblem	negative
arbeiterfrage	negative
erfolg	positive
normgemäss	positive
bestimmungsgemäss	positive
befehlsgemäss	positive
genuss	positive
genesis	negative
kinoliebhaber	positive
kinogängerin	positive
kinoliebhaberin	positive
kinofan	positive
kinogänger	positive
defensiv	positive
hinausbringen	negative
anschleppen	negative
mitbringen	negative
alltagsgeschichte	negative
parieren	positive
kernig	positive
training	negative
minderwertig	negative
einblenden	negative
schöpfungsgeschichte	negative
kreuzzug	negative
vogelscheuche	negative
judenvernichtung	negative
kommunion	positive
anknipsen	negative
molkerei	positive
käserei	positive
zwischenstopp	negative
absolut	positive
zwischenhalt	negative
zwischenaufenthalt	negative
relaxation	positive
kumpel	positive
taufe	positive
niveau	positive
unfreiheit	negative
glattgehen	positive
glatt gehen	positive
gutgehen	positive
gut gehen	positive
umdisponieren	negative
stark	positive
entschlüpfen	negative
indienststellung	negative
inbetriebnahme	negative
okkupator	negative
besetzer	negative
besatzer	negative
invasor	negative
belagerin	negative
okkupatorin	negative
besatzerin	negative
besetzerin	negative
okkupantin	negative
belagerer	negative
eroberin	negative
okkupant	negative
eroberer	negative
vermauern	positive
jähzorn	negative
zerstörungswut	negative
reinhauen	positive
volkszorn	negative
befahrung	positive
bewegen	negative
level	positive
tonalität	negative
offen	positive
advent	positive
sündhaft	negative
sündig	negative
stufe	positive
energiehaushalt	negative
seitenverhältnis	negative
beziehung	negative
öffnungsverhältnis	negative
mischungsverhältnis	negative
mehrheitsverhältnis	negative
atonalität	negative
signal-rausch-verhältnis	negative
spannungsverhältnis	negative
zahlenverhältnis	negative
verdichtungsverhältnis	negative
frequenzverhältnis	negative
missverhältnis	negative
dispersionsrelation	negative
kräfteverhältnis	negative
übersetzungsverhältnis	negative
torverhältnis	negative
preis-leistungs-verhältnis	negative
münzfuss	negative
mengenverhältnis	negative
eigentumsverhältnis	negative
stimmenverhältnis	negative
geschlechterverhältnis	negative
prangen	positive
entgehen	negative
davonkommen	negative
verübung	positive
lauflänge	negative
erschwinglich	positive
fusion	negative
irren	negative
erzürnen	negative
ausbrechen	negative
veranlassen	negative
damenhaft	positive
versuchen	positive
achtzigprozentig	negative
sechzigprozentig	negative
dreissigprozentig	negative
hochprozentig	negative
zwanzigprozentig	negative
fünfprozentig	negative
fünfzigprozentig	negative
siebzigprozentig	negative
neunzigprozentig	negative
zehnprozentig	negative
open-air-festival	positive
sommerfestival	positive
kirchweihfest	positive
konfirmation	positive
ramadan	positive
opferfest	positive
kreuzerhöhung	positive
schlagerfestival	positive
kranzniederlegung	positive
vogelschiessen	positive
reformationsfest	positive
purim	positive
gemeindefest	positive
literaturfestival	positive
schlussfeier	positive
theaterfestival	positive
keusch	positive
rechthaberisch	negative
lehrerhaft	negative
geck	negative
aggressorin	negative
angreifer	negative
angreiferin	negative
aggressor	negative
knorke	positive
astrein	positive
dufte	positive
finanzierbar	positive
bezahlbar	positive
kostengünstig	positive
preiswert	positive
preisgünstig	positive
selbstmörder	negative
ns-täter	negative
schreibtischtäterin	negative
einzeltäterin	negative
folterer	negative
einzeltäter	negative
selbstmörderin	negative
folterin	negative
wiederholungstäterin	negative
schreibtischtäter	negative
ns-täterin	negative
serientäter	negative
wiederholungstäter	negative
serientäterin	negative
durchrasseln	negative
erschaffen	positive
gelogen	negative
erlogen	negative
überarbeiten	positive
mythos	positive
klotzen	positive
chimäre	negative
kooperieren	positive
zusammenarbeiten	positive
volontariat machen	positive
schwarzarbeiten	positive
werkeln	positive
gärtnern	positive
schwarz arbeiten	positive
volontieren	positive
verausgaben	positive
werken	positive
gärteln	positive
kumpan	positive
schimäre	negative
hirngespinst	negative
ausgeburt	negative
jugendfreund	positive
hausfreund	positive
schulfreundin	positive
verknipsen	negative
hausfreundin	positive
schulfreund	positive
jugendfreundin	positive
duzfreundin	positive
duzfreund	positive
gelten	positive
schlepperin	negative
stumpf	negative
brenzlig	negative
brisant	negative
aufbewahren	positive
überstrahlen	positive
fluoreszieren	positive
lumineszieren	positive
zurückstrahlen	positive
ernst	negative
charisma	positive
dürsten	positive
dealerin	negative
dealer	negative
geiselnehmerin	negative
entführer	negative
erpresser	negative
rechtsbrecher	negative
schmugglerin	negative
kleinkrimineller	negative
schwerverbrecherin	negative
unterdrücker	negative
schleuser	negative
menschenhändlerin	negative
hehler	negative
ehebrecherin	negative
kriegsverbrecher	negative
entführerin	negative
kleinkriminelle	negative
erpresserin	negative
kriegsverbrecherin	negative
hehlerin	negative
schwerverbrecher	negative
rechtsbrecherin	negative
unterdrückerin	negative
schleuserin	negative
ehebrecher	negative
menschenhändler	negative
schmuggler	negative
geiselnehmer	negative
können	positive
vertanzen	positive
rage	negative
beschäftigung	negative
ausmachen	positive
absetzung	negative
grell	positive
dahinleben	positive
reflektieren	positive
berechtigt	positive
vermögenswert	positive
zahlungsmittel	positive
underlying	positive
basiswert	positive
vermögensgegenstand	positive
finanzmittel	positive
sollen	positive
clever	positive
auf zack	positive
alert	positive
sitzenbleiben	negative
sitzen bleiben	negative
entgegensehen	positive
sexy	positive
reüssieren	positive
stoppen	positive
krankenhausaufenthalt	negative
klinikaufenthalt	negative
stopover	negative
stop-over	negative
zwischenstation	negative
durchgangsstation	negative
nächtigung	negative
übernachtung	negative
bündelung	negative
dursten	positive
einschliessung	negative
erdung	negative
beeumeln	positive
beölen	positive
rechtsverbindlich	positive
kranken	positive
raushalten	positive
kränkeln	positive
versperren	positive
verschliessen	positive
haltmachen	positive
eilen	positive
fusionierung	negative
bündeln	negative
seelsorgerlich	positive
seelsorglich	positive
seelsorgerisch	positive
standesgemäss	positive
zusammenleimen	negative
verleimen	negative
aufsteigen	negative
meinen	positive
aufbehalten	positive
anbehalten	positive
herausschiessen	negative
hinausschiessen	negative
glänzend	positive
stolpern	negative
ligatur	negative
verschraubung	negative
kunstgeschichte	negative
musikgeschichte	negative
leichtfertig	negative
hinaushalten	positive
zueinander halten	positive
zueinanderhalten	positive
almen	positive
alpen	positive
repräsentieren	positive
haupttäter	negative
genusssüchtig	negative
plebejisch	negative
zotig	negative
gehirnwäsche	negative
erbrechen	negative
unerträglich	negative
spaltung	negative
mediengeschichte	negative
bundesligageschichte	negative
dorfgeschichte	negative
sprachgeschichte	negative
parteigeschichte	negative
begriffsgeschichte	negative
ideengeschichte	negative
fernsehgeschichte	negative
familiengeschichte	negative
rezeptionsgeschichte	negative
sozialgeschichte	negative
automobilgeschichte	negative
erdgeschichte	negative
fussballgeschichte	negative
militärgeschichte	negative
wm-geschichte	negative
wirkungsgeschichte	negative
theatergeschichte	negative
wirtschaftsgeschichte	negative
lokalgeschichte	negative
bandgeschichte	negative
medizingeschichte	negative
rechtsgeschichte	negative
gründungsgeschichte	negative
regionalgeschichte	negative
universitätsgeschichte	negative
landesgeschichte	negative
schulgeschichte	negative
versionsgeschichte	negative
luftfahrtgeschichte	negative
vereinsgeschichte	negative
kulturgeschichte	negative
kolonialgeschichte	negative
territorialgeschichte	negative
entdeckungsgeschichte	negative
ortsgeschichte	negative
kinogeschichte	negative
menschheitsgeschichte	negative
filmgeschichte	negative
philosophiegeschichte	negative
heilsgeschichte	negative
heimatgeschichte	negative
stadtgeschichte	negative
forstgeschichte	negative
literaturgeschichte	negative
verfassungsgeschichte	negative
kirchengeschichte	negative
baugeschichte	negative
kriegsgeschichte	negative
geistesgeschichte	negative
firmengeschichte	negative
technikgeschichte	negative
unternehmensgeschichte	negative
reichsgeschichte	negative
industrialisierung	negative
siedlungsgeschichte	negative
naturgeschichte	negative
industriegeschichte	negative
religionsgeschichte	negative
biogenese	negative
bergbaugeschichte	negative
eisenbahngeschichte	negative
feinschmeckerisch	positive
kulinarisch	positive
vorjahr	negative
lädieren	negative
vortag	negative
vorwoche	negative
vorleben	negative
verfeuern	negative
geloben	positive
toxisch	negative
enthalten	negative
sehnsucht	negative
ferienaufenthalt	negative
barsch	negative
abverlangen	positive
abfangen	positive
dienen	positive
nuance	negative
weise	positive
abstechen	negative
zusichern	positive
gefälle	negative
exil	negative
gerechtfertigt	positive
himmel	positive
sachgemäss	positive
kluft	negative
studienaufenthalt	negative
langzeitaufenthalt	negative
rettungsanker	negative
kurzaufenthalt	negative
boxenstopp	negative
sanatoriumsaufenthalt	negative
sommeraufenthalt	negative
erholungsaufenthalt	negative
werftaufenthalt	negative
auslandsaufenthalt	negative
zubringen	negative
zerstörerisch	negative
hineinbringen	negative
reinbringen	negative
vollständig	positive
wohlfeil	positive
fördern	positive
schwören	positive
erfolgsgeschichte	negative
dreiecksgeschichte	negative
weihnachtsgeschichte	negative
unbeschreibbar	negative
begründet	positive
anschalten	negative
einschalten	negative
broschur	negative
einigung	negative
passung	negative
matching	negative
anknüpfung	negative
referenzierung	negative
aufbringung	negative
anbahnung	negative
einnistung	negative
angliederung	negative
crossover	negative
umweltschädlich	negative
gesundheitsschädlich	negative
gesundheitsschädigend	negative
umweltschädigend	negative
popanz	negative
begreifbar	positive
begreiflich	positive
versöhnlich	positive
verpflichten	positive
sinnentstellend	negative
schreckgestalt	negative
schreckfigur	negative
lumpig	negative
gammelig	negative
zerlumpt	negative
abgerissen	negative
gammlig	negative
schreckgespenst	negative
anmachen	positive
gelobigen	positive
hocharbeiten	positive
vorhaben	positive
unbeschreiblich	negative
unsagbar	negative
unsäglich	negative
klar	positive
entkommen	negative
absprengen	negative
gehrung	negative
gehre	negative
vermischung	negative
vermengung	negative
atemstillstand	negative
kreislaufstillstand	negative
atemlähmung	negative
kreislaufversagen	negative
unhold	negative
lösen	positive
herausbringen	negative
walten	positive
triebverbrecherin	negative
sexualstraftäterin	negative
triebtäter	negative
sexualstraftäter	negative
sexualverbrecher	negative
triebtäterin	negative
sexualverbrecherin	negative
triebverbrecher	negative
bewährt	positive
verballern	negative
erprobt	positive
sterbehilfe	negative
zwingen	negative
deplatziert	negative
profilieren	positive
deplaziert	negative
regelrecht	positive
richtiggehend	positive
ausüben	positive
verspielt	negative
spielfreudig	negative
spielerisch	negative
entspannen	positive
lockern	positive
auflockerung	positive
flamme	positive
lockerung	positive
spucken	negative
fadenscheinig	negative
cineast	positive
cineastin	positive
roboten	positive
malochen	positive
weiterarbeiten	positive
jobben	positive
famulieren	positive
praktizieren	positive
unterkommen	positive
herausarbeiten	positive
hospitieren	positive
arbeitswille	positive
ausländerfreundlich	positive
verdingen	positive
probat	positive
verlottert	negative
verlumpt	negative
arbeitsfreude	positive
vergammelt	negative
volltrottel	negative
vollidiot	negative
oberblödmann	negative
vollidiotin	negative
frakturieren	negative
vorgeschoben	negative
korrekturbedürftig	negative
würgen	negative
kontrolle	negative
beschwören	positive
amigo	positive
kurschatten	positive
studienfreund	positive
jugendliebe	positive
ramponieren	negative
paradies	positive
prekär	negative
zauber	positive
heikel	negative
dornig	negative
knifflig	negative
feil	positive
feindschaft	negative
gebieten	positive
umrennen	negative
umlaufen	negative
klotzig	negative
klobig	negative
rassismus	negative
meistern	positive
nominale	positive
extremum	positive
extrem	positive
nennwert	positive
extremwert	positive
nominalwert	positive
verkümmeln	negative
gegensatz	negative
gegenteil	negative
diskrepanz	negative
verschiedenheit	negative
höhenunterschied	negative
niveauunterschied	negative
verschiedenartigkeit	negative
divergenz	negative
freiheit	negative
zurichten	negative
inhomogenität	negative
differenz	negative
mittelwert	positive
mittel	positive
durchschnittswert	positive
blind	negative
vereinigung	negative
mafioso	negative
schädiger	negative
gangster	negative
assassine	negative
wegelagerer	negative
trügen	negative
bewölkt	negative
wolkig	negative
erstrahlen	positive
wilderer	negative
unterstützend	positive
mannschaftstauglich	positive
mannschaftsdienlich	positive
subsidiär	positive
hungern	positive
minimalwert	positive
maximalwert	positive
bindend	positive
verpflichtend	positive
sachwert	positive
sammlerwert	positive
zeitwert	positive
buchwert	positive
betriebswert	positive
genant	negative
eitelkeit	positive
selbstgefälligkeit	positive
genierlich	negative
übergeben	negative
heterogenität	negative
quacksalbern	negative
passen	positive
verarbeiten	positive
herzstillstand	negative
maschinenstillstand	negative
anlagenstillstand	negative
ruinös	negative
geschäftsschädigend	negative
anoxisch	negative
parteischädigend	negative
rufschädigend	negative
kontraproduktiv	negative
schreiend	positive
darben	positive
herumschleppen	positive
dahinsiechen	positive
trauern	positive
durchleiden	positive
kabelverbindung	negative
verkehrsanbindung	negative
rohrverbindung	negative
schiffsverbindung	negative
strassenverbindung	negative
zeichenverbindung	negative
nord-süd-verbindung	negative
zusammenhang	negative
geschäftsverbindung	negative
verkehrsverbindung	negative
ost-west-verbindung	negative
westbindung	negative
verwicklung	negative
fernverbindung	negative
zusammenhalt	negative
verfilzung	negative
kundenbindung	negative
sichtverbindung	negative
flugverbindung	negative
kontinuum	negative
listenverbindung	negative
arbeiten	positive
ekelhaft	negative
ekelerregend	negative
ekel erregend	negative
zweitbeste	positive
entwicklungsgeschichte	negative
entstehungsgeschichte	negative
kurpfuschen	negative
geistreich	positive
genial	positive
gerissen	positive
schlitzohrig	positive
genialisch	positive
geistvoll	positive
schlampen	negative
schludern	negative
lümmelhaft	negative
flapsig	negative
flegelhaft	negative
züchtig	positive
abstürzen	negative
entmutigend	negative
demoralisierend	negative
abweichung	negative
weltfrieden	positive
hausfrieden	positive
landfrieden	positive
landfriede	positive
weltfriede	positive
hausfriede	positive
rechtsfriede	positive
rechtsfrieden	positive
religionsfriede	positive
vorfrieden	positive
religionsfrieden	positive
vorfriede	positive
verkehrsverhältnisse	negative
anleimen	negative
verzeihend	positive
gnädig	positive
huldreich	positive
rot glühend	positive
stänkern	negative
rotglühend	positive
mosern	negative
verwachsen	negative
bucklig	negative
buckelig	negative
tupamara	negative
tupamaro	negative
verschaukeln	negative
erlaucht	positive
gesucht	positive
ausgesucht	positive
auserlesen	positive
ausersehen	positive
zuhalten	positive
tatkraft	positive
entgleisen	negative
hort	positive
sachfremd	negative
ungelegen	negative
schützend	positive
behütend	positive
wohlmeinend	positive
treu sorgend	positive
treusorgend	positive
gutgemeint	positive
gehuldigt	positive
gelobt	positive
hell	positive
anregen	positive
schrammen	negative
ergreifung	negative
bann	positive
anekdote	negative
kriminalgeschichte	negative
schwank	negative
fortsetzungsgeschichte	negative
kindergeschichte	negative
nacherzählung	negative
tiergeschichte	negative
lügengeschichte	negative
bildergeschichte	negative
horrorgeschichte	negative
schnurre	negative
räuberpistole	negative
abenteuergeschichte	negative
volkserzählung	negative
hintergrundgeschichte	negative
detektivgeschichte	negative
arten	positive
pelztierfarm	positive
unverdient	negative
funktionieren	negative
varietät	negative
bedröppelt	negative
begossen	negative
gelackmeiert	negative
sitte	negative
lächerlich	negative
benachteiligen	negative
erfordern	positive
geschlechtsunterschied	negative
farbunterschied	negative
preisunterschied	negative
hauptunterschied	negative
tidenhub	negative
qualitätsunterschied	negative
geschwindigkeitsunterschied	negative
texturunterschied	negative
leistungsunterschied	negative
interessengegensatz	negative
bedeutungsunterschied	negative
klassenunterschied	negative
standesunterschied	negative
helligkeitsunterschied	negative
altersunterschied	negative
grössenunterschied	negative
antransportieren	negative
streitig	negative
zerstossen	negative
rang	positive
vergangenheit	negative
setzen	positive
historie	negative
krach	negative
verladen	negative
begehren	positive
erfassen	positive
tick	negative
inkongruenz	negative
eklat	negative
zwietracht	negative
knatsch	negative
zoff	negative
stunk	negative
unfrieden	negative
verholen	negative
zurückbringen	negative
zerstrittenheit	negative
streiterei	negative
unfriede	negative
überschlagen	negative
sitzen lassen	negative
sitzenlassen	negative
stürzen	negative
gewinnen	positive
einschalen	negative
ausrüstung	negative
lösung	positive
ausstattung	negative
hinterlistigkeit	negative
verschlagenheit	negative
ballsport	negative
ballsportart	negative
ballspiel	negative
überwachung	negative
kontrollierung	negative
heranbringen	negative
trübsinn	negative
abnehmen	positive
ermöglichen	positive
fantasievoll	positive
phantasievoll	positive
stagnation	negative
stillstand	negative
doofmann	negative
hampelmann	negative
schalen	negative
grad	positive
chance	positive
binden	positive
korrekt	positive
niederschmetternd	negative
untugend	negative
fantasiereich	positive
phantasiereich	positive
verbringen	negative
beibringen	negative
fragestellung	negative
lebensuntüchtig	negative
beteuern	positive
durchhauen	negative
vertrauen	positive
unannehmbar	negative
heranschaffen	positive
sadist	negative
beeidigen	positive
haspeln	positive
beeiden	positive
verhaspeln	positive
unschuld	positive
abschauen	positive
auseinandersprengen	negative
falzen	positive
stille	negative
diffizil	negative
verzauberung	positive
entzündungshemmend	positive
antiphlogistisch	positive
unerquicklich	negative
schimmel	negative
zieren	negative
verwahrlost	negative
verschwitzt	negative
involviert	negative
exponieren	positive
riskieren	negative
minimum	positive
zubereiten	positive
eignen	positive
hervortun	positive
barbarei	negative
farm	positive
unvertretbar	negative
entgegenkommen	negative
transgression	negative
anlegen	negative
verbrecherin	negative
spottbillig	positive
kriminelle	negative
krimineller	negative
steuergünstig	positive
problemfrei	positive
tiefstwert	positive
höchstwert	positive
erfolgsverwöhnt	positive
wettbewerbsfähig	positive
vielversprechend	positive
konkurrenzfähig	positive
übrig	positive
erfolgsgewöhnt	positive
aussichtsreich	positive
verzichten	negative
einbildung	positive
maximum	positive
preis	positive
unschicklich	negative
provozieren	negative
sadistin	negative
absurd	negative
spleen	negative
tic	negative
abstrus	negative
verstimmen	negative
ungeschliffen	negative
aufschiessen	negative
hanswurst	negative
galoppieren	negative
geldwert	positive
temperatur	positive
wärmegrad	positive
y-wert	positive
checksumme	positive
niederschlagsmenge	positive
niederschlagswert	positive
marktwert	positive
referenzwert	positive
marktpreis	positive
bezugswert	positive
prüfsumme	positive
ordinate	positive
börsenwert	positive
abszisse	positive
x-wert	positive
marktkapitalisierung	positive
firmenwert	positive
zerfahren	negative
fettig	negative
strähnig	negative
wertgegenstand	positive
wertsache	positive
pikanterie	negative
verbauen	negative
statisch	positive
bitten	positive
verfassungsfeind	negative
staatsfeindin	negative
verfassungsfeindin	negative
hauptfeindin	negative
intimfeindin	negative
lieblingsfeindin	negative
erzfeind	negative
klassenfeindin	negative
lieblingsfeind	negative
intimfeind	negative
klassenfeind	negative
todfeind	negative
staatsfeind	negative
hauptfeind	negative
todfeindin	negative
erzfeindin	negative
unverbindlich	negative
infektionsgefahr	negative
übertragungsgefahr	negative
sommerlich-sonnig	positive
ansteckungsgefahr	negative
wunder	positive
beste	positive
super	positive
top	positive
hochzufrieden	positive
dünkel	positive
rufen	positive
goodwill	positive
verunfallen	negative
peinlich	negative
vergrätzen	negative
haussegen	positive
form	positive
nebenwirkung	positive
asyl	negative
nebeneffekt	positive
todesgefahr	negative
erzählung	negative
erwürgen	negative
strangulieren	negative
rummeln	negative
erdrosseln	negative
hochintelligent	positive
vergeistigt	positive
pfiffig	positive
gescheit	positive
rumzetern	negative
finessenreich	positive
aufgebraucht	negative
auszanken	negative
ausschelten	negative
ausschimpfen	negative
unmanierlich	negative
schablonieren	positive
schablonisieren	positive
danebenschiessen	negative
vorbeischiessen	negative
vergrämen	negative
wankelmütig	negative
lose	negative
los	negative
entmutigen	negative
abspicken	positive
abkucken	positive
abgucken	positive
hinhauen	positive
kollege	positive
betulich	positive
leuchtendrot	positive
neonfarben	positive
händel	negative
hader	negative
gezänk	negative
zwist	negative
bedrückend	negative
stachlig	negative
befremdlich	negative
belastend	negative
beklemmend	negative
lästig	negative
stachelig	negative
nervig	negative
magengeschichte	negative
frauengeschichte	negative
skandalgeschichte	negative
ungebührlich	negative
ungeahnt	positive
unerahnt	positive
verbellen	negative
verächtlich	negative
despektierlich	negative
zerreissen	negative
arsch	negative
rettung	negative
rettungsaktion	negative
errettung	negative
väterlich	positive
mütterlich	positive
wohlwollend	positive
bewundern	positive
unbefriedigt	negative
stromausfall	negative
arbeitsausfall	negative
versäumnis	negative
unterrichtsausfall	negative
ernteausfall	negative
produktionsausfall	negative
hochverehrt	positive
druckausfall	negative
totalausfall	negative
maschinenausfall	negative
vergären	negative
verdienstausfall	negative
beschämt	negative
anherrschen	negative
arschloch	negative
landschaftsverträglich	positive
klimaverträglich	positive
pflanzenverträglich	positive
antibiotisch	positive
schlabberig	negative
schlabbrig	negative
ausfahren	negative
depp	negative
blödmann	negative
dummkopf	negative
dumpfbacke	negative
idiotin	negative
sehnen	positive
greifen	positive
affe	negative
abknallen	negative
asylgewährung	negative
arbeitsunwillig	negative
bellen	negative
crossdressing	negative
vermummung	negative
krisenintervention	negative
erdbeobachtung	negative
vogelbeobachtung	negative
naturbeobachtung	negative
radarbeobachtung	negative
marktbeobachtung	negative
wetterbeobachtung	negative
himmelsbeobachtung	negative
zähflüssig	negative
sonnenbeobachtung	negative
bärendienst	positive
wohltat	positive
liebesdienst	positive
rarität	positive
seltenheit	positive
spicken	positive
spleissen	negative
auflösen	negative
knebeln	positive
ölig	negative
versichern	positive
ausbringen	positive
gnade	positive
freundschaft	positive
haltbar	positive
durchtrennen	negative
auseinanderbrechen	negative
entzweibrechen	negative
durchbrechen	negative
zerbrechen	negative
herausbrechen	negative
kämpferisch	positive
passiv	negative
einhalten	positive
ängstigen	negative
kreativ	positive
schöpferisch	positive
adoption	negative
neuaufnahme	negative
abhängen	positive
wurzel	negative
brennen	positive
vorabend	positive
luder	negative
tauglich	positive
fertigen	positive
anfertigen	positive
verfertigen	positive
erklärt	positive
prunk	positive
niedertracht	negative
hereinbrechen	negative
bepreisen	positive
management	negative
verzweifeln	negative
billig	positive
prädikatisieren	positive
demoralisieren	negative
informell	negative
verdriessen	negative
verschnupfen	negative
feindin	negative
graben	positive
verknüpfen	positive
verheddern	positive
erträumen	positive
gedenken	positive
taggen	positive
verstrichen	negative
geschäftsleitung	negative
geschäftsführung	negative
werksleitung	negative
firmenleitung	negative
unternehmensleitung	negative
unternehmensführung	negative
antiquität	positive
deeskalation	positive
verletzen	negative
intendieren	positive
bezwecken	positive
glücken	positive
zersprengen	negative
besprengen	negative
energiegewinn	negative
gelegen	positive
verkehrsgünstig	positive
strömungsgünstig	positive
könig	positive
killerin	negative
killer	negative
mörder	negative
mörderin	negative
teilbar	positive
werfen	positive
einreichung	negative
erbauen	positive
abwehren	positive
salopp	negative
aussprengen	negative
delikat	negative
ausfransen	negative
indirektheit	positive
sensation	positive
bauen	positive
aufnahmefähig	positive
wertigkeit	positive
fündig	positive
siegreich	positive
druckfähig	positive
erlebbar	positive
reaktionsfähig	positive
mischbar	positive
zukunftsfähig	positive
perspektivreich	positive
waffenfähig	positive
singbar	positive
magnetisierbar	positive
marktfähig	positive
lagerfähig	positive
tanzbar	positive
kombinierbar	positive
börsenfähig	positive
bespielbar	positive
beihilfefähig	positive
erstattungsfähig	positive
panzerbrechend	positive
anrechnungsfähig	positive
erlernbar	positive
abzugsfähig	positive
geländegängig	positive
lötfähig	positive
verbrauchen	negative
zugriff	negative
hof	positive
einsatztauglichkeit	positive
verhaftung	negative
arretierung	negative
festnahme	negative
inhaftierung	negative
inhaftnahme	negative
spielen	negative
leuchtend	positive
sittlichkeit	negative
erfinderisch	positive
übung	negative
zermalmen	negative
zerschlitzen	negative
eindellen	negative
walzen	positive
einätzen	negative
herausätzen	negative
zerbomben	negative
korrodieren	negative
verbeulen	negative
versengen	negative
nebensache	negative
verwaltungsangelegenheit	negative
nebensächlichkeit	negative
zwistigkeit	negative
kinkerlitzchen	negative
eckwert	positive
kleinigkeit	negative
streitigkeit	negative
verwaltungsgeschäft	negative
absperrung	negative
einheitswert	positive
kampfwert	positive
warenwert	positive
rekordwert	positive
normalwert	positive
leistungswert	positive
kontrollwert	positive
selbstwert	positive
hämatokritwert	positive
farbwert	positive
ausgabewert	positive
näherungswert	positive
streitwert	positive
anfangswert	positive
parameterwert	positive
verkehrswert	positive
leberwert	positive
aussagewert	positive
kapitalwert	positive
heizwert	positive
codepunkt	positive
istwert	positive
endwert	positive
rückgabewert	positive
einzelwert	positive
gemeinverständlich	positive
grenzwert	positive
zielwert	positive
ertragswert	positive
umfragewert	positive
erfahrungswert	positive
unterhaltungswert	positive
temperaturwert	positive
eigenwert	positive
spitzenwert	positive
wiedererkennungswert	positive
punktwert	positive
nutzwert	positive
lautwert	positive
normwert	positive
prozentwert	positive
abtastwert	positive
maschineneinstellwert	positive
sollwert	positive
neuwert	positive
restwert	positive
schätzwert	positive
richtwert	positive
laborwert	positive
markenwert	positive
cholesterinwert	positive
gesamtwert	positive
erholungswert	positive
zahlenwert	positive
gebrauchswert	positive
funktionswert	positive
kurswert	positive
vorgabewert	positive
jahreswert	positive
symbolwert	positive
verstehbar	positive
allgemeinverständlich	positive
unwichtigkeit	positive
informationswert	positive
startwert	positive
barwert	positive
wahrheitswert	positive
ausgangswert	positive
freizeitwert	positive
wasserwert	positive
messwert	positive
abgaswert	positive
stellenwert	positive
invariante	positive
nährwert	positive
erfassbar	positive
hashwert	positive
verbrauchswert	positive
leitwert	positive
praxistauglichkeit	positive
qualität einer sache	positive
substanzlosigkeit	positive
qualität einer person	positive
unveränderlichkeit	positive
intelligent	positive
tod	negative
hybris	positive
hochmut	positive
scharfsinn	positive
fertig	positive
fürst	positive
nutzen	negative
schade	negative
bedauernswert	negative
bedauerlich	negative
pickel	negative
umarmen	positive
umschlingen	positive
umhalsen	positive
feindseligkeit	negative
spendenskandal	negative
korruptionsskandal	negative
lebensmittelskandal	negative
bestechungsskandal	negative
finanzskandal	negative
wettskandal	negative
dopingskandal	negative
abhörskandal	negative
parteispendenaffäre	negative
sonnen	positive
herausfordern	negative
idyll	positive
phänomen	positive
tollwütig	positive
doll	positive
schlau	positive
berauschen	positive
kalfatern	positive
kalfaten	positive
üppig	positive
sogwirkung	positive
tiefenwirkung	positive
placeboeffekt	positive
werbeeffekt	positive
kamineffekt	positive
feldeffekt	positive
splitterwirkung	positive
dopplereffekt	positive
bindungswirkung	positive
überraschungseffekt	positive
oberflächeneffekt	positive
dramatik	positive
heilwirkung	positive
spezialeffekt	positive
bildwirkung	positive
knalleffekt	positive
gesamtwirkung	positive
spontane emission	positive
halleffekt	positive
multieffekt	positive
synergieeffekt	positive
breitenwirkung	positive
lichteffekt	positive
klangeffekt	positive
farbeffekt	positive
tunneleffekt	positive
kerr-effekt	positive
fotoeffekt	positive
endeffekt	positive
rechtswirkung	positive
schockeffekt	positive
soundeffekt	positive
hebelwirkung	positive
lerneffekt	positive
beleuchtungseffekt	positive
giftwirkung	positive
umschmeicheln	positive
überragen	positive
elefant	positive
verbessernd	positive
erstrebenswert	positive
traum	positive
malerisch	positive
arkadisch	positive
sanftmütig	positive
stadtguerilla	negative
guerillero	negative
unartig	negative
losschlagen	negative
gegenwert	positive
losballern	negative
zusammenschiessen	negative
beschiessen	negative
niederschiessen	negative
abdrücken	negative
losschiessen	negative
abfallwirtschaft	negative
müllwirtschaft	negative
fall	negative
bewirtschaftung	negative
beleidigen	negative
kaufen	negative
knipsen	negative
suhlen	positive
diarrhö	negative
mehlig	negative
aufpeitschen	positive
fanatisieren	positive
unsympathisch	negative
beängstigend	negative
erdrückend	negative
mulmig	negative
kaiser	positive
abstossend	negative
ersaufen	negative
ertrinken	negative
vietnamkrieg	negative
auskosten	positive
vietnam-krieg	negative
heiliger krieg	negative
dschihad	negative
durchkosten	positive
feiern	positive
weiden	positive
unvermutet	positive
unverhofft	positive
handstreichartig	positive
überfallartig	positive
schmachvoll	negative
schmählich	negative
pöbelhaft	negative
patzig	negative
cäsarisch	positive
anhusten	negative
rügen	negative
anmeckern	negative
belfern	negative
rüffeln	negative
anpfeifen	negative
anhauchen	negative
geifern	negative
zölibatär	positive
cremig	negative
schmelzflüssig	negative
leichtflüssig	negative
feuerflüssig	negative
dünnflüssig	negative
kletterei	negative
bergsteigen	negative
alpinismus	negative
klettern	negative
auswerfen	positive
klettersport	negative
versprengen	negative
vorknöpfen	negative
schiffbar	positive
gangbar	positive
schlucken	positive
zweck	positive
ruin	negative
brüchig	negative
porös	negative
fluffig	negative
fleischlich	positive
brüderlichkeit	positive
ächzen	negative
lebenstrieb	positive
bildhübsch	positive
dekaptieren	negative
dekapitieren	negative
stöhnen	negative
psychoterror	negative
agape	positive
einschmeicheln	positive
eitrig	negative
schwerverletzt	negative
vereitert	negative
schwerverwundet	negative
eiternd	negative
krankenhausreif	negative
ausstatten	negative
ausrüsten	negative
einbeulen	negative
anstückeln	positive
veranschlagen	positive
fesseln	positive
verstromen	positive
wirkung	positive
beschmieren	positive
computertätigkeit	positive
handarbeiten	positive
handwerken	positive
modellieren	positive
synthetisieren	positive
basteln	positive
plastizieren	positive
stereotypieren	positive
typen	positive
chem veränd herstell	positive
herstellen durch entfernen	positive
schneidern	positive
maximaltemperatur	positive
spitzentemperatur	positive
höchsttemperatur	positive
schlingen	positive
stürmen	negative
einfangen	positive
ängsten	negative
derb	negative
schirmherrschaft	negative
protektorat	negative
patronat	negative
ägide	negative
schutzherrschaft	negative
vorspiel	negative
überfluten	negative
gruseln	negative
grausen	negative
graulen	negative
hoffähig	positive
statthaft	positive
nahrungsversorgung	negative
werbeaktion	negative
marketingkampagne	negative
nahrungsmittelversorgung	negative
werbekampagne	negative
essensversorgung	negative
lebensmittelversorgung	negative
werbetrommel	negative
müllverbrennung	negative
kameradschaft	positive
biegsam	negative
befruchten	positive
ungeniessbar	negative
unbekömmlich	negative
zäh	negative
stress	negative
anspannung	negative
reiterei	negative
hinnehmen	positive
reiten	negative
pferdesport	negative
reitsport	negative
macker	positive
stecher	positive
schreck	negative
attentäterin	negative
zechpreller	negative
zechprellerin	negative
falschspieler	negative
falschspielerin	negative
attentäter	negative
peinigerin	negative
peiniger	negative
lädiert	negative
entzündet	negative
wund	negative
blessiert	negative
entschärfung	positive
deprimieren	negative
kolonist	negative
konquistador	negative
fiktion	negative
fürchten	negative
sache	negative
verwundet	negative
jahresdurchschnittstemperatur	positive
jahrestemperatur	positive
varianz	positive
pottasche	negative
benutzung	negative
nutzung	negative
betrieb	negative
abmachen	negative
auslagerung	negative
auslagern	negative
übereinstimmend	positive
ausgewogen	positive
differenziert	positive
wertlosigkeit	positive
probe	negative
schande	negative
moderat	positive
konkordant	positive
konform	positive
umsichtig	positive
massvoll	positive
gemässigt	positive
schmeissen	positive
unüberprüfbar	negative
durchschaubar	positive
kriegszug	negative
feldzug	negative
absetzen	negative
übernehmen	positive
witzigkeit	positive
spassigkeit	positive
kontaminieren	negative
bodenlos	negative
befugt	positive
schadenseindämmung	negative
schadensbegrenzungsmassnahme	negative
schadensbegrenzung	negative
erwärmen	positive
demut	negative
verkomplizieren	negative
mieterhöhung	positive
kinderfeindlich	negative
verwaltung	negative
beschaffenheit	positive
mietzinserhöhung	positive
mietsteigerung	positive
sachgerecht	positive
begründbar	positive
frieden	positive
pax	positive
empörend	negative
himmelschreiend	negative
massensport	negative
kampfsport	negative
volkssport	negative
fliegerei	negative
flugsport	negative
kampfsportart	negative
breitensport	negative
kampfkunst	negative
luftsport	negative
beleidigend	negative
ironisch	negative
sarkastisch	negative
ausfallend	negative
ehrensache	negative
arrest	negative
gewahrsam	negative
börsencrash	negative
verschorft	negative
kassenangelegenheit	negative
buchungsangelegenheit	negative
spielerei	negative
betreff	negative
bundesangelegenheit	negative
staatsangelegenheit	negative
grundstücksangelegenheit	negative
rechtsangelegenheit	negative
familienangelegenheit	negative
personalangelegenheit	negative
finanzangelegenheit	negative
problemkreis	negative
belange	negative
privatangelegenheit	negative
baufinanzierungsangelegenheit	negative
scheidungsangelegenheit	negative
regularie	negative
sterilisierung	negative
sterilisation	negative
einleuchtend	positive
luzid	positive
familienfreundlich	positive
derivat	negative
wasser	negative
wiederholen	positive
langsam	negative
liquidator	negative
barbecue	positive
putz	negative
hinreissen	positive
oberwasser	positive
fallschirmabsprung	negative
vertrauensbruch	negative
tabubruch	negative
wortbruch	negative
stilbruch	negative
haupt	negative
wertvorstellung	negative
zahlungsmoral	negative
sexualmoral	negative
menschlichkeit	negative
unmenschlichkeit	negative
humanität	negative
inhumanität	negative
wirtschaftsethik	negative
kampfmoral	negative
doppelmoral	negative
irritierend	negative
verwirrend	negative
umweltfreundlich	positive
technikfreundlich	positive
frauenfreundlich	positive
verwundern	positive
internum	negative
familienbande	negative
multiplizieren	positive
erwischen	positive
ehemaligentreffen	negative
stelldichein	negative
versammlung	negative
zusammenkunft	negative
veteranentreffen	negative
date	negative
stammtisch	negative
ungezügelt	negative
hemmungslos	negative
empathie	negative
salz	negative
acetylcholin	negative
carbid	negative
oxyd	negative
hydroxid	negative
sacharose	negative
azetylcholin	negative
karbid	negative
hydroxyd	negative
azetat	negative
oxid	negative
saccharose	negative
wasserstoffbrückenbindung	negative
wasserstoffbrücke	negative
acetat	negative
salzmineral	negative
säuerlich	negative
stütze	negative
erschrecken	negative
pflege	negative
höhenflug	positive
exaltieren	positive
cool	positive
kampf	negative
aufwendung	negative
schnöde	negative
verwechslungsgefahr	negative
einsturzgefahr	negative
steinschlaggefahr	negative
lawinengefahr	negative
kritikalität	negative
verletzungsgefahr	negative
gesundheitsgefahr	negative
hochwassergefahr	negative
kriegsgefahr	negative
unfallgefahr	negative
entgiften	positive
gefährdung	negative
fluchtgefahr	negative
abstiegsgefahr	negative
explosionsgefahr	negative
feuergefahr	negative
katastrophengefahr	negative
umweltgefahr	negative
inflationsgefahr	negative
brandgefahr	negative
ausnutzung	negative
ausnutzen	negative
administration	negative
verwaltungswesen	negative
homophob	negative
betreiben	negative
herausbilden	positive
partnerschaft	negative
verfügung	negative
unerwartet	positive
unglücklichkeit	negative
belangen	negative
unhöflich	negative
belächeln	positive
disposition	negative
tadeln	negative
aufwenden	negative
handhabung	negative
handling	negative
hudeln	positive
tragik	positive
tisch	negative
märchen	positive
kränken	negative
charaktervoll	positive
ether	negative
anstecken	negative
wohltemperiert	positive
fachgerecht	positive
brotzeit	negative
empfehlenswert	positive
jause	negative
einvernehmlich	positive
wohl temperiert	positive
ratsam	positive
demgemäss	positive
dementsprechend	positive
gütlich	positive
fachgemäss	positive
henkersmahlzeit	negative
henkersmahl	negative
erprobung	negative
einschluss	negative
schinden	positive
manöver	negative
stromversorgung	negative
abschreckung	negative
abschreckungsmassnahme	negative
elektrizitätsversorgung	negative
energiezufuhr	negative
protestakt	negative
gruppenaktion	negative
protestaktion	negative
energieversorgung	negative
konzertierte aktion	negative
deponieren	negative
deponierung	negative
standard	positive
entzauberung	positive
laufen	negative
turnierschach	negative
verzücken	positive
mitreissen	positive
aufputschen	positive
vernarren	positive
verteuerung	positive
präventivkrieg	negative
sechstagekrieg	negative
falklandkrieg	negative
sonderbundskrieg	negative
bosnienkrieg	negative
burgunderkrieg	negative
zulukrieg	negative
markgrafenkrieg	negative
bedrohen	negative
jugoslawienkrieg	negative
koreakrieg	negative
golfkrieg	negative
palästinakrieg	negative
kroatienkrieg	negative
perserkrieg	negative
bruderkrieg	negative
pazifikkrieg	negative
hussitenkrieg	negative
balkankrieg	negative
burenkrieg	negative
winterkrieg	negative
irakkrieg	negative
kosovokrieg	negative
indianerkrieg	negative
niederhalten	negative
grossmeister	positive
erbosen	negative
ärger	negative
begreifen	negative
apathisch	negative
absaugung	negative
anbölken	negative
anschreien	negative
anbrüllen	negative
krebsen	positive
steuerung	negative
lenkung	negative
teuerung	positive
beitragserhöhung	positive
beitragsanhebung	positive
lockerlassen	positive
wunschbild	positive
leitbild	positive
leitstern	positive
mitreissend	positive
einweisung	negative
rennsport	negative
athletik	negative
mannschaftssport	negative
rollschuhfahren	negative
körperertüchtigung	negative
leibesübung	negative
leichtathletik	negative
wintersport	negative
rollschuhlaufen	negative
wintersportart	negative
motorsport	negative
mannschaftssportart	negative
schiesssport	negative
sportschiessen	negative
tiefsttemperatur	positive
reibung	negative
fes	negative
notaufnahme	negative
abkömmling	negative
erdolchen	negative
wehrkraftzersetzung	negative
versieglung	negative
verschaffen	negative
aufarbeiten	negative
abwickeln	negative
beschicken	negative
versiegelung	negative
gutgelaunt	positive
gut gelaunt	positive
marktschreierisch	negative
einkalkulieren	positive
wettstreit	negative
konkurrenzkampf	negative
froh gelaunt	positive
launig	positive
gut aufgelegt	positive
frohgelaunt	positive
entfachen	positive
isoliert	negative
ablagerung	negative
reiberei	negative
losen	negative
familienkrach	negative
ehekrach	negative
abtausch	negative
schlagabtausch	negative
ehestreit	negative
familienstreit	negative
auslosen	negative
leitungsebene	positive
weltliga	positive
führungsebene	positive
hierarchiestufe	positive
qualitätsstufe	positive
orientierungsstufe	positive
qualitätsniveau	positive
hierarchieebene	positive
eingangsstufe	positive
weltniveau	positive
ablagern	negative
konvent	negative
kristall	negative
primarstufe	positive
rendezvous	negative
familientreffen	negative
theatertreffen	negative
ministertreffen	negative
kaffeekränzchen	negative
kränzchen	negative
folgetreffen	negative
aufeinandertreffen	negative
meeting	negative
begegnung	negative
klassentreffen	negative
jahrestreffen	negative
zeitgerecht	positive
randaliererin	negative
randalierer	negative
unruhestifter	negative
unruhestifterin	negative
widerspenstigkeit	negative
vergrätzt	negative
vergrämt	negative
verhärtet	negative
erweiterbar	positive
erweiterungsfähig	positive
ausbaufähig	positive
arsenverbindung	negative
einfachbindung	negative
ionenbindung	negative
ammoniak	negative
fluorwasserstoff	negative
dioxin	negative
keton	negative
nitrogruppe	negative
stickstoffverbindung	negative
kohlenwasserstoff	negative
schwefelverbindung	negative
phosgen	negative
aldehyd	negative
aminosäure	negative
auxin	negative
halogenid	negative
wasserstoffperoxid	negative
komplexverbindung	negative
hydrid	negative
aromat	negative
terpene	negative
indol	negative
ligand	negative
schwefelwasserstoff	negative
chlorwasserstoff	negative
cumarin	negative
alkali	negative
kaliumpermanganat	negative
tannin	negative
biomarker	negative
doppelbindung	negative
stickstoffwasserstoffsäure	negative
peptidbindung	negative
peroxid	negative
sulfid	negative
stickoxid	negative
kohlenstoffverbindung	negative
nitrit	negative
atombindung	negative
dreifachbindung	negative
isomer	negative
aminogruppe	negative
base	negative
durchschauen	negative
abstehen	negative
anteil	negative
querele	negative
verantwortung	negative
säure	negative
verantwortlichkeit	negative
verkehrsführung	negative
verkehrsplanung	negative
anziehen	positive
betriebsführung	negative
betriebsleitung	negative
parteileitung	negative
kirchenführung	negative
kirchenleitung	negative
parteiführung	negative
auftragung	negative
benützung	negative
nutzanwendung	negative
gebrauch	negative
weiterverwendung	negative
wiederverwendung	negative
begriffsverwendung	negative
rechtsanwendung	negative
spezialanwendung	negative
exzessiv	negative
regie	negative
zur welt bringen	positive
kreissen	positive
gebären	positive
tanklastzug	negative
tankzug	negative
clinch	negative
alkohol	negative
martialisch	negative
kannibalisch	negative
barbarisch	negative
unwürdig	negative
würdelos	negative
hauptmahlzeit	negative
take away	negative
unverdaulich	negative
schmaus	negative
grillen	negative
frühstück	negative
picknick	negative
zwischenmahlzeit	negative
brunch	negative
amphetamin	negative
modenschau	negative
einspielung	negative
exhibition	negative
einblendung	negative
modeschau	negative
zurschaustellung	negative
kurzschluss	negative
entwürdigen	negative
sonderaktion	negative
unterrichtsversorgung	negative
nahversorgung	negative
solidaritätsaktion	negative
maximalversorgung	negative
regelversorgung	negative
grabungskampagne	negative
blutversorgung	negative
sicherungsverwahrung	negative
stimulation	negative
gegenaktion	negative
saisonvorbereitung	negative
unterversorgung	negative
gemeinschaftsaktion	negative
ölversorgung	negative
vorbereitungszeit	negative
militäraktion	negative
militärische operation	negative
eigenversorgung	negative
endlagerung	negative
arbeitsvorbereitung	negative
kunstaktion	negative
anzeigenkampagne	negative
spendenaktion	negative
prüfungsvorbereitung	negative
löschaktion	negative
vorarbeit	negative
altersversorgung	negative
nachschub	negative
hilfsaktion	negative
selbstversorgung	negative
arzneimittelversorgung	negative
hinterlegung	negative
sauerstoffversorgung	negative
anlagerung	negative
pr-aktion	negative
zurichtung	negative
bevorratung	negative
staatsaktion	negative
archivierung	negative
einzelaktion	negative
fragebogenaktion	negative
verkaufsaktion	negative
wasserversorgung	negative
gasversorgung	negative
suchaktion	negative
sicherheitsvorkehrung	negative
kriegsvorbereitung	negative
gesundheitsversorgung	negative
säuberungsaktion	negative
einstimmung	negative
zusatzversorgung	negative
medienkampagne	negative
schmutzkampagne	negative
grundversorgung	negative
versandvorbereitung	negative
blitzaktion	negative
plakataktion	negative
informationskampagne	negative
störaktion	negative
verkaufsförderungsaktion	negative
aufruf	negative
aufklärungskampagne	negative
wohnungsversorgung	negative
widerstandsaktion	negative
racheaktion	negative
spannungsversorgung	negative
krankenversorgung	negative
stillen	negative
strafaktion	negative
mailingaktion	negative
luftversorgung	negative
polizeiaktion	negative
zwischenlagerung	negative
vergeltungsaktion	negative
pressekampagne	negative
unterschriftenaktion	negative
nährstoffversorgung	negative
aufräumaktion	negative
startvorbereitung	negative
hetzkampagne	negative
nacht-und-nebel-aktion	negative
bürgeraktion	negative
befreiungsaktion	negative
gebührenerhöhung	positive
naturgemäss	positive
austreibung	negative
koalitionsstreit	negative
namensstreit	negative
dauerstreit	negative
parteienstreit	negative
hickhack	negative
schlammschlacht	negative
handgreiflichkeit	negative
methodenstreit	negative
erbfolgestreit	negative
grenzstreit	negative
bilderstreit	negative
thronstreit	negative
meinungsstreit	negative
fehde	negative
ehrenhandel	negative
investiturstreit	negative
richtungsstreit	negative
zinserhöhung	positive
einkommenserhöhung	positive
preiserhöhung	positive
lohnerhöhung	positive
dividendenerhöhung	positive
rentenerhöhung	positive
diätenerhöhung	positive
gehaltserhöhung	positive
kapitalerhöhung	positive
vereinzelt	negative
umweltgerecht	positive
entwicklungsgemäss	positive
gebührend	positive
zünftig	positive
nachahmenswert	positive
wohlproportioniert	positive
situationsgerecht	positive
behindertengerecht	positive
praxisgerecht	positive
zweckgemäss	positive
überraschen	positive
blutsverwandtschaft	negative
blutsbande	negative
niedrig	negative
feuern	negative
täfelung	negative
unrühmlich	negative
deposition	negative
zechen	positive
trinkgelage	positive
saufgelage	positive
zecherei	positive
nieder	negative
wettkampfsport	negative
trendsportart	negative
behindertensport	negative
schulsport	negative
tanzsport	negative
amateursport	negative
randsportart	negative
hochleistungssport	negative
eissport	negative
nationalsport	negative
vereinssport	negative
einkesselung	negative
hundesport	negative
freizeitsport	negative
rallyesport	negative
fallschirmsport	negative
darts	negative
zeitfahren	negative
kartsport	negative
freisport	negative
kraftsport	negative
spitzensport	negative
mehrkampf	negative
einzelspringen	negative
leistungssport	negative
wassersport	negative
bergsport	negative
teildisziplin	negative
wandern	negative
profisport	negative
gewichtheben	negative
rudersport	negative
einzeldisziplin	negative
radsport	negative
erwecken	positive
popelig	negative
poplig	negative
zurückscheuen	negative
erschauern	negative
erschaudern	negative
zurückschrecken	negative
komik	positive
vollsperrung	negative
luftabschluss	negative
seitensperrung	negative
halbsperrung	negative
gleissperrung	negative
benutzersperrung	negative
bildebene	positive
netzebene	positive
entmachtung	negative
entthronung	negative
bärenstark	positive
eindeutig	positive
finit	positive
umschrieben	positive
unterstufe	positive
schnitzeljagd	negative
verwaltungsebene	positive
gehaltsstufe	positive
schwierigkeitsgrad	positive
bildungsniveau	positive
sicherheitslevel	positive
eu-ebene	positive
lebensniveau	positive
zeitebene	positive
sprachebene	positive
zwischenstufe	positive
strassenniveau	positive
temperaturniveau	positive
kommandoebene	positive
rangstufe	positive
sachebene	positive
fertigungsstufe	positive
altersstufe	positive
regierungsebene	positive
leistungsniveau	positive
mindestniveau	positive
zeitstufe	positive
signifikanzniveau	positive
verbandsebene	positive
mittelstufe	positive
abstraktionsebene	positive
rekordniveau	positive
handlungsebene	positive
kreisebene	positive
vorjahresniveau	positive
westniveau	positive
zinsniveau	positive
bezirksebene	positive
tonstufe	positive
pflegestufe	positive
produktionsstufe	positive
geheimhaltungsstufe	positive
schwierigkeitsstufe	positive
preisniveau	positive
bedeutungsebene	positive
leistungsstufe	positive
endstufe	positive
kulturstufe	positive
erzählebene	positive
lohnniveau	positive
aufbereitungsstufe	positive
fahrstufe	positive
grundstufe	positive
gemeindeebene	positive
einrichten	positive
gefälligkeit	positive
festnehmen	positive
arretieren	positive
inhaftieren	positive
verhaften	positive
instanz	positive
vereinsamt	negative
anschluss	negative
verehrungswürdig	positive
hehr	positive
finanzierung	negative
hash-funktion	negative
hashfunktion	negative
antisemit	negative
kreisleitung	negative
museumsleitung	negative
einsatzleitung	negative
orchesterleitung	negative
kontoführung	negative
militärführung	negative
fraktionsführung	negative
feuerleitung	negative
anstaltsleitung	negative
reichsleitung	negative
redaktionsleitung	negative
vereinsführung	negative
wirtschaftsleitung	negative
armeeführung	negative
menschenführung	negative
chorleitung	negative
künstlerische leitung	negative
schulleitung	negative
spielleitung	negative
teamleitung	negative
dirigat	negative
konzernleitung	negative
streikleitung	negative
verhandlungsführung	negative
bezirksleitung	negative
haushaltsführung	negative
wirtschaftsführung	negative
amtsführung	negative
meinungsführerschaft	negative
gesamtleitung	negative
personalführung	negative
gewerkschaftsführung	negative
verlagsführung	negative
bauleitung	negative
klinikleitung	negative
universitätsleitung	negative
messeleitung	negative
kommandantur	negative
bioterror	negative
bioterrorismus	negative
quote	negative
koitieren	positive
aufsicht	negative
kopulieren	positive
renovierbar	positive
canceln	negative
instandsetzbar	positive
engagement	positive
rate	negative
produktpräsentation	negative
warenpräsentation	negative
onlineauftritt	negative
wiedervorlage	negative
bildschirmdarstellung	negative
anstrengen	positive
firmenpräsentation	negative
menschenverachtend	negative
position	positive
aufschub	negative
aufschiebung	negative
unentschieden	negative
unentschlossen	negative
geistesklar	positive
berücksichtigen	positive
achsstand	negative
heraufsetzen	positive
achsenstand	negative
achsabstand	negative
heraufsetzung	positive
anhebung	positive
ausgehen	positive
entweihung	negative
übereinstimmung	negative
roh	negative
vaterlandslos	negative
betätigen	positive
handgreiflich	negative
rabiat	negative
erbarmungslos	negative
rüde	negative
schonungslos	negative
gnadenlos	negative
brachial	negative
mitleidslos	negative
rüd	negative
tötung	negative
totschlag	negative
besamen	positive
bühnenengagement	positive
theaterengagement	positive
verheilt	positive
genesen	positive
wohltäter	positive
wohltäterin	positive
gesundet	positive
moralvorstellung	negative
baumeln	negative
bammeln	negative
herabhängen	negative
herunterhängen	negative
assoziieren	positive
altmeister	positive
gebrauchen	positive
hebung	positive
verbalisieren	positive
belegung	negative
austritt	negative
ballen	positive
blutig	negative
überrumpeln	negative
schwierigkeit	negative
loshauen	negative
grobkörnig	negative
abhauen	negative
unverkrampft	negative
erscheinen	positive
fakultät	negative
stellung	positive
choreographieren	positive
projektieren	positive
vorverlegung	negative
designen	positive
differentialform	negative
automorphismus	negative
realteil	negative
produktionsfunktion	negative
exponentialfunktion	negative
platzierung	negative
übertragungsfunktion	negative
stammfunktion	negative
umkehrfunktion	negative
potenzfunktion	negative
bilinearform	negative
isomorphismus	negative
funktor	negative
nutzenfunktion	negative
schätzfunktion	negative
logarithmus	negative
häufigkeitsverteilung	negative
verteilungsfunktion	negative
quantor	negative
divisor	negative
winkelfunktion	negative
homomorphismus	negative
wellenfunktion	negative
determinante	negative
gut tun	positive
schwängern	positive
guttun	positive
zukunftsvision	negative
oberstufe	positive
resistent	positive
populationsdichte	negative
bevölkerungsdichte	negative
unaussprechlich	negative
raffiniert	positive
ausgebufft	positive
immun	positive
belästigen	positive
einschichtig	negative
verlassen	negative
ungehemmt	negative
einplanen	positive
punkt	negative
benutzbar	positive
treten	negative
handlich	positive
handhabbar	positive
abwahl	negative
abgewrackt	negative
amateurhaft	negative
zünden	positive
entzweien	positive
verkaufsfördernd	positive
wachstumsfördernd	positive
leistungsfördernd	positive
verwertbar	positive
erneuerbar	positive
internetfähig	positive
speicherbar	positive
abbaubar	positive
aufladbar	positive
praktikabel	positive
auswertbar	positive
erschliessbar	positive
netzwerkfähig	positive
bedienbar	positive
verarbeitbar	positive
anbaufähig	positive
abbauwürdig	positive
bandabstand	negative
bandlücke	negative
weserübung	negative
mongolensturm	negative
nerven	negative
drangsalierung	negative
tierquälerei	negative
misshandlung	negative
entgleisung	negative
fettnäpfchen	negative
austausch	negative
ausplünderung	negative
erreichbar	negative
nobilitierung	positive
standeserhöhung	positive
kaperung	negative
hausbesetzung	negative
viele	positive
allerlei	positive
vielerlei	positive
mancherlei	positive
wahlverwandtschaft	negative
schwägerschaft	negative
standhalten	positive
narr	negative
grausam	negative
behängen	negative
blutrünstig	negative
militant	negative
vorhängen	negative
tätlich	negative
heraushängen	negative
gesundheitsabträglich	negative
verkuppeln	positive
bemühen	positive
rühmlich	positive
gewinn	negative
anpöbeln	positive
evozieren	positive
beschlag	negative
ausschlachten	negative
verbeissen	negative
verschmerzen	positive
verkraften	positive
bedenklich	negative
anstiften	positive
geben	negative
erklären	positive
anzetteln	positive
weite	negative
utopie	negative
programm	negative
bestreben	positive
grabscher	negative
grabscherin	negative
grapscher	negative
grapscherin	negative
fummler	negative
fummlerin	negative
räuber	negative
parallaxe	negative
verpennen	negative
verschnarchen	negative
verschlafen	negative
verdrahten	positive
einwohnerdichte	negative
textverarbeitungssystem	negative
newsreader	negative
nachrichtenleser	negative
webanwendung	negative
webapplikation	negative
textverarbeitungsprogramm	negative
kommen	positive
inflation	positive
mensur	negative
ferne	negative
umringen	positive
ergreifen	positive
radstand	negative
bodenfreiheit	negative
augenabstand	negative
autostunde	negative
höhenstufe	negative
betrachtungsabstand	negative
sicherheitsabstand	negative
winkelabstand	negative
tuchfühlung	negative
katzensprung	negative
zeilenabstand	negative
mindestabstand	negative
reichweite	negative
apogäum	negative
brennweite	negative
stützweite	negative
wellenlänge	negative
luftlinie	negative
tragweite	negative
partie	negative
solidarität	negative
anlehnung	negative
dichte	negative
krimskrams	negative
kleinkram	negative
ertragen	negative
lehrmeister	positive
lehrmeisterin	positive
schneidig	positive
beredt	positive
vollbringen	positive
äther	negative
rüstig	positive
krank	negative
quietschfidel	positive
clean	positive
kerngesund	positive
einhängen	negative
cannstatter wasen	positive
carnival	positive
oktoberfest	positive
räuberin	negative
meisterdiebin	negative
kleptomane	negative
autodiebin	negative
autodieb	negative
taschendieb	negative
ladendieb	negative
kleptomanin	negative
ladendiebin	negative
meisterdieb	negative
zurückweisen	negative
taschendiebin	negative
beredsam	positive
wortgewaltig	positive
eloquent	positive
wortreich	positive
wortgewandt	positive
entfalten	positive
schnitt	negative
selbstentblösser	negative
exhibitionist	negative
selbstentblösserin	negative
exhibitionistin	negative
grauen	negative
scheuen	negative
schaudern	negative
inkonsequent	negative
gelenk	negative
kabelschuh	negative
kabelsteckverbinder	negative
gelenkstück	negative
pardun	negative
pardune	negative
vormachen	negative
ansuchen	positive
anrufen	positive
unumschränkt	positive
absolutistisch	positive
abpflücken	negative
pflücken	negative
wecken	positive
aufrühren	positive
broterwerb	negative
stiften	positive
zeitigen	positive
bedingen	positive
verschulden	positive
heraufbeschwören	positive
emotionalisieren	positive
herbeiführen	positive
gefühle verursachen	positive
agent	negative
einhauchen	positive
lobenswert	positive
löblich	positive
anwendungsprogramm	negative
anwenderprogramm	negative
anwendungssoftware	negative
beharren	positive
ehrbar	positive
glorreich	positive
ehrenwert	positive
ruhmvoll	positive
achtbar	positive
ruhmreich	positive
trödel	negative
kinderkram	negative
papierkram	negative
erkennbar	positive
senkung	negative
it-anwendung	negative
internetanwendung	negative
unternehmensanwendung	negative
sound player	negative
multimediaanwendung	negative
standardanwendungssoftware	negative
spreadsheet	negative
webservice	negative
kenntlich	positive
treffend	positive
trefflich	positive
untauglich	negative
computerbild	negative
lasche	negative
unterbringen	positive
vorgreifen	positive
abfahren	positive
elevation	positive
gefährden	negative
raffinesse	negative
berufstätigkeit	negative
trichter	negative
granattrichter	negative
beruf	negative
bombentrichter	negative
berufsausübung	negative
erwerbstätigkeit	negative
erwerbsarbeit	negative
schächten	negative
notschlachten	negative
ausprägen	positive
grammatikalisieren	positive
frass	negative
runden	positive
kinderschänder	negative
frotteurin	negative
vergewaltigerin	negative
kinderschänderin	negative
vergewaltiger	negative
frotteur	negative
unterhaltung	negative
besorgen	negative
nähe	negative
wende	negative
druckerhöhung	positive
empfangen	positive
spannungserhöhung	positive
temperaturerhöhung	positive
rangerhöhung	positive
muffe	negative
dreck	negative
plunder	negative
lager	negative
zählen	positive
ramsch	negative
kram	negative
krempel	negative
bettel	negative
klimbim	negative
brüten	positive
verbundstück	negative
verbindungsstück	negative
anzünden	negative
querverbindung	negative
pressverbindung	negative
adapter	negative
nippel	negative
stiftverbindung	negative
ohrpassstück	negative
gleisverbindung	negative
steckverbindung	negative
kupplungsstutzen	negative
eisenbahnanschluss	negative
traktur	negative
corps	negative
kopfhörerbügel	negative
zugverband	negative
scharnier	negative
kabelseele	negative
drehstück	negative
schäkel	negative
scart	negative
flansch	negative
in brand setzen	negative
exempel	positive
schöpfungsmythos	positive
schöpfungsbericht	positive
studentencorps	negative
gezähmt	positive
strapazieren	positive
herausgeben	negative
unseriös	negative
erdulden	positive
gewieft	positive
gewitzt	positive
unverwechselbar	positive
unverkennbar	positive
stück	negative
danebengegangen	negative
schiefgegangen	negative
fehlgeschlagen	negative
operation	negative
schiefgelaufen	negative
