schlecht	negative
nachtragend	negative
ärgerlich	negative
zornig	negative
schwach	negative
böse	negative
wütend	negative
kompliziert	negative
langweilig	negative
schlimm	negative
grimmig	negative
schwierig	negative
schrecklich	negative
langsam	negative
dumm	negative
sauer	negative
teuflisch	negative
dämonisch	negative
diabolisch	negative
satanisch	negative
verletzt	negative
pikiert	negative
eingeschnappt	negative
gekränkt	negative
beleidigt	negative
feig	negative
feige	negative
hinterhältig	negative
unversöhnlich	negative
bös	negative
bösartig	negative
böswillig	negative
hämisch	negative
maliziös	negative
entwürdigend	negative
vorwurfsvoll	negative
boshaft	negative
niederträchtig	negative
übel	negative
gemein	negative
süffisant	negative
hündisch	negative
hasserfüllt	negative
stiefmütterlich	negative
schwer erziehbar	negative
schwererziehbar	negative
luziferisch	negative
mephistophelisch	negative
tückisch	negative
ruchbar	negative
lieb	positive
phantastisch	positive
liebevoll	positive
prima	positive
schön	positive
fantastisch	positive
schnell	positive
stark	positive
hübsch	positive
nett	positive
hervorragend	positive
sympathisch	positive
grossartig	positive
gemeingefährlich	negative
heimtückisch	negative
arglistig	negative
beknackt	negative
bitterböse	negative
erbost	negative
durchtrainiert	positive
infernal	negative
hart	positive
unberechenbar	negative
unkalkulierbar	negative
mau	negative
stabil	positive
perfid	negative
perfide	negative
selbstständig	positive
selbständig	positive
blitzschnell	positive
blitzartig	positive
sekundenschnell	positive
rasant	positive
explosionsartig	positive
trainiert	positive
flau	negative
souverän	positive
absolut	positive
durchtrieben	negative
hinterlistig	negative
infam	negative
hinterfotzig	negative
bärenstark	positive
stramm	positive
erzürnt	negative
unsportlich	negative
unnütz	negative
kernig	positive
fit	positive
nutzlos	negative
aggressiv	negative
übertrieben	positive
muskelbepackt	positive
muskulös	positive
vermaledeit	negative
verwünscht	negative
verflucht	negative
verflixt	negative
unselbständig	negative
unselbstständig	negative
unumschränkt	positive
absolutistisch	positive
aufhetzend	negative
demagogisch	negative
hetzerisch	negative
aufwiegelnd	negative
nichtsnutzig	negative
unnützlich	negative
angriffslustig	negative
kampfeslustig	negative
kampflustig	negative
indigniert	negative
empört	negative
entrüstet	negative
süss	positive
unauffällig	negative
matt	negative
ruckartig	positive
kräftig	positive
liebesfähig	positive
liebreich	positive
unbegreiflich	negative
unbegreifbar	negative
unverständlich	negative
sicher	positive
wild	negative
untrainiert	negative
belämmert	negative
behämmert	negative
bescheuert	negative
zärtlich	positive
zänkisch	negative
zanksüchtig	negative
streitsüchtig	negative
hinfällig	negative
gebrechlich	negative
morbide	negative
sportlich	positive
eigenständig	positive
fein	positive
schädlich	negative
unmässig	positive
masslos	positive
zwecklos	negative
schwindlig	negative
verwickelt	negative
offensiv	negative
fuchsteufelswild	negative
fuchsig	negative
verworren	negative
verwoben	negative
draufgängerisch	negative
gehässig	negative
provokativ	negative
provozierend	negative
bissig	negative
vielschichtig	negative
verzwickt	negative
komplex	negative
verzwackt	negative
vertrackt	negative
beziehungsreich	negative
schädigend	negative
abträglich	negative
zweckfrei	negative
unzweckmässig	negative
ätzend	negative
mistig	negative
oll	negative
peinlich	negative
dufte	positive
knorke	positive
astrein	positive
scheiss	negative
kraftvoll	positive
instabil	negative
mutig	positive
lächerlich	negative
fest	positive
heftig	positive
berechenbar	positive
zorn	negative
genierlich	negative
genant	negative
problemvoll	negative
problematisch	negative
brenzlig	negative
brisant	negative
doof	negative
blöd	negative
dämlich	negative
dull	negative
stilsicher	positive
stilgerecht	positive
geschmackvoll	positive
stilvoll	positive
autokratisch	positive
einförmig	negative
gefährdet	negative
edel	positive
wertlos	negative
dahergelaufen	negative
herausfordernd	negative
forsch	negative
kriegerisch	negative
streitlustig	negative
wut	negative
blass	negative
erbittert	negative
labil	negative
monoton	negative
eintönig	negative
fix	positive
verheerend	negative
katastrophal	negative
vernichtend	negative
mickerig	negative
schlaff	negative
schwächlich	negative
schlapp	negative
abgeschlagen	negative
horrend	positive
überzogen	positive
überhöht	positive
unsinnig	negative
sinnlos	negative
unfair	negative
ungerecht	negative
zäh	positive
ungünstig	negative
unakzeptabel	negative
misslungen	negative
wuchtig	positive
knuffig	positive
goldig	positive
niedlich	positive
herzig	positive
possierlich	positive
putzig	positive
drollig	positive
konditionsstark	positive
widerstandsfähig	positive
unehrenhaft	negative
unvorteilhaft	negative
bescheiden	negative
attraktiv	positive
kalkulierbar	positive
inakzeptabel	negative
missraten	negative
ehrlos	negative
beschissen	negative
schäbig	negative
dilettantisch	negative
miserabel	negative
unschön	negative
lausig	negative
stümperhaft	negative
ungut	negative
grottig	negative
mörderisch	positive
höllisch	positive
auffällig	positive
mächtig	positive
eklatant	positive
unkompliziert	positive
trocken	negative
reissend	positive
unerklärlich	negative
unerklärbar	negative
machtvoll	positive
selbstbewusst	positive
intensiv	positive
hochgradig	positive
selbstsicher	positive
prekär	negative
heikel	negative
dornig	negative
knifflig	negative
unerfindlich	negative
unergründlich	negative
unauffallend	negative
faul	negative
sehnig	positive
drahtig	positive
unedel	negative
feingeschnitten	positive
fein geschnitten	positive
hochwertig	positive
anfällig	negative
hilfesuchend	negative
hilfebedürftig	negative
hilfe suchend	negative
hilfsbedürftig	negative
aufgebracht	negative
geharnischt	negative
öd	negative
öde	negative
fade	negative
fad	negative
flügge	positive
kraftlos	negative
solide	positive
solid	positive
flott	positive
bleich	negative
gefährlich	negative
hochklassig	positive
prächtig	positive
prachtvoll	positive
verloren	negative
vortrefflich	positive
vorzüglich	positive
dröge	negative
verzögerungslos	positive
rasch	positive
eilig	positive
temporeich	positive
reflexhaft	positive
nahtlos	positive
hastig	positive
rapide	positive
rapid	positive
reflexartig	positive
saublöd	negative
stupide	negative
einfältig	negative
saudumm	negative
tumb	negative
beschränkt	negative
töricht	negative
saudoof	negative
stupid	negative
giftig	negative
scharf	positive
memmenhaft	negative
altersschwach	negative
muskelschwach	negative
sehschwach	negative
konditionsschwach	negative
zart	negative
zittrig	negative
immunschwach	negative
hilflos	negative
destruktiv	negative
verkehrsarm	negative
verkehrsschwach	negative
gelind	negative
gelinde	negative
unfassbar	negative
toxisch	negative
zerstörerisch	negative
umweltschädlich	negative
gesundheitsschädlich	negative
gesundheitsschädigend	negative
umweltschädigend	negative
schleppend	negative
träge	negative
träg	negative
lahm	negative
transusig	negative
tranig	negative
stinklangweilig	negative
sterbenslangweilig	negative
nichts sagend	negative
nichtssagend	negative
kabbalistisch	negative
lebhaft	positive
zurückhaltend	negative
amoralisch	negative
unglücklich	negative
unfreundlich	negative
schuldig	negative
glücklos	negative
erfolglos	negative
ergebnislos	negative
ungeeignet	negative
chancenlos	negative
dezent	negative
furchtbar	negative
fürchterlich	negative
traumatisierend	negative
traumatisch	negative
suizidgefährdet	negative
selbstmordgefährdet	negative
lebendig	positive
trostlos	negative
trist	negative
undurchschaubar	negative
stahlhart	positive
steinhart	positive
eisenhart	positive
unabhängig	positive
eitrig	negative
vereitert	negative
schwerverwundet	negative
schwerverletzt	negative
eiternd	negative
krankenhausreif	negative
komplizieren	negative
hochkompliziert	negative
unverträglich	negative
frei	positive
ruinös	negative
anrüchig	negative
unprofessionell	negative
charakterlos	negative
laienhaft	negative
pejorativ	negative
ineffektiv	negative
fehlerhaft	negative
widrig	negative
grauslich	negative
kriminell	negative
strafwürdig	negative
grottenschlecht	negative
leid	negative
schrecken	negative
protzig	positive
unbändig	positive
überschwänglich	positive
gutartig	positive
anziehend	positive
unlöslich	negative
beleidigen	negative
gewalttätig	negative
hochkomplex	negative
geschäftsschädigend	negative
anoxisch	negative
parteischädigend	negative
rufschädigend	negative
kontraproduktiv	negative
einseitig	negative
druckvoll	positive
überhart	positive
kopfballstark	positive
unbezähmbar	positive
unvermindert	positive
überstark	positive
durchsetzungsfähig	positive
gefestigt	positive
konfliktfähig	positive
gewaltig	positive
verstärkt	positive
entschieden	positive
entschlossen	positive
diffizil	negative
resolut	positive
siegesgewiss	positive
siegessicher	positive
siegesbewusst	positive
lädiert	negative
entzündet	negative
wund	negative
blessiert	negative
herstellerunabhängig	positive
oberflächlich	negative
wohl geformt	positive
wohlgeformt	positive
suchtgefährdet	negative
verführbar	negative
beeinflussbar	negative
unfallgefährdet	negative
rückfällig	negative
facettenreich	negative
pflegeabhängig	negative
pflegebedürftig	negative
rat suchend	negative
ratsuchend	negative
grandios	positive
herausragend	positive
sintflutartig	negative
wolkenbruchartig	negative
verblichen	negative
verletzen	negative
sympathieerweckend	positive
sympathie erweckend	positive
leicht	negative
bestechend	positive
famos	positive
fulminant	positive
kränken	negative
verschorft	negative
allegro	positive
reizlos	negative
fluchtartig	positive
zügig	positive
flink	positive
geschwind	positive
hurtig	positive
kometenhaft	positive
pfeilschnell	positive
superschnell	positive
galoppierend	positive
schnellwüchsig	positive
schnellfüssig	positive
grimm	negative
grantig	negative
gebleicht	negative
verblasst	negative
ausgebleicht	negative
fertig	negative
negativ	negative
gut	positive
grau	negative
erledigt	negative
abhängig	negative
konsequent	positive
groggy	negative
ausgepowert	negative
unbeachtet	negative
unerträglich	negative
unbeirrbar	positive
lichtschwach	negative
entscheidungsschwach	negative
rauchschwach	negative
finanzschwach	negative
willensschwach	negative
weinerlich	negative
wirtschaftsschwach	negative
leistungsschwach	negative
nervenschwach	negative
einkommensschwach	negative
mitgliederschwach	negative
umsatzschwach	negative
farbschwach	negative
fehlbar	negative
geburtenschwach	negative
charakterschwach	negative
strukturschwach	negative
verkaufsschwach	negative
lohnabhängig	negative
angewiesen	negative
anlehnungsbedürftig	negative
liebenswürdig	positive
liebenswert	positive
unzufrieden	negative
gemächlich	negative
andante	negative
stockend	negative
ersichtlich	positive
unbeobachtet	negative
unbemerkt	negative
strohdumm	negative
strohdoof	negative
trottelhaft	negative
dusslig	negative
idiotenhaft	negative
dusselig	negative
idiotisch	negative
trottelig	negative
geisttötend	negative
ermüdend	negative
wunderschön	positive
schmachvoll	negative
dekorativ	positive
schmählich	negative
bildschön	positive
schmuck	positive
tiefgreifend	positive
tiefgehend	positive
tiefreichend	positive
tiefschürfend	positive
offenkundig	positive
offensichtlich	positive
offenbar	positive
sichtlich	positive
manifest	positive
getragen	negative
rage	negative
ernstlich	positive
unaufschiebbar	positive
dringend	positive
dringlich	positive
wertstabil	positive
richtungsstabil	positive
preisstabil	positive
säuerlich	negative
verwundet	negative
eklig	negative
arg	negative
niedertracht	negative
einschätzbar	positive
robust	positive
adelig	positive
adlig	positive
missvergnügt	negative
angefressen	negative
blaublütig	positive
aristokratisch	positive
unstabil	negative
gründlich	positive
steif	positive
stechend	positive
beissend	positive
bildhübsch	positive
sinnig	positive
sinnvoll	positive
staatsmännisch	positive
fleissig	positive
jähzorn	negative
zerstörungswut	negative
volkszorn	negative
schnöde	negative
entwürdigen	negative
prunkvoll	positive
pompös	positive
prunkhaft	positive
urlaubsreif	negative
erholungsbedürftig	negative
unschädlich	positive
deformiert	negative
langeweile	negative
glühend	positive
nützlich	positive
friedlich	positive
appetitlich	positive
gepflegt	positive
leuchtend	positive
beinhart	positive
knallhart	positive
unerbittlich	positive
adrett	positive
abgehärtet	positive
klug	positive
niedrig	negative
nieder	negative
kreideweiss	negative
kalkweiss	negative
unspektakulär	negative
idiot	negative
trottel	negative
unbarmherzig	positive
voreingenommen	negative
violent	positive
gewaltsam	positive
hervorragen	positive
ästhetisch	positive
übermässig	positive
absurd	negative
abstrus	negative
subjektiv	negative
farblos	negative
angeschlagen	negative
kriegsmüde	negative
schadenfroh	negative
schurkisch	negative
garstig	negative
fies	negative
mies	negative
popelig	negative
poplig	negative
verstohlen	negative
unscheinbar	negative
unverdächtig	negative
fair	positive
gerecht	positive
unwürdig	negative
würdelos	negative
ansehnlich	positive
uninteressant	negative
interessant	positive
keck	positive
schlagfertig	positive
nachdrücklich	positive
eindringlich	positive
wässrig	negative
versöhnlich	positive
wässerig	negative
qualitätsvoll	positive
qualitätvoll	positive
voreilig	positive
vorschnell	positive
moralisch	positive
lappig	negative
resistent	positive
gütig	positive
abscheulich	negative
verabscheuungswürdig	negative
zweckmässig	positive
verdammt	positive
gelungen	positive
akzeptabel	positive
debil	negative
begriffsstutzig	negative
geistesschwach	negative
unterbelichtet	negative
ignorant	negative
schwachsinnig	negative
sinnlich	positive
ärger	negative
hässlich	negative
verärgert	negative
furios	positive
ansprechend	positive
vorzeigbar	positive
apart	positive
liebreizend	positive
unwiderstehlich	positive
rassig	positive
begehrenswert	positive
verführerisch	positive
kokett	positive
scharmant	positive
charmant	positive
lieblich	positive
zweifelsfrei	positive
zweifellos	positive
unbezweifelbar	positive
graziös	positive
anmutig	positive
ausgebrannt	negative
erschöpft	negative
abgespannt	negative
ausgepumpt	negative
mitgenommen	negative
ausgelaugt	negative
entkräftet	negative
erzürnen	negative
dicht	positive
bodenlos	negative
verschossen	negative
staubtrocken	negative
hochherrschaftlich	positive
nobel	positive
blassrosa	negative
verwaschen	negative
unannehmbar	negative
unvertretbar	negative
mühevoll	positive
undicht	negative
unrühmlich	negative
günstig	positive
durchlässig	negative
empörend	negative
himmelschreiend	negative
freundlich	positive
vaterlandslos	negative
kaltblütig	positive
abgewrackt	negative
amateurhaft	negative
streng	positive
schweisstreibend	positive
kräftezehrend	positive
strapaziös	positive
entbehrungsreich	positive
vollkommen	positive
unfruchtbar	negative
seelenruhig	positive
kaltschnäuzig	positive
abgezockt	positive
felsenfest	positive
bombensicher	positive
standfest	positive
völlig	positive
total	positive
gänzlich	positive
zappelig	negative
grossspurig	negative
grossmäulig	negative
angeberisch	negative
wichtigtuerisch	negative
grosskotzig	negative
prahlerisch	negative
hochgespannt	positive
aromatisch	positive
halbwild	negative
prätentiös	negative
würzig	positive
schal	negative
neuwertig	positive
wertig	positive
erbosen	negative
bestimmt	positive
stressig	positive
anstrengend	positive
druckfest	positive
charismatisch	positive
definit	positive
verträglich	positive
undurchlässig	positive
inhaltsarm	negative
gegeben	positive
feststehend	positive
glücklich	positive
unschuldig	positive
tüchtig	positive
vornehm	positive
entsetzlich	negative
tragisch	negative
scheusslich	negative
eifrig	positive
emsig	positive
arbeitsam	positive
erfolgreich	positive
chancenreich	positive
glückreich	positive
geeignet	positive
ergebnisreich	positive
tücke	negative
betörend	positive
unattraktiv	negative
strapazierfähig	positive
wacklig	negative
marode	negative
marod	negative
rostig	negative
verrostet	negative
wackelig	negative
stumpf	negative
sinnhaft	positive
sinnreich	positive
energisch	positive
formen	positive
hektisch	negative
kalt	positive
ungefährdet	positive
überzeugt	positive
kaltherzig	positive
hartherzig	positive
ausgekocht	positive
hartgesotten	positive
abgebrüht	positive
beispielhaft	positive
zahm	positive
ungezähmt	negative
geklärt	positive
ertragssicher	positive
vorherbestimmt	positive
fraglos	positive
untrüglich	positive
unzweifelhaft	positive
deterministisch	positive
todsicher	positive
mustergültig	positive
vorbildlich	positive
vorbildhaft	positive
paradigmatisch	positive
kraft	positive
rasend	positive
edelmütig	positive
griffig	positive
frenetisch	positive
thermostabil	positive
hitzestabil	positive
empören	negative
minderwertig	negative
undankbar	negative
unverfroren	negative
impertinent	negative
unverschämt	negative
verwittert	negative
baufällig	negative
originell	positive
schmuckvoll	positive
geil	positive
mitreissend	positive
pflegeleicht	positive
voraussagbar	positive
vorhersagbar	positive
notorisch	positive
allbekannt	positive
gewalt	positive
unruhig	positive
spitzfindig	negative
spöttisch	negative
spitz	negative
überflüssig	negative
müssig	negative
turbulent	positive
positiv	positive
trainieren	positive
vogelscheuche	negative
eigen	negative
tragfähig	positive
unzerstörbar	positive
witterungsbeständig	positive
bruchfest	positive
unbrennbar	positive
formstabil	positive
wasserfest	positive
abriebfest	positive
feuerfest	positive
unzerbrechlich	positive
festgefügt	positive
lichtbeständig	positive
zuträglich	positive
markig	positive
aussergewöhnlich	positive
matschig	positive
morastig	positive
schlammig	positive
ungeschrieben	positive
flagrant	positive
ehrenhaft	positive
einfallsreich	positive
erfindungsreich	positive
ideenreich	positive
sittlich	positive
desolat	negative
fintenreich	positive
trickreich	positive
listig	positive
listenreich	positive
melodramatisch	positive
flach	negative
ethisch	positive
vollmundig	negative
lautstark	negative
zynisch	negative
höhnisch	negative
schnippisch	negative
scharfzüngig	negative
schablonenhaft	negative
weich	negative
harsch	positive
übersehbar	positive
gewiss	positive
entscheidbar	positive
relativ	negative
phlegmatisch	negative
glänzend	positive
unbeschreibbar	negative
auffallend	positive
dick	positive
danebengegangen	negative
schiefgegangen	negative
fehlgeschlagen	negative
schiefgelaufen	negative
popanz	negative
förmlich	negative
pedantisch	negative
ungezogen	negative
unbeschreiblich	negative
unsagbar	negative
unsäglich	negative
verleumderisch	negative
schnoddrig	negative
polemisch	negative
vorlaut	negative
muskel	positive
schaden	negative
fragil	positive
kolloidal	positive
kolloid	positive
zerbrechlich	positive
immun	positive
vital	positive
schreckfigur	negative
schreckgespenst	negative
schreckgestalt	negative
sexy	positive
blind	negative
exzeptionell	positive
ausserordentlich	positive
schädigen	negative
dickflüssig	positive
tugendlich	positive
tugendreich	positive
legendär	positive
legendenhaft	positive
spitze	positive
herrlich	positive
klasse	positive
paradiesisch	positive
tugendhaft	positive
endgeil	positive
mythisch	positive
himmlisch	positive
nutzbringend	positive
friedliebend	positive
schlicht	negative
banal	negative
einfach	negative
trivial	negative
gebrechen	negative
uniform	negative
gleichförmig	negative
heimtücke	negative
genehm	positive
geraten	positive
arglist	negative
theatralisch	positive
reizvoll	positive
clever	positive
auf zack	positive
alert	positive
geschützt	positive
lebensgefährlich	negative
lebensbedrohend	negative
risikobehaftet	negative
lebensbedrohlich	negative
riskant	negative
risikoreich	negative
hochwassergefährdet	negative
einsturzgefährdet	negative
verloren gegangen	negative
verlorengegangen	negative
zuverlässig	positive
unsicher	negative
unästhetisch	negative
macht	positive
mass	positive
lawinensicher	positive
frostsicher	positive
kugelsicher	positive
trittsicher	positive
uneinnehmbar	positive
betriebssicher	positive
mündelsicher	positive
abgeklärt	positive
geschäftig	positive
agil	positive
betriebsam	positive
vehement	positive
ungestüm	positive
gefällig	positive
oberblödmann	negative
vollidiotin	negative
volltrottel	negative
vollidiot	negative
feinkörnig	positive
duftig	positive
unfein	negative
feingemahlen	positive
filigran	positive
muffelig	negative
miesepetrig	negative
griesgrämig	negative
wucht	positive
involviert	negative
gefährden	negative
bestmöglich	positive
viskos	positive
bindig	positive
lachen	negative
problem	negative
nass	positive
feucht	positive
aktiv	positive
arbeitswillig	positive
ungiftig	positive
tatkräftig	positive
diensteifrig	positive
übereifrig	positive
servil	positive
beflissen	positive
arbeitsfreudig	positive
eingängig	positive
optimal	positive
gutherzig	positive
imageträchtig	positive
erfolgversprechend	positive
grossherzig	positive
meisterhaft	positive
meisterlich	positive
prestigeträchtig	positive
anspruchslos	negative
ausgezeichnet	positive
exzellent	positive
erfolg versprechend	positive
wundervoll	positive
wunderbar	positive
allmächtig	positive
finanzkräftig	positive
wirkmächtig	positive
omnipotent	positive
wirkungsmächtig	positive
finanzstark	positive
lachhaft	negative
hast	positive
eile	positive
luftgetrocknet	negative
gelöscht	negative
gefriergetrocknet	negative
semiarid	negative
bedroht	negative
feinschmeckerisch	positive
kulinarisch	positive
weise	positive
geistreich	positive
genial	positive
gerissen	positive
brillant	positive
schlitzohrig	positive
scharfsinnig	positive
genialisch	positive
geistvoll	positive
spektakulär	positive
erbittern	negative
letal	negative
brandgefährlich	negative
tödlich	negative
hochgefährlich	negative
grob	negative
unpersönlich	negative
detachiert	negative
erklärt	positive
zufrieden	positive
lebenstüchtig	positive
geschäftstüchtig	positive
eilfertig	positive
gelehrig	positive
lethargisch	negative
doofmann	negative
hampelmann	negative
verformt	negative
ungelenkig	positive
jäh	positive
ungelenk	positive
feudalistisch	positive
altadelig	positive
feudal	positive
altadlig	positive
königlich	positive
kleinadlig	positive
royal	positive
kleinadelig	positive
stümper	negative
faulig	negative
verfault	negative
hinderlich	negative
sinn	positive
kondition	positive
fürstlich	positive
mühelos	negative
schneidig	positive
starr	positive
vorteilhaft	positive
reputierlich	positive
gediegen	positive
verlieren	negative
hanswurst	negative
beachtet	positive
ungesehen	negative
unerkannt	negative
ungehört	negative
störend	negative
selbstzerstörerisch	negative
selbstschädigend	negative
nervenschädlich	negative
augenschädigend	negative
nervenschädigend	negative
nierenschädlich	negative
klimaschädigend	negative
leberschädlich	negative
nierenschädigend	negative
klimaschädlich	negative
leberschädigend	negative
augenschädlich	negative
unverwüstlich	positive
winterhart	positive
ohnmächtig	negative
genügsam	negative
angenehm	positive
toll	positive
wichtig	positive
potent	positive
kaiserlich-königlich	positive
hochadlig	positive
höfisch	positive
freiherrlich	positive
spannungsreich	positive
standesherrlich	positive
kaiserlich	positive
hochadelig	positive
wünschenswert	positive
sagenhaft	positive
berauschend	positive
gehoben	positive
begrüssenswert	positive
herzensgut	positive
sensationell	positive
perfekt	positive
unfehlbar	positive
märchenhaft	positive
okay	positive
idyllisch	positive
erstklassig	positive
bedenkenswert	positive
traumhaft	positive
spitzenmässig	positive
elefantös	positive
ideal	positive
besser	positive
unübertrefflich	positive
ehrenvoll	positive
blendend	positive
überragend	positive
gutmütig	positive
phänomenal	positive
verbrecherisch	negative
delinquent	negative
schändlich	negative
straffällig	negative
umsatzstark	positive
kampfstark	positive
spielstark	positive
tonangebend	positive
imperial	positive
einflussreich	positive
übermächtig	positive
brutal	positive
pracht	positive
gräulich	negative
ausgetrocknet	negative
halbtrocken	negative
arid	negative
martialisch	negative
kannibalisch	negative
barbarisch	negative
unansehnlich	negative
verfänglich	negative
verlegt	negative
hilfe	negative
zähflüssig	positive
vordergründig	negative
erträglich	positive
hell	positive
memme	negative
spannend	positive
spannungsvoll	positive
arsch	negative
faszinierend	positive
begeisternd	positive
fesselnd	positive
arschloch	negative
narr	negative
depp	negative
blödmann	negative
dummkopf	negative
dumpfbacke	negative
affe	negative
idiotin	negative
ätherisch	negative
verzeihend	positive
knochentrocken	negative
huldreich	positive
gnädig	positive
hochintelligent	positive
verzögerung	positive
vergeistigt	positive
pfiffig	positive
gescheit	positive
finessenreich	positive
graulich	negative
anthrazitfarben	negative
silbergrau	negative
metallicgrau	negative
anthrazit	negative
charakterfest	positive
integer	positive
bedrohlich	negative
torgefährlich	negative
existenzbedrohend	negative
gefahr	negative
explosionsgefährlich	negative
gefahrvoll	negative
gehbehindert	negative
trocken-kalt	negative
schleppen	negative
zytotoxisch	negative
hochgiftig	negative
umweltbelastend	negative
umweltgefährdend	negative
schuld	negative
untauglich	negative
standhaft	positive
platt	negative
dümmlich	negative
seicht	negative
blödsinnig	negative
unfähig	negative
schuldhaft	negative
unüberprüfbar	negative
verteufelt	negative
barsch	negative
mitschuldig	negative
unverrichtet	negative
laie	negative
verkomplizieren	negative
unverbindlich	negative
gewalttat	negative
verstärken	positive
lesbar	positive
unstimmig	negative
strafbar	negative
erpresserisch	negative
lebensfeindlich	negative
kleinkriminell	negative
dissozial	negative
asozial	negative
betrügerisch	negative
räuberisch	negative
schreck	negative
flucht	positive
durchschauen	negative
streitbar	positive
ausgesprochen	positive
betont	positive
schlagkräftig	positive
durchschlagskräftig	positive
roh	negative
kursorisch	negative
klischeehaft	negative
intelligent	positive
kurzweile	positive
unzumutbar	negative
rabiat	negative
schonungslos	negative
gnadenlos	negative
brachial	negative
handgreiflich	negative
mitleidslos	negative
erbarmungslos	negative
rüde	negative
rüd	negative
schlau	positive
unerotisch	negative
grundsolid	positive
grundsolide	positive
verbraucht	negative
fantasievoll	positive
phantasievoll	positive
insultieren	negative
verunglimpfen	negative
federleicht	negative
reibungslos	negative
wartungsarm	negative
leichtgängig	negative
luftig	negative
schwer	positive
unschwer	negative
phantasiereich	positive
fantasiereich	positive
wieselflink	positive
allegretto	positive
komet	positive
lesenswert	positive
erbaulich	positive
ermüden	negative
kurzweilig	positive
beeindruckend	positive
sehenswürdig	positive
sehenswert	positive
anregend	positive
eindrucksvoll	positive
unterhaltsam	positive
aschgrau	negative
hechtgrau	negative
weissgrau	negative
perlgrau	negative
dunkelgrau	negative
stahlgrau	negative
feldgrau	negative
schwarzgrau	negative
blaugrau	negative
grüngrau	negative
rauchgrau	negative
rauchfarben	negative
taubengrau	negative
steingrau	negative
schiefergrau	negative
hellgrau	negative
anthrazitgrau	negative
lichtgrau	negative
fahlgrau	negative
grauhaarig	negative
nebelgrau	negative
olivgrau	negative
mausgrau	negative
eisgrau	negative
gesundheitsdienlich	positive
wohltuend	positive
gesund	positive
gesundheitsfördernd	positive
gesundheitsförderlich	positive
unbefriedigt	negative
verlebt	negative
andantino	negative
unwille	negative
unmut	negative
ungunst	negative
missmut	negative
adagio	negative
largo	negative
geringwertig	negative
problemfrei	negative
geniessbar	positive
bekömmlich	positive
zank	negative
barmherzig	positive
cool	positive
erklärbar	positive
erklärlich	positive
begreifbar	positive
begreiflich	positive
holprig	positive
staksig	positive
hölzern	positive
essbar	positive
hervorstechend	positive
markant	positive
ausgeprägt	positive
hinterlist	negative
annehmbar	positive
streit	negative
kreativ	positive
schöpferisch	positive
blutig	negative
grausam	negative
kurzweil	positive
verdächtig	positive
demonstrativ	positive
suspekt	positive
ostentativ	positive
umweltverträglich	positive
naturverträglich	positive
erholsam	positive
entspannend	positive
heilsam	positive
heilend	positive
provozieren	negative
unübersehbar	positive
sport	positive
blutrünstig	negative
militant	negative
tätlich	negative
sportiv	positive
athletisch	positive
vertretbar	positive
verdaulich	positive
verärgern	negative
hochinteressant	positive
aufregend	positive
interessieren	positive
abwechslungsreich	positive
fleischlich	positive
pickelig	negative
entstellt	negative
potthässlich	negative
unförmig	negative
unelastisch	positive
immobil	positive
ortsfest	positive
hieratisch	positive
zugänglich	positive
begreifen	negative
erfinderisch	positive
verständlich	positive
defensiv	positive
bestechlich	negative
konstruktiv	positive
korrupt	negative
käuflich	negative
herausfordern	negative
unbedenklich	positive
aberwitzig	negative
irrwitzig	negative
hirnrissig	negative
provokant	positive
wirtschaftsverträglich	positive
magenverträglich	positive
menschenverträglich	positive
stadtverträglich	positive
trinkbar	positive
sozialverträglich	positive
probiotisch	positive
nahrhaft	positive
hautverträglich	positive
gesellschaftsverträglich	positive
unignorierbar	positive
süsslich	positive
zuckersüss	positive
unflexibel	positive
grell	positive
hilfreich	positive
unbeweglich	positive
verätzen	negative
strahlend	negative
unaussprechlich	negative
hintergründig	positive
sinnfällig	negative
primitiv	negative
simpel	negative
penibel	negative
einprägsam	positive
prägnant	positive
scharm	positive
charme	positive
formschön	positive
formvollendet	positive
ungeschützt	negative
unerreichbar	positive
unerschrocken	positive
furchtlos	positive
uneinholbar	positive
unnachahmlich	positive
unübertroffen	positive
heldenhaft	positive
unerreicht	positive
kühn	positive
wagemutig	positive
waghalsig	positive
angstlos	positive
heldisch	positive
heroisch	positive
fett	positive
wohlfeil	negative
niederrangig	negative
rangnieder	negative
parteiisch	negative
intersubjektiv	negative
tendenziös	negative
fassbar	positive
tapfer	positive
wacker	positive
ritterlich	positive
naseweis	positive
kess	positive
inständig	positive
reserviert	negative
zurückgezogen	negative
spröde	negative
menschenscheu	negative
spröd	negative
kontaktarm	negative
krass	positive
durchsichtig	negative
unentschieden	negative
unentschlossen	negative
grazil	positive
beredt	positive
reizend	positive
raffiniert	positive
ausgebufft	positive
verwunden	negative
förderlich	positive
prickelnd	positive
flüssig	negative
reckenhaft	positive
vielseitig	positive
aufrichtig	positive
ernsthaft	positive
seriös	positive
aufrecht	positive
gesetzt	positive
feurig	positive
temperamentvoll	positive
heissblütig	positive
beredsam	positive
eloquent	positive
wortgewaltig	positive
wortreich	positive
wortgewandt	positive
ungeniessbar	negative
unbekömmlich	negative
geschockt	negative
schockiert	negative
erstrangig	positive
glück	positive
zugreifbar	positive
abrufbar	positive
couragiert	positive
beherzt	positive
mut	positive
zerbeult	negative
belastungsfähig	positive
belastbar	positive
brüskieren	negative
schmähen	negative
waschecht	positive
kältebeständig	positive
reissfest	positive
wetterfest	positive
alterungsbeständig	positive
winterfest	positive
korrosionsbeständig	positive
hitzebeständig	positive
säurefest	positive
lichtecht	positive
farbecht	positive
kochfest	positive
temperaturbeständig	positive
betretbar	positive
begehbar	positive
befahrbar	positive
fahrbar	positive
tragbar	positive
auffallen	positive
einfluss	positive
lauter	positive
schreiend	positive
redlich	positive
unbescholten	positive
tiefsinnig	positive
hintersinnig	positive
dienlich	positive
tiefgründig	positive
gemässigt	negative
untadelig	positive
marktführend	positive
rechtschaffen	positive
untadlig	positive
marktbeherrschend	positive
munter	positive
umtriebig	positive
quirlig	positive
gezähmt	positive
rege	positive
unaufdringlich	negative
adel	positive
bürgerlich	negative
gewieft	positive
gewitzt	positive
leben	positive
akut	positive
vordringlich	positive
inkonsequent	negative
ehrlich	positive
rot glühend	positive
rotglühend	positive
unverdaulich	negative
fördernd	positive
brauchbar	positive
sehne	positive
