schlecht	negative
gemein	negative
negativ	negative
unglücklich	negative
ekelhaft	negative
hässlich	negative
minderwertig	negative
lästig	negative
arm	negative
falsch	negative
übel	negative
schön	positive
richtig	positive
gut	positive
korrekt	positive
nett	positive
glücklich	positive
positiv	positive
ausgezeichnet	positive
überlegen	positive
hochwertig	positive
schwindlig	negative
glück	positive
regelrecht	positive
richtiggehend	positive
böse	negative
ehrlich	positive
ruchbar	negative
unaufrichtig	negative
unrichtig	negative
auszeichnen	positive
traurig	negative
ekel	negative
gewissenhaft	positive
ekelerregend	negative
ekel erregend	negative
preussisch	positive
reich	positive
unglück	negative
dusel	positive
glücksfall	positive
hochklassig	positive
geringwertig	negative
pech	negative
glücksgefühl	positive
hervortun	positive
exponieren	positive
niederträchtig	negative
boshaft	negative
bös	negative
unehrlich	negative
aufrichtig	positive
vertrauenswürdig	positive
gehaltvoll	positive
reichhaltig	positive
froh	positive
verarmt	negative
kummer	negative
sorge	negative
leidwesen	negative
leid	negative
freudlos	negative
preussen	positive
bepreisen	positive
prädikatisieren	positive
taggen	positive
abscheu	negative
ekelgefühl	negative
unterlegen	negative
exzellent	positive
nervig	negative
vermögend	positive
unglücksfall	negative
froh gestimmt	positive
frohgestimmt	positive
pechfall	negative
vertrauen	positive
aufrecht	positive
freude	negative
niedertracht	negative
misstrauen	negative
