angenehm	positive
arm	negative
armselig	negative
ausgezeichnet	positive
bedauernswert	negative
besser	positive
böse	negative
dürftig	negative
ekelerregend	negative
ekelhaft	negative
ekelig	negative
falsch	negative
fies	negative
freundlich	positive
gemein	negative
geringwertig	negative
glücklich	positive
gut	positive
hässlich	negative
höherwertig	positive
hübsch	positive
irrig	negative
korrekt	positive
lieb	positive
mangelhaft	negative
minderwertig	negative
misslich	negative
nachrangig	negative
negativ	negative
nett	positive
positiv	positive
richtig	positive
scheusslich	negative
schlecht	negative
schlimm	negative
schwach	negative
schädlich	negative
schön	positive
unangenehm	negative
unerfreulich	negative
unglücklich	negative
ungünstig	negative
unrecht	negative
unterlegen	negative
verdorben	negative
widerlich	negative
widerwärtig	negative
übel	negative
überlegen	positive
überragend	positive
platz	negative
tourist	negative
mehrfach	negative
china	negative
fink	negative
kid	negative
stern	negative
dna	negative
musik	negative
winden	negative
sterben	negative
überprüfung	negative
fremd	negative
vollständig	negative
zucker	negative
kochen	negative
rezept	negative
klingen	negative
telekom	negative
terrorist	negative
halb	negative
gleichung	negative
einordnung	negative
aktuell	negative
staatsbürger	negative
unterrichten	negative
endlich	negative
service	negative
versagen	negative
ferien	negative
elektriker	negative
kollege	negative
weinen	negative
wein	negative
jagen	negative
arbeiter	negative
singen	negative
silber	negative
dick	negative
kohle	negative
schulunterricht	negative
zahlen	negative
waschmaschine	negative
buchhalter	negative
union	negative
giessen	negative
vorschrift	negative
kohl	negative
flüssigkeit	negative
jung	negative
viertel	negative
spritzen	negative
anhänger	negative
kamin	negative
abitur	negative
teich	negative
lassen	negative
airbag	negative
hai	negative
fallen	negative
ausüben	negative
persönlichkeit	negative
nutzpflanze	negative
schiene	negative
gebäude	negative
erkennen	negative
deutschland	negative
stange	negative
zeuge	negative
sportart	negative
wirklichkeit	negative
stechen	negative
binden	negative
zahnarzt	negative
züchter	negative
chemisch	negative
pferd	negative
gewitter	negative
