angenehm	positive
ausgezeichnet	positive
besser	positive
freundlich	positive
glücklich	positive
gut	positive
höherwertig	positive
hübsch	positive
korrekt	positive
lieb	positive
nett	positive
positiv	positive
richtig	positive
schön	positive
überlegen	positive
überragend	positive
arm	negative
armselig	negative
bedauernswert	negative
böse	negative
china	negative
dna	negative
dürftig	negative
ekelerregend	negative
ekelhaft	negative
ekelig	negative
falsch	negative
fies	negative
fink	negative
fremd	negative
gemein	negative
geringwertig	negative
hässlich	negative
irrig	negative
kid	negative
mangelhaft	negative
mehrfach	negative
minderwertig	negative
misslich	negative
musik	negative
nachrangig	negative
negativ	negative
platz	negative
scheusslich	negative
schlecht	negative
schlimm	negative
schwach	negative
schädlich	negative
sterben	negative
stern	negative
tourist	negative
unangenehm	negative
unerfreulich	negative
unglücklich	negative
ungünstig	negative
unrecht	negative
unterlegen	negative
verdorben	negative
vollständig	negative
widerlich	negative
widerwärtig	negative
winden	negative
übel	negative
überprüfung	negative
