^	^
=	=
|	|
_	_
-((	-((
-	-
,	,
;	;
:-((	:-((
:-(	:-(
:-[	:-[
:-*	:-*
:-	:-
://	://
:/	:/
:(((((	:(((((
:((((	:((((
:((	:((
:(	:(
:	:
!	!
?	?
/	/
...	...
.	.
'	'
‘	‘
"	"
“	“
”	”
»	»
(	(
)	)
[	[
]	]
}	}
@	@
€	€
*_*	*_*
*-*	*-*
*	*
\	\
&	&
#	#
%	%
+	+
❤☀	❤☀
😁	😁
…	…
000	@card@
007	@card@
00	@card@
03	@card@
09	@card@
100	100
10	10
1,020	@card@
+1	+1
1	1
11	11
1,150	@card@
115	@card@
1205	@card@
12	12
13	13
14	14
150	150
153,650	@card@
16	16
17	17
17:37	@card@
180k	180k
18	18
19:00	@card@
1949	@card@
19,90	@card@
@1darsa	@1darsa
@1d_sheerio	@1d_sheerio
@1_theo_	@1_theo_
20.000	@card@
2001	@card@
2009	@card@
2013	@card@
2017	@card@
20357	@card@
@20min	@20min
21	21
2	2
22:00	@card@
22.09	@card@
22	22
2/3	2/3
240	240
28.4	@card@
2h	2h
30.000	@card@
3:00	@card@
3	3
33	33
@3chelon	@3chelon
41	41
-4230	@card@
4	4
450	450
-472820-	@card@
500x	500x
502	@card@
5	5
55-	55-
566	@card@
591	@card@
60	60
65	65
66	@card@
6,8	@card@
76-	@card@
76	@card@
7	7
@7vampir	@7vampir
8-	8-
8d	8d
90	90
9.5	@card@
9	9
99	99
a45	a45
a	a
aaarrr	aaarrr
a.	am
ab	ab
abend	abend
abendblatt	abendblatt
aber	aber
abgang	abgang
abgeordnete	abgeordnete
abgeordneten	abgeordnete
abgerissene	abgerissen
abgeschafft	abschaffen
abgeschlossen	abschließen
abgestraft	abstrafen
abkanzeln	abkanzeln
ablagesystem	ablagesystem
abnehmpläne	abnehmpläne
abschied	abschied
absicht	absicht
abstillen	abstillen
abstimme	abstimmen
abstract	abstract
#abusaeed	#abusaeed
abwählen	abwählen
abzulehnen	ablehnen
action	action
@adannenbring	@adannenbring
adasch	adasch
adoptionsrecht	adoptionsrecht
#afd	#afd
afd	afd
#afghanistan	#afghanistan
#agenda2010	#agenda2010
#agenda	#agenda
agenda	agenda
@agneskrumwiede	@agneskrumwiede
agrarfinanzierung	agrarfinanzierung
ägypten	ägypten
ägypter	ägypter
äh	äh
ähm	ähm
ähnliches	ähnlich
ahnung	ahnung
aif	aif
aigner	aigner
air	air
aires	aires
akkord	akkord
aktion	aktion
aktuell	aktuell
aktueller	aktuell
alben	album
albträume	alptraum
album	album
@alexcasino	@alexcasino
algermissen	algermissen
@alibas76	@alibas76
alisch	alisch
alkoholiker	alkoholiker
alle	alle
allein	allein
alleine	alleine
allem	alle
allen	alle
aller	alle
alles	alle
allianz	allianz
allnatura	allnatura
#alqaida	#alqaida
als	als
also	also
alster	alster
altbürgermeister	altbürgermeister
alte	alt
alten	alte
alter	alt
alter	alter
alternative	alternative
alterspräsident	alterspräsident
altmaier	altmaier
altparteien	altpartei
@alx42	@alx42
am	am
am	an
amerikanische	amerikanisch
amigos	amigos
amine	amin
amnog	amnog
&amp	&amp
amsel	amsel
amt	amt
anak	anak
analysiert	analysieren
an	an
anbieter	anbieter
anblaffst	anblaffst
and	and
andere	andere
anderem	andere
anderen	andere
anderer	andere
anders	anders
anderswoher	anderswoher
#android	#android
android	android
#androidgames	#androidgames
anfallen	anfallen
angeblich	angeblich
angekommen	ankommen
angela	angela
angemeldet	anmelden
angepasstes	angepasst
angesprochen	ansprechen
angriffe	angriff
angst	angst
animes	animes
ankara	ankara
@anked	@anked
anlass	anlass
anmeldung	anmeldung
anmeldungen	anmeldung
@annalena101	@annalena101
#annettefocks	#annettefocks
@annigga_	@annigga_
@anonnewsde	@anonnewsde
anruft	anrufen
ansatz	ansatz
anschauen	anschauen
anschläge	anschlag
anstand	anstehen
anständiger	anständig
anstoss	anstoss
anstrengung	anstrengung
#antiatom	#antiatom
antrag	antrag
antwort	antwort
antworten	antwort|antworten
antworten	antworten
anzeiger	anzeiger
anzufangen	anfangen
anzugreifen	angreifen
anzuönden	anzuönden
@apothekeadhoc	@apothekeadhoc
apotheke	apotheke
app	app
appell	appell
@ar1904	@ar1904
arbeit	arbeit
arbeiten	arbeiten
arbeitskreis	arbeitskreis
#arbeitslosigkeit	#arbeitslosigkeit
#ard	#ard
ard	ard
@ardde	@ardde
@ard_warschau	@ard_warschau
are	are
argentina	argentina
#argentinien	#argentinien
argentinien	argentinien
#argentinier	#argentinier
argentinier	argentinier
argentinische	argentinisch
ärgern	ärgern
argumentiert	argumentieren
arme	arm
arme	arm|arme
armen	arm|arme
armes	arm
@arminlaschet	@arminlaschet
@arminwolf	@arminwolf
#armut	#armut
#arnie	#arnie
arrrr	arrrr
arsch	arsch
arschgeigen	arschgeige
@arschhaarzopf	@arschhaarzopf
art	art
@artgerechtpirat	@artgerechtpirat
artikel	artikel
artist	artist
asap	asap
@aschtarot	@aschtarot
aspekte	aspekt
#aspekte	#aspekte
asphalt	asphalt
assad	assad
@astefanowitsch	@astefanowitsch
asyl	asyl
atomaren	atomar
atombombe	atombombe
atv	atv
auch	auch
audio	audio
auditions	auditions
aufarbeitung	aufarbeitung
auf	auf
aufbruch	aufbruch
aufforderung	aufforderung
aufgeben	aufgeben
aufgeflogen	auffliegen
aufgenommen	aufnehmen
aufgibt	aufgeben
aufklärung	aufklärung
aufm	aufm
aufsatz	aufsatz
aufwachen	aufwachen
aufzunehmen	aufnehmen
aufzwingen	aufzwingen
augen	auge
augenblick	augenblick
auml	auml
aus	aus
ausbildung	ausbildung
ausbremsen	ausbremsen
auseinandersetzung	auseinandersetzung
ausgetreten	austreten
ausgezeichnete	ausgezeichnet
ausländer	ausländer
ausreichend	ausreichend
ausrichtung	ausrichtung
ausschaffung	ausschaffung
ausschlafen	ausschlafen
ausschliessen	ausschließen
ausschließlicher	ausschließlich
außenminister	außenminister
außer	außer
außerdem	außerdem
außerhalb	außerhalb
äußert	äußern
aussichtsreich	aussichtsreich
ausspricht	aussprechen
austreten	austreten
@auswaertigesamt	@auswaertigesamt
auswerten	auswerten
auszubrechen	ausbrechen
auto	auto
autobahn	autobahn
autobahnen	autobahn
autobranche	autobranche
autokauf	autokauf
@autorenongrata	@autorenongrata
autumn	autumn
axel	axel
@_ayeeesmoovee	@_ayeeesmoovee
@aynen_kendisi	@aynen_kendisi
#b75	#b75
babo	babo
back	backen
backyard	backyard
bad	bad
bade	bad
badeinrichtung	badeinrichtung
baden	baden
bahr	bahr
bajonetta	bajonetta
bald	bald
balkon	balkon
bamboo	bamboo
band	band
@bangpowwww	@bangpowwww
bankablehnung	bankablehnung
#bankenkrise	#bankenkrise
bapak	bapak
barbados	barbados
barcelona	barcelona
barth	barth
baru	baru
basisdemokratie	basisdemokratie
#basketball	#basketball
#bauarbeiten	#bauarbeiten
bauen	bauen
baum	baum
bawü	bawü
bay	bay
bayern2	bayern2
bayern	bayer
#bayern	#bayern
bayern	bayern
#bayernwahl	#bayernwahl
b.	b.
b	b
bbq	bbq
beantwortet	beantworten
beautiful	beautiful
be	be
beckstein	beckstein
bed	bed
bedeuten	bedeuten
bedeutsamster	bedeutsamster
@bediko	@bediko
bedingungen	bedingung
bedrängnis	bedrängnis
befindet	befinden
befreien	befreien
begeistert	begeistert
beginnen	beginnen
beherrschen	beherrschen
behindern	behindern
bei	bei
beiden	beide
beides	beide
beigetreten	beitreten
beileid	beileid
beim	bei
beinahe	beinahe
@beingmenow	@beingmenow
beispiel	beispiel
beitrag	beitrag
beiträge	beitrag
bejubeln	bejubeln
bekämpfst	bekämpfst
bekannt	bekannt
bekanntes	bekannt
bekennen	bekennen
beklagt	beklagen
bekommen	bekommen
bekommt	bekommen
belegen	belegen
beleuchtet	beleuchten
bemerkenswert	bemerkenswert
bemühen	bemühen
bemüht	bemühen
benötigt	benötigen
beobachten	beobachten
beobachtung	beobachtung
berater	berater
#ber	#ber
ber	ber
bereich	bereich
#bergoglio	#bergoglio
bergoglio	bergoglio
berichterstattung	berichterstattung
berichtet	berichten
#berlin	#berlin
berlin	berlin
bernd	bernd
@bernhardkaster	@bernhardkaster
beruf	beruf
berufssparten	berufssparte
beschäftigt	beschäftigt
bescheiden	bescheiden
besichtigt	besichtigen
besonderen	besonder
besonderes	besonder
bessere	gut
besseres	gut
besser	gut
beste	gut
bestellt	bestellen
bester	gut
bestes	gut
best	gut
bestimmt	bestimmt
bestuecken	bestuecken
besuch	besuch
besucher	besucher
betet	beten
betonen	betonen
betonklotz	betonklotz
betrug	betrug
bett	bett
beutezug	beutezug
bevölkerung	bevölkerung
bevor	bevor
bevormundung	bevormundung
bewegung	bewegung
beweisfotos	beweisfoto
bewertet	bewerten
bewertung	bewertung
bewiesen	beweisen
bewusst	bewusst
bezeichnet	bezeichnen
bezeichnete	bezeichnen
bezeichnung	bezeichnung
beziehungen	beziehung
bezug	bezug
bezweiflele	bezweiflele
bibel	bibel
bicolor	bicolor
bieber	bieber
#bier	#bier
bier	bier
biete	bieten
bilanzverlängerung	bilanzverlängerung
bild	bild
bilder	bild
@binberlinerin	@binberlinerin
bingo	bingo
bin	sein
bio	bio
@birgit_riegler	@birgit_riegler
birne	birne
birthday	birthday
bis	bis
bischof	bischof
bischofsheim	bischofsheim
bisher	bisher
bisschen	bisschen
bist	sein
bitte	bitte
bitte	bitten
bittet	bitten
@bjoernmahe	@bjoernmahe
@bjoernsaenger	@bjoernsaenger
@bjsemrau	@bjsemrau
blah	blah
blaselaune	blaselaune
blau	blau
@blaueswunder_13	@blaueswunder_13
bleibe	bleiben
bleiben	bleiben
bleibst	bleiben
bleibt	bleiben
@blickamabend	@blickamabend
blick	blick
@blickch	@blickch
bling	bling
blockparteien	blockpartei
blog	blog
blogeintrag	blogeintrag
bloß	bloß
blumen	blume
blut	blut
#bnd	#bnd
boah	boah
bo	bo
boch	boch
bochumer	bochumer
bock	bocken
@bodoramelow	@bodoramelow
bombenanschläge	bombenanschlag
bond	bond
boot	boot
#borat	#borat
böses	böse
botschafter	botschafter
bottom	bottom
boys	boy
#bpt131	#bpt131
#bradleymanning	#bradleymanning
braff	braff
@braktash	@braktash
brasilien	brasilien
brauchen	brauchen
braucht	brauchen
bräuchten	brauchen
bridge	bridge
#bromance	#bromance
#browsergames	#browsergames
bruchsal	bruchsal
brüderle	brüderle
#brüssel	#brüssel
#btw13	#btw13
#btw	#btw
btw	btw
buch	buch
buchstäblich	buchstäblich
buenos	buenos
@buer_aner	@buer_aner
bühne	bühne
@buk	@buk
bullshit	bullshit
bummeln	bummeln
bund	bund
#bundeskampf	#bundeskampf
bundeskanzler	bundeskanzler
bundeskanzlerin	bundeskanzlerin
bundesland	bundesland
bundesnetzagentur	bundesnetzagentur
bundespräsident	bundespräsident
bundespräsidentenbild	bundespräsidentenbild
#bundesregierung	#bundesregierung
bundesregierung	bundesregierung
bundesrepublik	bundesrepublik
#bundestag	#bundestag
bundestag	bundestag
bundestagskandidatin	bundestagskandidatin
bundestagsparteien	bundestagspartei
bundestagswahl	bundestagswahl
bürger	bürger
bürgermeisterkandidaten	bürgermeisterkandidat
bürgerrechtsverletzungen	bürgerrechtsverletzung
büro	büro
bürsten	bürsten
@bushido78	@bushido78
#bushido	#bushido
@butterfly_ger	@butterfly_ger
#bvb	#bvb
bzw	bzw
cam	cam
carcubes	carcubes
@carfreitag	@carfreitag
carla	carla
castor	castor
@cateringhamburg	@cateringhamburg
cause	cause
c	c
cc	cc
@ccs_stoppen	@ccs_stoppen
cd	cd
@cdgsthermi	@cdgsthermi
#cdu	#cdu
cdu	cdu
@cdu_news	@cdu_news
@cduwatch	@cduwatch
@celinua	@celinua
chabo	chabo
championsleague	championsleague
chance	chance
checa	checa
chef	chef
chemiewaffen	chemiewaffe
@cherrykitty1411	@cherrykitty1411
chicane	chicane
#chicklit	#chicklit
@chmav	@chmav
christian	christian
@christian_ude	@christian_ude
citizens	citizens
@claudiajgasmi	@claudiajgasmi
@cletus_del_roy	@cletus_del_roy
@c_netz	@c_netz
cocker	cocker
co	co
@codebrecht	@codebrecht
collaborative	collaborative
collar	collar
comedie	comedie
commander	commander
computers	computer
computerspiele	computerspiel
#conclave	#conclave
@contratom	@contratom
copy	copy
@corneliabreusz	@corneliabreusz
cost	cost
@courtisane_de	@courtisane_de
@crackpille	@crackpille
crm	crm
@croeckerath	@croeckerath
cry	cry
@csu	@csu
#csu	#csu
csu	csu
@ctfcrea	@ctfcrea
cyberabwehrzentrum	cyberabwehrzentrum
cyber	cyber
dabei	dabei
dachten	denken
@daconpp	@daconpp
da	da
dafür	dafür
daher	daher
dahin	dahin
damals	damals
damit	damit
@daniel	@daniel
daniel	daniel
@daniele_rizzo	@daniele_rizzo
danke	dank
danke	danke
danke	danken
dankee	dankee
dankö	dankö
dann	dann
daran	daran
darauf	darauf
darf	dürfen
#darmstadt	#darmstadt
@darocktown	@darocktown
darum	darum
das	die
@daslicke	@daslicke
dass	dass
dat	dat
daten	datum
datenhafen	datenhafen
#datenschutz	#datenschutz
dauert	dauern
@dave_kay	@dave_kay
davon	davon
day	day
dazu	dazu
@db_bahn	@db_bahn
#db	#db
:d	:d
d.	d.
d	d
:d:d	:d:d
dead	dead
death	death
debattiert	debattieren
#de	#de
de	de
@dee_onpoint	@dee_onpoint
dein	dein
deine	dein
dekadenz	dekadenz
deklari	deklari
dekorativer	dekorativ
del	del
dem	die
dementsprechend	dementsprechend
@demifansde	@demifansde
democracy	democracy
demo	demo
#demokratie	#demokratie
demokratie	demokratie
demokratieverständnis	demokratieverständnis
den	die
denen	die
@denisquadt	@denisquadt
denk	denken
denke	denken
denn	denn
@dennisbeck_w	@dennisbeck_w
dennis	dennis
@deppenbot	@deppenbot
@deppentoeter	@deppentoeter
der	die
@der_dutschi	@der_dutschi
deren	die
@derpupe	@derpupe
des	die
desinteressierte	desinteressierte
dessen	die
details	detail
det	det
deutsch	deutsch
deutsche	deutsch
deutscher	deutsch
deutschland	deutschland
diabetes	diabetes
dich	du
dicke	dicke
dicker	dick
◄die	◄die
die	die
@die_gruenen	@die_gruenen
#diekmann	#diekmann
@dielinke	@dielinke
@diemone37	@diemone37
dienstagmittag	dienstagmittag
@die_piraten	@die_piraten
dies	dies
diese	dies
diesem	dies
diesen	dies
diesen	diese
dieser	dies
dieses	dies
diktatur	diktatur
@diminutivchen	@diminutivchen
dinge	ding
dingsis	dingsis
dinner	dinner
@dioneira	@dioneira
diplomate	diplomate
dir	du
direkt	direkt
diskutieren	diskutieren
#dithmarschen	#dithmarschen
dji	dji
@djuultjekusx	@djuultjekusx
@d_kerstin	@d_kerstin
@dl3ngn	@dl3ngn
@dlf	@dlf
dm	dm
dnt	dnt
doch	doch
do	do
dom	dom
@domian	@domian
#domian	#domian
don	don
doppelbelastung	doppelbelastung
doppel	doppel
#doppelmoral	#doppelmoral
@dorobaer	@dorobaer
dort	dort
dossier	dossier
@douniaslimani	@douniaslimani
downloaden	downloaden
dpa	dpa
@dpomondi	@dpomondi
@dpourmohsen	@dpourmohsen
draft	draft
dran	dran
dr.	dr.
drei	drei
dreier	dreier
#dreifachmoral	#dreifachmoral
#dreikampf	#dreikampf
dreist	dreist
dreister	dreist
dresden	dresden
drin	drin
dritt	dritt
drittel	drittel
drohgebärden	drohgebärden
drohnenopfer	drohnenopfer
drohung	drohung
#drosselkom	#drosselkom
drosseln	drossel|drosseln
@drthomasfeist	@drthomasfeist
drüber	drüber
druck	druck
dt.	deutsch
ducati	ducati
du	du
duell	duell
dumme	dumm
dunkelhäutigen	dunkelhäutig
durch	durch
durchgreifen	durchgreifen
durchsetzen	durchsetzen
dürfen	dürfen
durlach	durlach
@dw_deutsch	@dw_deutsch
dynamo	dynamo
@earth_pics	@earth_pics
@ebay	@ebay
#ebook	#ebook
echte	echt
echtzeit	echtzeit
ecke	ecke
edge	edge
edited	edited
e	e
effektiven	effektiv
egal	egal
ego	ego
#egovernment	#egovernment
ehe	ehe
eh	eh
ehren	ehre|ehren
ei	ei
eigene	eigen
eigenes	eigen
eigentlich	eigentlich
eil	eilen
einarbeitung	einarbeitung
einbruch	einbruch
ein/e	ein/e
eine	eine
ein	ein
ein	eine
einem	eine
einen	eine
einer	eine
eines	eine
einfach	einfach
einführen	einführen
eingebildeten	eingebildet
eingebildeter	eingebildeter
eingetreten	eintreten
einheitsbrei	einheitsbrei
einige	einige
einigung	einigung
einmal	einmal
einsatz	einsatz
einschalten	einschalten
eins	eins
einsendungen	einsendung
einstellig	einstellig
einstimmig	einstimmig
@ein_tim	@ein_tim
eintragen	eintragen
eintreten	eintreten
einzige	einzig
einzige	einzige
einzig	einzig
@eisbaer55	@eisbaer55
ekelfleisch	ekelfleisch
elektronisch	elektronisch
@eliza_muc	@eliza_muc
elsen	elsen
@elyas_mbarek	@elyas_mbarek
@emmanuelahpunkt	@emmanuelahpunkt
@emonotion	@emonotion
empfohlen	empfehlen
empört	empören
empowering	empowering
#enddarmbewohner	#enddarmbewohner
ende	ende
endet	enden
endfphase	endfphase
endlich	endlich
energiewendig	energiewendig
engagiert	engagiert
englisch	englisch
entäuschung	entäuschung
entscheidende	entscheidend
entscheidet	entscheiden
enttäuscht	enttäuscht
entweder	entweder
@epirat	@epirat
episch	episch
erbarmen	erbarmen
erbaut	erbauen
erbeutest	erbeutest
erdogan	erdogan
er	er
ergebni	ergebni
ergebnis	ergebnis
ergebnisse	ergebnis
erhalten	erhalten
erhoehte	erhoehte
erhöht	erhöhen
@ericmarr	@ericmarr
@erikmfh	@erikmfh
erinner	erinnern
erinnern	erinnern
erinnert	erinnern
erkältung	erkältung
erklärungsnot	erklärungsnot
ermittlerin	ermittlerin
ermittlungen	ermittlung
ernährung	ernährung
ernährungs	ernährungs
ernennen	ernennen
ernst	ernst
eröffnet	eröffnen
eröffnung	eröffnung
erreicht	erreichen
ersatzbank	ersatzbank
erschütterts	erschütterts
erschwinglich	erschwinglich
erstaunt	erstaunen
erste	erst
ersten	erst
erster	erst
erster	erste
erst	erst
erstes	erst
erstmal	erstmal
erststimme	erststimme
erwachsene	erwachsene
erwägt	erwägen
erwarte	erwarten
erwarten	erwarten
erwartet	erwarten
erzbischof	erzbischof
erzürnt	erzürnen
#esc2013	#esc2013
#esc	#esc
es	es
espana	espana
essen	essen
#essensretter	#essensretter
etwa	etwa
etwas	etwas
euch	ihr
euer	euer
eu	eu
eure	euer
euro	euro
europa	europa
europaweite	europaweit
europ	europ
#euro-schuldenkrise	#euro-schuldenkrise
evangelischer	evangelisch
@evelinelemke	@evelinelemke
ever	ever
everybody	everybody
evtl.	evtl.
#ewm	#ewm
ewm	ewm
ex	ex
exklusiv	exklusiv
exklusivste	exklusiv
experten	experte
explizit	explizit
extra	extra
extrem	extrem
#facebook	#facebook
facebook	facebook
fachlexikon	fachlexika
faden	faden
fäden	faden
fähnchen	fähnchen
fahrbahn	fahrbahn
fahren	fahren
fahrstreifen	fahrstreifen
fährt	fahren
fahrt	fahrt
faible	faible
#fail	#fail
fallen	fallen
fall	fall
fällt	fallen|fällen
falschen	falsch
falsch	falsch
familie	familie
fand	finden
fans	fan
fast	fast
faul	faul
faultiere	faultier
favs	favs
@faz_politik	@faz_politik
#fb	#fb
@fcbayern	@fcbayern
fc	fc
#fd	#fd
@fdp_de	@fdp_de
#fdp	#fdp
fdp	fdp
#fdp-politikern	#fdp-politikern
fehlen	fehlen
fehler	fehler
fehlt	fehlen
feierabendbier	feierabendbier
feiern	feiern
feinde	feind
feldstr	feldstr
@feminsist	@feminsist
fern	fern
fernseher	fernseher
fertig	fertig
fertigung	fertigung
festanstellung	festanstellung
festgebissen	festbeißen
festschreiben	festschreiben
#fettnäpfchen	#fettnäpfchen
fettnapf	fettnapf
f.	f.
#ff	#ff
ffranziskus	ffranziskus
fg	fg
@fhatti	@fhatti
ficht	fechten
fiese	fies
fietz	fietz
fights	fights
film	film
filmmusik	filmmusik
@filzflausch	@filzflausch
finale	finale
#finanzkrise	#finanzkrise
finde	finden
finden	finden
finnischer	finnisch
fischer	fischer
fitnesstraining	fitnesstraining
@fjg_film	@fjg_film
@fjhmr	@fjhmr
@fl0gl	@fl0gl
flake	flake
flirtverbot	flirtverbot
@florianbrill	@florianbrill
@florianklenk	@florianklenk
flotter	flott
flug	flug
#flughafen	#flughafen
@fluxusx	@fluxusx
flyer	flyer
fnp	fnp
#focus	#focus
focus	focus
@focusonline	@focusonline
folgen	folgen
folgt	folgen
follower	follower
#followerpower	#followerpower
fordern	fordern
fördern	fördern
fordert	fordern
forenbeitrag	forenbeitrag
for	for
format	format
forsa	forsa
fortschritt	fortschritt
#forum	#forum
foto	foto
fotos	foto
#fracking	#fracking
frackingregelung	frackingregelung
frage	frage
frage	fragen
fragen	frage
fragen	fragen
frag	fragen
fraktionsbus	fraktionsbus
fraktionschef	fraktionschef
@frandom74	@frandom74
frankfurt	frankfurt
franklin	franklin
@franziskakernen	@franziskakernen
#franziskus	#franziskus
franziskus	franziskus
frauenbeauftragter	frauenbeauftragte
frauen	frau
#frauen	#frauen
#frauenquote	#frauenquote
frau	frau
fraunhofer	fraunhofer
frechen	frech
free2play	free2play
fre	fre
freie	frei
#freie	#freie
freien	frei
frei	frei
freiheit	freiheit
freitag1930	freitag1930
freitag	freitag
fremdenfeindliche	fremdenfeindlich
fremdkapital	fremdkapital
freu	freuen
freunde	freund
freunden	freund
freundlichen	freundlich
freut	freuen
friedens	frieden
friedhelm	friedhelm
friend	friend
@frl_bruenett	@frl_bruenett
frühe	früh
früher	früher
frühjahrsputz	frühjahrsputz
frühlingsgefühle	frühlingsgefühl
#fruits	#fruits
frustriert	frustrieren
fuer	fuer
führt	führen
für	für
für’s	für’s
#fussball-fans	#fussball-fans
fußball	fußball
@fuzzyleapfrog	@fuzzyleapfrog
#fw	#fw
@fwhessen	@fwhessen
@fwiefilip	@fwiefilip
fz	fz
#g20	#g20
gäbe	geben
@gabmoke	@gabmoke
#gabriel	#gabriel
#gähn	#gähn
@gallenbitter	@gallenbitter
game	game
#gameinsight	#gameinsight
gam	gam
gan	gan
gangstarapper	gangstarapper
ganze	ganz
ganzen	ganz
ganz	ganz
garde	garde
gar	gar
gastbeitrag	gastbeitrag
#gauck	#gauck
gauck	gauck
gau	gau
gebäude	gebäude
geben	geben
gebildet	bilden
gebrauchen	gebrauchen
gebraucht	brauchen|gebrauchen
gebühr	gebühren
geburtstagslied	geburtstagslied
gedacht	denken|gedenken
geeinigt	einigen
geerntet	ernten
@geeska_till	@geeska_till
gefahr	gefahr
gefallen	fallen|gefallen
gefällt	gefallen
gefiel	gefallen
gefordert	fordern
geführt	führen
gefunden	finden
gegangen	gehen
gegebenem	gegeben
gegend	gegend
gegen	gegen
gegenhalten	gegenhalten
gegenstand	gegenstand
@gegenstrom	@gegenstrom
gegenüber	gegenüber
gehabt	gehabt
gehabt	haben
gehälter	gehalt
gehalt	gehalt
geheimbesuch	geheimbesuch
geheimdienst	geheimdienst
geheimnis	geheimnis
gehen	gehen
geh	gehen
gehört	gehören
gehört	gehören|hören
gehring	gehring
gehst	gehen
geht	gehen
gehts	gehts
geil	geil
geilomat	geilomat
geisterbahn	geisterbahn
geister	geist
geistesgestörtheit	geistesgestörtheit
geist	geist
geistige	geistig
gekommen	kommen
gekuschelt	kuscheln
gelände	gelände
gelb	gelb
geld	geld
geldsorgen	geldsorge
gelegenheit	gelegenheit
gelesen	lesen
gelistet	listen
gelungener	gelungen
gemacht	machen
gemeindebau	gemeindebau
gemeldet	melden
gemobbt	gemobbt
genau	genau
generalsekretärin	generalsekretärin
generationen	generation
generell	generell
geniale	genial
genossen	genosse
genossinnen	genossin
genug	genug
genuss	genuss
geplante	geplant
geplanten	geplant
gepostet	gepostet
gepusht	pushen
gerade	gerade
@geraldgrosz	@geraldgrosz
gerechnet	rechnen
gerecht	gerecht
geredet	reden
gerhard	gerhard
gerne	gerne
gern	gern
gesagt	sagen
gesammelt	sammeln
gesamtkunstwerk	gesamtkunstwerk
geschäftsf	geschäftsf
geschäftsführerin	geschäftsführerin
geschäftsstelle	geschäftsstelle
geschaut	schauen
gescheitert	scheitern
geschichte	geschichte
geschlechtergerechtigkeit	geschlechtergerechtigkeit
geschlechtskrankheiten	geschlechtskrankheit
geschrieben	schreiben
geschützt	schützen
geschwurbel	geschwurbel
gesegnet	segnen
gesehen	sehen
gesellschaftsfragen	gesellschaftsfrage
gesetzlich	gesetzlich
gesperrt	sperren
gespielt	spielen
gestecke	gesteck
gestellt	stellen
gestern	gestern
gestresst	stressen
gestrigen	gestrig
gesucht	suchen
gesund	gesund
gesundheitsreform	gesundheitsreform
getroffen¿	getroffen¿
gettn	gettn
getweetet	getweetet
gewählt	wählen
gewartet	warten
gewechselt	wechseln
geweihten	geweiht
gewerkschaften	gewerkschaft
gewerkschafter	gewerkschafter
gewinnen	gewinnen
gewinn	gewinn
gewinnt	gewinnen
gewonne	gewonne
geworden	werden
gezählt	zählen
gezien	gezien
gezwungen	zwingen
g	g
gg	gg
gib	geben
gibs	gibs
gibt	geben
gibt´s	gibt´s
gibt’s	gibt’s
gibts	gibts
gierig	gierig
gießen	gießen
gift	gift
gigantische	gigantisch
gipfel	gipfel
girl	girl
girls	girls
#gladbeck	#gladbeck
glamourvolle	glamourvolle
#glasssteagall	#glasssteagall
glauben	glauben
glaub	glauben
glaubst	glauben
glaubt	glauben
gleich	gleich
gleichste	gleichste
gliedmaßen	gliedmaß
#globalchange	#globalchange
gluco	gluco
@gnetzer	@gnetzer
go	go
going	going
goldenen	golden
goldmünzen	goldmünze
google	google
gordon	gordon
gorleben	gorleben
got	got
gottes	gott
@_goulven_	@_goulven_
gps	gps
grade	grad
grad	grad
graf	graf
grafik	grafik
gratisrum	gratisrum
gratulieren	gratulieren
gratuliert	gratulieren
#graz	#graz
greenwich	greenwich
gregor	gregor
greifen	greifen
#grie	#grie
grillen	grille|grillen
grillo	grillo
grinst	grinsen
@gronkh	@gronkh
gronkh	gronkh
große	groß
großen	groß
großer	groß
größer	groß
#grossprojekte	#grossprojekte
größte	groß
#gruene	#gruene
@gruene_jugend	@gruene_jugend
gruenen	gruenen
@grumpymerkel	@grumpymerkel
@grumpypeer1	@grumpypeer1
gründe	grund
grund	grund
grundlage	grundlage
grundpfeiler	grundpfeiler
grundrechte	grundrecht
grundstimmungen	grundstimmung
grüne	grün
#grüne	#grüne
grüne	grüne
grünen	grün
grünen	grüne
#grünen	#grünen
grüne/r	grüne/r
grünes	grün
grün	grün
grünlile	grünlile
grüßen	gruß|grüßen
gsogt	gsogt
&gt	&gt
guido	guido
gummibärchen	gummibärchen
günstige	günstig
günther	günther
gurls	gurls
gute	gut
guten	gut
guter	gut
gutes	gut
gut	gut
gutmenschen	gutmensch
gutverdienende	gutverdienende
guuut	guuut
@guy_threepwood	@guy_threepwood
gyok	gyok
gysi	gysi
hää	hää
habe	haben
#habemus	#habemus
habemus	habemus
#habemuspapam	#habemuspapam
#habemuspapem	#habemuspapem
haben	haben
hab´	hab´
hab	hab
hab	haben
habt	haben
habts	habts
hachja	hachja
@hael_ge	@hael_ge
hafti	hafti
hagen	hagen
hahahaah	hahahaah
haha	haha
hahaha	hahaha
hahahaha	hahahaha
@hahnflo	@hahnflo
hahn	hahn
halbe	halb
halbes	halb
hallo	hallo
halten	halten
halt	halt
hält	halten
haltlos	haltlos
hamburger	hamburger
#hamburg	#hamburg
hamburg	hamburg
hanau	hanau
handeln	handeln
handelsblatt	handelsblatt
hand	hand
handtuch	handtuch
hängen	hängen
hangout	hangout
hangouts	hangouts
hängt	hängen
@hanni_30	@hanni_30
@hannover_eti	@hannover_eti
hannover	hannover
@hanscarlos	@hanscarlos
hans	hans
@hanssoellner_de	@hanssoellner_de
#hanssöllner	#hanssöllner
happy	happy
@happyschnitzel	@happyschnitzel
#haraldglööckler	#haraldglööckler
harlem	harlem
hartes	hart
#hartz4	#hartz4
hasenkaninchen	hasenkaninchen
haslauer	haslauer
hass	hass
#hassknecht	#hassknecht
haste	hasten
hast	haben
hat	haben
hatte	haben
hätte	haben
hatten	haben
hätten	haben
hättest	haben
#hauptbahnhof	#hauptbahnhof
hauptbahnhof	hauptbahnhof
hauptstadt	hauptstadt
hausaufgabenbetreuung	hausaufgabenbetreuung
hause	haus
@haz	@haz
#haz	#haz
hbf	hbf
hb	hb
hc	hc
@hdberretz	@hdberretz
hea	hea
heard	heard
hebt	heben
heey	heey
heftig	heftig
hegemonie	hegemonie
heidelberg	heidelberg
heidenspaß	heidenspaß
heiko	heiko
heilerziehungspfleger	heilerziehungspfleger
heilt	heilen
heimat	heimat
heini	heini
heino	heino
@heisserkaffe	@heisserkaffe
heißt	heißen
helf	helf
helle	hellen
hell	hell
#hengsbach	#hengsbach
@henkulus	@henkulus
herausforderungen	herausforderung
herausgefunden	herausfinden
here	here
hereinregnet	hereinregnet
her	her
herrenrassen	herrenrassen
herr	herr
@herrmann_marc	@herrmann_marc
@herr_natischer	@herr_natischer
@herrtutorial	@herrtutorial
herze	herzen
herzens	herz
herzmenschen	herzmenschen
#hessen	#hessen
hessen	hessen
hessens	hessen
hessische	hessisch
heteronormativität	heteronormativität
heute	heute
#heuteplus	#heuteplus
#heute-show	#heute-show
#heuteshow	#heuteshow
heut	heuen
heut	heute
hey	hey
h	h
@hhmittendrin	@hhmittendrin
hidu	hidu
hier	hier
hieß	heißen
hihi	hihi
hilfe	hilfe
hilflos	hilflos
hinneee	hinneee
hintergrund	hintergrund
hinter	hinter
#hinterlist	#hinterlist
hinzugefügt	hinzufügen
@hipsterschwein	@hipsterschwein
hit	hit
hobbys	hobby
hochrechnung	hochrechnung
hochtouren	hochtour
hoeneli	hoeneli
hoffentlich	hoffentlich
hoff	hoffen
hof	hof
holen	holen
hollande	hollande
hollywood	hollywood
holzer	holzer
homo	homo
homophober	homophober
homosexuellenehe	homosexuellenehe
hören	hören
#horst	#horst
horst	horst
hört	hören
hosianna	hosianna
housing	housing
ht	ht
htt	htt
http://1.1.1.5/bmi/cdn1.spiegel.de/images/image	http://1.1.1.5/bmi/cdn1.spiegel.de/images/image
http://	http://
http:/	http:/
http	http
https://t.co/ckvfrtrmb1	https://t.co/ckvfrtrmb1
https://t.co/rqdt9svwmp	https://t.co/rqdt9svwmp
https://t.co/sdfmckfjnm	https://t.co/sdfmckfjnm
http://t.c	http://t.c
http://t.co/00ytri73en	http://t.co/00ytri73en
http://t.co/0ehdhctvtt	http://t.co/0ehdhctvtt
http://t.co/0es7fomkaz	http://t.co/0es7fomkaz
http://t.co/0gj2ykfkmf	http://t.co/0gj2ykfkmf
http://t.co/1auvtcuyfm	http://t.co/1auvtcuyfm
http://t.co/1klclxg6nv	http://t.co/1klclxg6nv
http://t.co/1kmdrpxetw	http://t.co/1kmdrpxetw
http://t.co/1udurqror5	http://t.co/1udurqror5
http://t.co/2fxiqwmwkt	http://t.co/2fxiqwmwkt
http://t.co/39fwr3xye8	http://t.co/39fwr3xye8
http://t.co/3dqnwrdwhs	http://t.co/3dqnwrdwhs
http://t.co/3ggmrzwfnn	http://t.co/3ggmrzwfnn
http://t.co/3ro5ljehoa	http://t.co/3ro5ljehoa
http://t.co/3sanu512vb	http://t.co/3sanu512vb
http://t.co/4vhclfbq3s	http://t.co/4vhclfbq3s
http://t.co/53b3fex614	http://t.co/53b3fex614
http://t.co/5iryjwl5gf	http://t.co/5iryjwl5gf
http://t.co/5jl1igq36m	http://t.co/5jl1igq36m
http://t.co/5lr7yjwzpu	http://t.co/5lr7yjwzpu
http://t.co/5pk9n7ykpz	http://t.co/5pk9n7ykpz
http://t.co/5qibjfxwuj	http://t.co/5qibjfxwuj
http://t.co/5qprqs52oz	http://t.co/5qprqs52oz
http://t.co/5ryfozu1ct	http://t.co/5ryfozu1ct
http://t.co/6ckvuhtf5i	http://t.co/6ckvuhtf5i
http://t.co/6iuzswkvyy	http://t.co/6iuzswkvyy
http://t.co/7k3d4qeyda	http://t.co/7k3d4qeyda
http://t.co/7mj6l2xubt	http://t.co/7mj6l2xubt
http://t.co/7nmwi	http://t.co/7nmwi
http://t.co/7onpulgajn	http://t.co/7onpulgajn
http://t.co/7wnglcjugq	http://t.co/7wnglcjugq
http://t.co/8fiaykps	http://t.co/8fiaykps
http://t.co/8rpomnicyw	http://t.co/8rpomnicyw
http://t.co/8w1iw1flhv	http://t.co/8w1iw1flhv
http://t.co/9udbxogghc	http://t.co/9udbxogghc
http://t.co/a2jmabwdyl	http://t.co/a2jmabwdyl
http://t.co/a81spbwbuk	http://t.co/a81spbwbuk
http://t.co/ac9fe6k7l6	http://t.co/ac9fe6k7l6
http://t.co/ackzwograu	http://t.co/ackzwograu
http://t.co/adqsqkx30b	http://t.co/adqsqkx30b
http://t.co/aj5kinp7gq	http://t.co/aj5kinp7gq
http://t.co/ajbb3auctk	http://t.co/ajbb3auctk
http://t.co/ajg6wlv1yh	http://t.co/ajg6wlv1yh
http://t.co/aprmf7dy2g	http://t.co/aprmf7dy2g
http://t.co/bdbiubxppp	http://t.co/bdbiubxppp
http://t.co/beq7tyf5yn	http://t.co/beq7tyf5yn
http://t.co/bjtnrq8hjj	http://t.co/bjtnrq8hjj
http://t.co/blpcrqkkwy	http://t.co/blpcrqkkwy
http://t.co/bqwsqzqi3i	http://t.co/bqwsqzqi3i
http://t.co/bv	http://t.co/bv
http://t.co/byhlrhkziy	http://t.co/byhlrhkziy
http://t.co/bztoj1jlp4	http://t.co/bztoj1jlp4
http://t.co/c9uu762id9	http://t.co/c9uu762id9
http://t.co/cdbrh3biev	http://t.co/cdbrh3biev
http://t.co/cfpojfjevo	http://t.co/cfpojfjevo
http://t.co/cjhiii7rdv	http://t.co/cjhiii7rdv
http://t.co/ckwzy87ptw	http://t.co/ckwzy87ptw
http://t.co/clh1w9otgf	http://t.co/clh1w9otgf
http://t.co/ctar57tggb	http://t.co/ctar57tggb
http://t.co/cupl20i0nx	http://t.co/cupl20i0nx
http://t.co/cvdddw6sxv	http://t.co/cvdddw6sxv
http://t.co/cx9u09mkjw	http://t.co/cx9u09mkjw
http://t.co/cxvagecyu6	http://t.co/cxvagecyu6
http://t.co/ddgedzm0ik	http://t.co/ddgedzm0ik
http://t.co/deuhkcdmkm	http://t.co/deuhkcdmkm
http://t.co/d	http://t.co/d
http://t.co/djdlylldce	http://t.co/djdlylldce
http://t.co/dl2ldrykc2	http://t.co/dl2ldrykc2
http://t.co/ds0s7v5cwv	http://t.co/ds0s7v5cwv
http://t.co/dwt1srtzbp	http://t.co/dwt1srtzbp
http://t.co/dwvsxucgks	http://t.co/dwvsxucgks
http://t.co/eb88ck2uin	http://t.co/eb88ck2uin
http://t.co/edgcznbvlz	http://t.co/edgcznbvlz
http://t.co/elmtsm3ahf	http://t.co/elmtsm3ahf
http://t.co/ersouj433k	http://t.co/ersouj433k
http://t.co/ezznsboex6	http://t.co/ezznsboex6
http://t.co/f4vhqe5erc	http://t.co/f4vhqe5erc
http://t.co/feyptdfldq	http://t.co/feyptdfldq
http://t.co/fgu315ikbb	http://t.co/fgu315ikbb
http://t.co/fh7pkaaksw	http://t.co/fh7pkaaksw
http://t.co/fisnqclwp1	http://t.co/fisnqclwp1
http://t.co/fkr9aoppmv	http://t.co/fkr9aoppmv
http://t.co/fngmhzo1uj	http://t.co/fngmhzo1uj
http://t.co/fsaenikc0p	http://t.co/fsaenikc0p
http://t.co/g8jtdfph1f	http://t.co/g8jtdfph1f
http://t.co/gb1djdmb	http://t.co/gb1djdmb
http://t.co/gbjcnbqzom	http://t.co/gbjcnbqzom
http://t.co/getspiejov	http://t.co/getspiejov
http://t.co/gkf51caior	http://t.co/gkf51caior
http://t.co/gleeioodwz	http://t.co/gleeioodwz
http://t.co/glzix3eay	http://t.co/glzix3eay
http://t.co/gnwjsinctq	http://t.co/gnwjsinctq
http://t.co/gsjgywwtph	http://t.co/gsjgywwtph
http://t.co/gvdmqofw5k	http://t.co/gvdmqofw5k
http://t.co/gzoehjrzqm	http://t.co/gzoehjrzqm
http://t.co/h3lnwrndas	http://t.co/h3lnwrndas
http://t.co	http://t.co
http://t.co/i3rdrw60au	http://t.co/i3rdrw60au
http://t.co/i	http://t.co/i
http://t.co/iitucxb6ex	http://t.co/iitucxb6ex
http://t.co/ikfhxoukx1	http://t.co/ikfhxoukx1
http://t.co/iokqabfnkq	http://t.co/iokqabfnkq
http://t.co/iw3ycpydwn	http://t.co/iw3ycpydwn
http://t.co/j1vukzxko3	http://t.co/j1vukzxko3
http://t.co/j58mkfyo2j	http://t.co/j58mkfyo2j
http://t.co/jccyujwypj	http://t.co/jccyujwypj
http://t.co/jcmzxkwxng	http://t.co/jcmzxkwxng
http://t.co/jemnotpus5	http://t.co/jemnotpus5
http://t.co/jji5tuyu0f	http://t.co/jji5tuyu0f
http://t.co/jlhwyxubaq	http://t.co/jlhwyxubaq
http://t.co/jlposcb2ev	http://t.co/jlposcb2ev
http://t.co/jsnporwlkh	http://t.co/jsnporwlkh
http://t.co/jwbbldr8m5	http://t.co/jwbbldr8m5
http://t.co/k8rdr5k1wf	http://t.co/k8rdr5k1wf
http://t.co/kd3ngtrqdm	http://t.co/kd3ngtrqdm
http://t.co/kgg3ygnnfn	http://t.co/kgg3ygnnfn
http://t.co/kslovzvm18	http://t.co/kslovzvm18
http://t.co/kwh8twffwu	http://t.co/kwh8twffwu
http://t.co/l2r	http://t.co/l2r
http://t.co/l64xpqmuzk	http://t.co/l64xpqmuzk
http://t.co/le1xowxgwd	http://t.co/le1xowxgwd
http://t.co/lexx5	http://t.co/lexx5
http://t.co/lfpsfuj2gn	http://t.co/lfpsfuj2gn
http://t.co/lgx7xeussy	http://t.co/lgx7xeussy
http://t.co/lqlvbervsz	http://t.co/lqlvbervsz
http://t.co/lurbqm6hql	http://t.co/lurbqm6hql
http://t.co/m69zak41q5	http://t.co/m69zak41q5
http://t.co/m8jkfkrbpq	http://t.co/m8jkfkrbpq
http://t.co/mawxjg5tyr	http://t.co/mawxjg5tyr
http://t.co/mezdeivnxn	http://t.co/mezdeivnxn
http://t.co/mgum	http://t.co/mgum
http://t.co/mi3lmjezsh	http://t.co/mi3lmjezsh
http://t.co/mkletb3kdt	http://t.co/mkletb3kdt
http://t.co/mqe90vvxpo	http://t.co/mqe90vvxpo
http://t.co/mrydivgcgg	http://t.co/mrydivgcgg
http://t.co/ms003qslqn	http://t.co/ms003qslqn
http://t.co/muamhkygtp	http://t.co/muamhkygtp
http://t.co/n18r8rea	http://t.co/n18r8rea
http://t.co/n7be375paf	http://t.co/n7be375paf
http://t.co/nb1cwdhfa5	http://t.co/nb1cwdhfa5
http://t.co/ncgsfnk5am	http://t.co/ncgsfnk5am
http://t.co/njkbvbkpc2	http://t.co/njkbvbkpc2
http://t.co/nsgd1hsd7q	http://t.co/nsgd1hsd7q
http://t.co/nzjusixptm	http://t.co/nzjusixptm
http://t.co/odtgq2rlin	http://t.co/odtgq2rlin
http://t.co/onfswjhbmj	http://t.co/onfswjhbmj
http://t.co/ophy3ilcbv	http://t.co/ophy3ilcbv
http://t.co/ov22ayfm16	http://t.co/ov22ayfm16
http://t.co/ov8w1ufbgi	http://t.co/ov8w1ufbgi
http://t.co/oyrp1lliv2	http://t.co/oyrp1lliv2
http://t.co/p6f6qt560i	http://t.co/p6f6qt560i
http://t.co/p9bx9ingln	http://t.co/p9bx9ingln
http://t.co/pi49r4zjr7	http://t.co/pi49r4zjr7
http://t.co/pjvwmwcw10	http://t.co/pjvwmwcw10
http://t.co/pmym1ztwqk	http://t.co/pmym1ztwqk
http://t.co/ptsaoazq1l	http://t.co/ptsaoazq1l
http://t.co/pwncyyhphx	http://t.co/pwncyyhphx
http://t.co/pylg7pfn0r	http://t.co/pylg7pfn0r
http://t.co/q1qirrr5vp	http://t.co/q1qirrr5vp
http://t.co/q4luvngtuf	http://t.co/q4luvngtuf
http://t.co/q7t8pj8zh8	http://t.co/q7t8pj8zh8
http://t.co/q8ek8wsnm7	http://t.co/q8ek8wsnm7
http://t.co/qcgguq5sev	http://t.co/qcgguq5sev
http://t.co/qeghu7wdvc	http://t.co/qeghu7wdvc
http://t.co/qkqxgre20s	http://t.co/qkqxgre20s
http://t.co/qtnp4v	http://t.co/qtnp4v
http://t.co/qxk7bkxarb	http://t.co/qxk7bkxarb
http://t.co/r5yahyipn2	http://t.co/r5yahyipn2
http://t.co/rebqqyn4z3	http://t.co/rebqqyn4z3
http://t.co/rih2vamzpg	http://t.co/rih2vamzpg
http://t.co/rnbetzhj50	http://t.co/rnbetzhj50
http://t.co/roxkrot35e	http://t.co/roxkrot35e
http://t.co/rpikkef7rr	http://t.co/rpikkef7rr
http://t.co/rzh5nvzkzp	http://t.co/rzh5nvzkzp
http://t.co/rzyiw5jacr	http://t.co/rzyiw5jacr
http://t.co/sagufqhjnu	http://t.co/sagufqhjnu
http://t.co/sdydfqn8rg	http://t.co/sdydfqn8rg
http://t.co/sgdjscghgu	http://t.co/sgdjscghgu
http://t.co/sgm30iuuf8	http://t.co/sgm30iuuf8
http://t.co/sgo4f0zatz	http://t.co/sgo4f0zatz
http://t.co/s	http://t.co/s
http://t.co/skatnxywty	http://t.co/skatnxywty
http://t.co/skqkfydnu6	http://t.co/skqkfydnu6
http://t.co/slfbnii8j3	http://t.co/slfbnii8j3
http://t.co/soy11fb7w3	http://t.co/soy11fb7w3
http://t.co/sszphouiha	http://t.co/sszphouiha
http://t.co/st2sszwipa	http://t.co/st2sszwipa
http://t.co/strlrqp92b	http://t.co/strlrqp92b
http://t.co/sujhlo8tdc	http://t.co/sujhlo8tdc
http://t.co/sutdjwnlpg	http://t.co/sutdjwnlpg
http://t.co/t55zrtjclp	http://t.co/t55zrtjclp
http://t.co/tcfa9tyrow	http://t.co/tcfa9tyrow
http://t.co/tl1gbx5d0f	http://t.co/tl1gbx5d0f
http://t.co/trzudyenyb	http://t.co/trzudyenyb
http://t.co/tsymt7ox0o	http://t.co/tsymt7ox0o
http://t.co/twcheskqzs	http://t.co/twcheskqzs
http://t.co/uahetarfnb	http://t.co/uahetarfnb
http://t.co/uckonn6svq	http://t.co/uckonn6svq
http://t.co/uenvcmwt2h	http://t.co/uenvcmwt2h
http://t.co/ufz0y2njnk	http://t.co/ufz0y2njnk
http://t.co/ui5n	http://t.co/ui5n
http://t.co/uttndy1x8m	http://t.co/uttndy1x8m
http://t.co/uuzox2nbdj	http://t.co/uuzox2nbdj
http://t.co/uyyp2nvixt	http://t.co/uyyp2nvixt
http://t.co/v57gomqljk	http://t.co/v57gomqljk
http://t.co/vecojcvtqp	http://t.co/vecojcvtqp
http://t.co/v	http://t.co/v
http://t.co/vjw6jmazb9	http://t.co/vjw6jmazb9
http://t.co/vnqyyq46ft	http://t.co/vnqyyq46ft
http://t.co/vueeqx3itu	http://t.co/vueeqx3itu
http://t.co/vyhc5iddnr	http://t.co/vyhc5iddnr
http://t.co/w9saulpris	http://t.co/w9saulpris
http://t.co/wglruwm6gl	http://t.co/wglruwm6gl
http://t.co/wprjzxe5jb	http://t.co/wprjzxe5jb
http://t.co/wsf54lfix1	http://t.co/wsf54lfix1
http://t.co/x47ueh1c1f	http://t.co/x47ueh1c1f
http://t.co/xdhb4kmccf	http://t.co/xdhb4kmccf
http://t.co/xg2aqg8u6a	http://t.co/xg2aqg8u6a
http://t.co/xh4kbwkw6z	http://t.co/xh4kbwkw6z
http://t.co/xkpzixflyn	http://t.co/xkpzixflyn
http://t.co/xmi5d7dnzq	http://t.co/xmi5d7dnzq
http://t.co/y49qa6blab	http://t.co/y49qa6blab
http://t.co/y6bcgvoivj	http://t.co/y6bcgvoivj
http://t.co/ycm9c4qb87	http://t.co/ycm9c4qb87
http://t.co/ydcaoyy0xf	http://t.co/ydcaoyy0xf
http://t.co/yfwyfnzomx	http://t.co/yfwyfnzomx
http://t.co/ykl61k2i1r	http://t.co/ykl61k2i1r
http://t.co/ymjd0j	http://t.co/ymjd0j
http://t.co/yn42yctzzf	http://t.co/yn42yctzzf
http://t.co/yptx1r1wfb	http://t.co/yptx1r1wfb
http://t.co/yrt3vlwend	http://t.co/yrt3vlwend
http://t.co/yuifv7h61b	http://t.co/yuifv7h61b
http://t.co/yvt39ymhwk	http://t.co/yvt39ymhwk
http://t.co/z1mmfrlnrb	http://t.co/z1mmfrlnrb
http://t.co/za1doleq8v	http://t.co/za1doleq8v
http://t.co/zfhpzvwurj	http://t.co/zfhpzvwurj
http://t.co/zgykmlgov0	http://t.co/zgykmlgov0
http://t.co/zh1g31kdbw	http://t.co/zh1g31kdbw
http://t.co/zhuufn4pel	http://t.co/zhuufn4pel
http://t.co/zlbpho70ot	http://t.co/zlbpho70ot
http://t.co/zlcwakgveb	http://t.co/zlcwakgveb
http://t.co/zmnrzwgpkv	http://t.co/zmnrzwgpkv
http://t.co/zn350c5tkd	http://t.co/zn350c5tkd
http://t.co/znmu0tbejm	http://t.co/znmu0tbejm
http://t.co/zukjge1srx	http://t.co/zukjge1srx
http://t.co/zv28yors5l	http://t.co/zv28yors5l
http://t.co/zy4gd45vzs	http://t.co/zy4gd45vzs
http://t.co/zytfrxd4lh	http://t.co/zytfrxd4lh
http://t	http://t
htwk	htwk
@hubertsickinger	@hubertsickinger
@hubertus_heil	@hubertus_heil
hummels	hummels
hundert	hundert
hunger	hunger
hupend	hupend
hupen	hupe|hupen
hürde	hürde
hürden	hürde
hurra	hurra
ich	ich
ic	ic
ick	ick
idee	idee
ideen	idee
idioten	idiot
if	if
igitt	igitt
ih	ih
ihk	ihk
ihm	er
ihn	er
ihre	ihr
ihrem	ihr
ihrer	ihr
ihres	ihr
ihr	ihr
ihr	sie
ihsetze	ihsetze
i.	i.
i	i
iiihaaa	iiihaaa
ii	ii
i.	in
ikea	ikea
#illner	#illner
@imaxiiii	@imaxiiii
im	in
immer	immer
impressionen	impression
indien	indien
indischen	indisch
industrieschau	industrieschau
informationen	information
informiert	informieren
infos	info
infoständen	infostand
in	in
initiative	initiative
inkl	inkl
#inklusio	#inklusio
innenstädten	innenstadt
innerhalb	innerhalb
insbesondere	insbesondere
ins	in
installation	installation
integration	integration
interessanter	interessant
internationale	internationale
internet	internet
intern	intern
interview	interview
intrige	intrige
inzwi	inzwi
#irak	#irak
irgend	irgend
irgendwann	irgendwann
irgendwas	irgendwas
irgendwie	irgendwie
irgendwo	irgendwo
@irigyt	@irigyt
irrglaube	irrglaube
irrsinn	irrsinn
@isabelledaniel	@isabelledaniel
ischia	ischia
isch	isch
@isipisi5	@isipisi5
is	is
island	island
israels	israel
ist	sein
ists	ists
jackpot	jackpot
jahns	jahn
jahre	jahr
jahren	jahr
jahres	jahr
jahrestief	jahrestief
jahrhundertprozess	jahrhundertprozess
jährige	jährige
jahr	jahr
@jaimesboobies	@jaimesboobies
ja	ja
jaja	jaja
@jakob_juergen	@jakob_juergen
jamaika	jamaika
james	james
@janinab_	@janinab_
jap	jap
jawohl	jawohl
@jbierwirth	@jbierwirth
@jderulosgirl	@jderulosgirl
@jeckesding	@jeckesding
jede	jede
jedem	jede
jeden	jede
jeder	jede
jeht	jeht
je	je
jemanden	jemand
jemand	jemand
jerusalem	jerusalem
jesuiten	jesuit
jesuit	jesuit
jetzt	jetzt
@jfroemmrich	@jfroemmrich
j.	j.
@j_nb	@j_nb
@_jo07	@_jo07
jobcenter	jobcenter
job	job
@jochenflasbarth	@jochenflasbarth
joe	joe
@joernlinnertz	@joernlinnertz
@joernpl	@joernpl
joghurt	joghurt
johannes	johannes
joint	joint
jorge	jorge
journalistenlogik	journalistenlogik
jpg	jpg
@jtrittin	@jtrittin
@jubayern	@jubayern
#jubel	#jubel
jugendarbeitslo	jugendarbeitslo
juhuuu	juhuuu
@julis_hl	@julis_hl
julis	julis
@junge_freiheit	@junge_freiheit
junge	jung
jungen	junge
@jungfreisinnige	@jungfreisinnige
@junggruen	@junggruen
jung	jung
jungs	jungs
#jungundnaiv	#jungundnaiv
jura	jura
jusos	juso
@jusos	@jusos
justin	justin
#justiz	#justiz
#justsaying	#justsaying
@kabine	@kabine
kacken	kacken
kaffee	kaffee
@kahrs	@kahrs
@kaigehring	@kaigehring
@kakaokind_	@kakaokind_
kaltschnee	kaltschnee
kamera	kamera
kampen	kampen
#kämpfe	#kämpfe
kämpfen	kämpfen
kampf	kampf
kandidaten	kandidat
kaninchen	kaninchen
kann	können
kannst	können
kanzlei	kanzlei
kanzleramt	kanzleramt
kanzlerin	kanzlerin
kanzlerkandidaten	kanzlerkandidat
kapelle	kapelle
#kapitalismus	#kapitalismus
kardinal	kardinal
karlsruhe	karlsruhe
#kärnten	#kärnten
karren	karren
@karsten_berlin	@karsten_berlin
karte	karte
kartoffelliebe	kartoffelliebe
@karwundel	@karwundel
kassenlage	kassenlage
@katrinar47	@katrinar47
katz3n	katz3n
katzen	katze
#kauder	#kauder
kaufen	kaufen
kauft	kaufen
kaum	kaum
keen	keen
keine	keine
keinen	keine
keiner	keine
kein	keine
ke	ke
keller	keller
kenne	kennen
kerl	kerl
@khgruensteidl	@khgruensteidl
kickerturniers	kickerturniers
@killikus	@killikus
kim	kim
kinde	kind
kindergarten	kindergarten
kinderspielfest	kinderspielfest
kindesmissbrauch	kindesmissbrauch
kindheit	kindheit
#kindle	#kindle
kino	kino
#kirche	#kirche
kirche	kirche
kirchenaustritt	kirchenaustritt
kirchen	kirche
@kistann	@kistann
@kiyoskarotten	@kiyoskarotten
@klapauz	@klapauz
klappen	klappen
klappt	klappen
klaps	klaps
klarheit	klarheit
klar	klar
klartext	klartext
klasse	klasse
klassenzimmern	klassenzimmer
klaus	klaus
kleiderschrank	kleiderschrank
kleinanzeigen	kleinanzeige
#kleinanzeigen	#kleinanzeigen
#kleine	#kleine
kleinen	klein
kleiner	klein
kleines	klein
@_klingebiel	@_klingebiel
klitzekleine	klitzekleine
klopf	klopfen
kluch	kluch
klug	klug
@klzcodebrecht	@klzcodebrecht
km	km
knall	knall
know	know
knuddel	knuddel
koalieren	koalieren
koalition	koalition
koalitionsgefängnis	koalitionsgefängnis
koalitionspartners	koalitionspartner
koal	koal
kobolde	kobold
kochen	kochen
#köfer	#köfer
koffer	koffer
kollegin	kollegin
kölner	kölner
#köln	#köln
köln	köln
kolonialherr	kolonialherr
kolping	kolping
kolpingwerk	kolpingwerk
komisches	komisch
komisch	komisch
komme	kommen
kommenden	kommend
kommen	kommen
kommentar	kommentar
komm	kommen
kommst	kommen
kommt	kommen
kommts	kommts
kommunalbörse	kommunalbörse
kommunikation	kommunikation
kommunistenschweine	kommunistenschwein
kompetenzteam	kompetenzteam
komplizen	komplize
kompromiss	kompromiss
komt	komt
kondome	kondom
konflikt	konflikt
#konklave	#konklave
konklave	konklave
könne	können
können	können
könnte	können
könnt	können
konrad	konrad
konservativen	konservativ
konservativ	konservativ
kontakte	kontakt
kontakt	kontakt
kontrolle	kontrolle
konzept	konzept
konzeptkünstlerin	konzeptkünstlerin
köpfchen	köpfchen
kopf	kopf
korea	korea
korrektur	korrektur
#korruption	#korruption
@kosmolink	@kosmolink
#kosovo	#kosovo
koste	kosen|kosten
kostenlos	kostenlos
#kotzalarm	#kotzalarm
kotze	kotzen
kotzen	kotzen
kotz	kotzen
kracht	krachen
krafttraining	krafttraining
krankenversicherung	krankenversicherung
krass	krass
kratzen	kratzen
kräuterquark	kräuterquark
#kredit	#kredit
kreide	kreiden
kreuznach	kreuznach
kriecht	kriechen
kriminelle	kriminelle
krisenländern	krisenland
krisenpolitik	krisenpolitik
krisensitzung	krisensitzung
kristina	kristina
kritiker	kritiker
kritik	kritik
kritisieren	kritisieren
@krohlas	@krohlas
ksta	ksta
#kubicki	#kubicki
kubicki	kubicki
kugel	kugeln
kugelschreiber	kugelschreiber
kühlschrank	kühlschrank
#kultup	#kultup
#kultur	#kultur
kultur	kultur
kundenbeispiele	kundenbeispiele
kunstblitz	kunstblitz
#kunst	#kunst
@kunstwand	@kunstwand
#kunstwan	#kunstwan
#kurdistan	#kurdistan
kurs	kurs
kurt	kurt
kürze	kürze
kürzer	kurz
kurz	kurz
kurzvita	kurzvita
@kuttnersarah	@kuttnersarah
lage	lage
lagerwahlkampf	lagerwahlkampf
lag	liegen
landen	landen
ländern	land
landeswahlkampf	landeswahlkampf
landeswahlleiter	landeswahlleiter
land	land
@landpirat	@landpirat
landtag	landtag
landtagswahl	landtagswahl
#langeher	#langeher
lange	lang
lange	lange
langenhagen	langenhagen
langenselbold	langenselbold
langer	lang
langes	lang
lang	lang
langsrumpf	langsrumpf
#lanz	#lanz
laptop	laptop
lassen	lassen
lass	laß
lass	lassen
lasst	lassen
lässt	lassen
#lasttweet	#lasttweet
latino	latino
laufen	laufen
läuft	laufen
lauterbach	lauterbach
lauter	lauter
#lautfm	#lautfm
laut	laut
#lazy	#lazy
leaks	leaks
lebend	lebend
leben	leben
#lebensmittelverschwendung	#lebensmittelverschwendung
lecken	lecken
left	left
legen	legen
lehm	lehm
lehramt	lehramt
lehrer	lehrer
leider	leider
leidet	leiden
leihen	leihen
#leipzig	#leipzig
leipzig	leipzig
leipzigs	leipzig
leisen	leise
lernen	lernen
lese	lese
lesen	lese|lesen
lesen	lesen
#leserstimme	#leserstimme
let	let
letzte	letzt
letztlich	letztlich
leuft	leuft
leute	leute
@levu666	@levu666
leyen	leyen
lhe	lhe
#libyen	#libyen
lichtenstein	lichtenstein
licht	licht
liebe	lieb
liebe	lieben
lieber	lieb
liebev	liebev
lieblingseissalons	lieblingseissalons
liebt	lieben
liechtensteinstr	liechtensteinstr
lied	lied
liegen	liegen
lieve	lieve
#life	#life
like	like
lilie	lilie
lindner	lindner
linie	linie
@linke_hei	@linke_hei
linke	link
#linke	#linke
linke	linke
linke	linken
linke	links
linken	linke
linken	links
@linksfraktion	@linksfraktion
@lissydreams1r	@lissydreams1r
liste	liste
@littlewisehen	@littlewisehen
live	live
livestream	livestream
@lmprojectger	@lmprojectger
lobbying	lobbying
loch	loch
lock	locken
logistics	logistics
lohnt	lohnen
#london	#london
look	look
losgeschickt	losschicken
los	los
love	love
löwen	löwe
low	low
#lptby	#lptby
lsl	lsl
lsw	lsw
lte	lte
lter	lter
&lt	&lt
#ltnrw-stream	#ltnrw-stream
#ltwby13	#ltwby13
#ltwhe	#ltwhe
@lucasloveora	@lucasloveora
#lucke	#lucke
lüdenscheid	lüdenscheid
lüfter	lüfter
luft	luft
lügen	lüge|lügen
#lügenpack	#lügenpack
lu	lu
lungenflügel	lungenflügel
lupenreine	lupenrein
lustige	lustig
lustig	lustig
luxembourg	luxembourg
luxemburg	luxemburg
luxus	luxus
maas	maas
mache	machen
machen	machen
machern	macher
mach	machen
machst	machen
mächtig	mächtig
#machtkunst	#machtkunst
macht	machen
macht	macht
mädchen	mädchen
@madmenna	@madmenna
@maerys	@maerys
mafia	mafia
#mafia-seilschaften	#mafia-seilschaften
magazin	magazin
magistra	magistra
mag	mögen
mail	mail
mai	mai
@maja_1983	@maja_1983
makaber	makaber
making	making
#malaga	#malaga
@malertrynoga	@malertrynoga
mal	mal
@mamakeinezeit	@mamakeinezeit
mama	mama
@mamihaus	@mamihaus
managerin	managerin
manche	manche
manchmal	manchmal
manch	manche
mangelnde	mangelnd
mang	mang
man	man
mannheimer	mannheimer
mann	mann
@manomama	@manomama
manövern	manöver
manuel	manuel
maradona	maradona
maralorn	maralorn
@marcintosch	@marcintosch
@marcusblumberg	@marcusblumberg
@marcus_held	@marcus_held
mariaaaaaaa	mariaaaaaaa
@marianschreier	@marianschreier
mario	mario
@markuspingel	@markuspingel
@martasalazar	@martasalazar
@martin_belli	@martin_belli
martin	martin
@martinthue	@martinthue
maschine	maschine
masqq	masqq
massenhaft	massenhaft
mathe	mathe
@mathiasrichel	@mathiasrichel
mat	mat
@matschipyon	@matschipyon
@matthiasreckten	@matthiasreckten
@matthiasstrobel	@matthiasstrobel
@matzeknop	@matzeknop
@mauruszeier	@mauruszeier
maut	maut
maxi	maxi
maxinata	maxinata
max	max
mcdonald’s	mcdonald’s
@mcweijers	@mcweijers
@mdl_felbinger	@mdl_felbinger
medial	medial
@mediat	@mediat
medien	medien
medien	medium
meets	meets
mehr	mehr
meiendorfer	meiendorfer
mei	mei
meine	mein
meine	meinen
meinem	mein
meinen	mein
meiner	mein
mein	mein
meint	meinen
meinung	meinung
meisten	meist
meistgelesene	meistgelesen
meldet	melden
@melukie	@melukie
me	me
menge	menge
#menschenhandel	#menschenhandel
menschen	mensch
menschheit	menschheit
mentalität	mentalität
mercii	mercii
#merkel	#merkel
merkel	merkel
#merkel's	#merkel's
#merkel-wahn	#merkel-wahn
merken	merken
messehalle	messehalle
messi	messi
metzgerei	metzgerei
mhm	mhm
mich	ich
mietenexplosion	mietenexplosion
mieten	miete
mieterin	mieterin
@mikenolte_de	@mikenolte_de
militärdiktatur	militärdiktatur
militärischen	militärisch
milliardeneinnahmen	milliardeneinnahme
millionen	million
million	million
minderheitsregierung	minderheitsregierung
#minecraft	#minecraft
minijob	minijob
ministerien	ministerium
ministerin	ministerin
minister	minister
ministern	minister
ministerpräsidenten	ministerpräsident
ministerpräsident	ministerpräsident
min	min
mint	mint
mir	ich
mirror	mirror
@miss_1000_volt	@miss_1000_volt
mission	mission
#missschweiz	#missschweiz
misty	misty
miterlebt	miterleben
mitglied	mitglied
mitmachen	mitmachen
mit	mit
#mitspieler	#mitspieler
mitteilungen	mitteilung
mittelstand	mittelstand
mitte	mitte
mittendrin	mittendrin
mitten	mitten
mitternachtskonzert	mitternachtskonzert
mittler	mittler
@mittsommar	@mittsommar
mittwochaben	mittwochaben
mixen	mixen
m	m
mmmmmhhhh	mmmmmhhhh
#moca13	#moca13
möchte	mögen
möcht	möcht
mode	mode
moderiert	moderieren
modischen	modisch
möge	mögen
mögen	mögen
möglichkeit	möglichkeit
moin	moin
#mollath	#mollath
moma	moma
moment	moment
monaten	monaten
mond	mond
money	money
@monitoringcamp	@monitoringcamp
monitoring	monitoring
moral	moral
morgen	morgen
@moritzesyot	@moritzesyot
moslem	moslem
motivation	motivation
motiv	motiv
#möwe	#möwe
@mrmoregame	@mrmoregame
muharrharrharr	muharrharrharr
mülheim	mülheim
münchen	münchen
münchner	münchner
munter	munter
@muschelschloss	@muschelschloss
musikautorenpreis	musikautorenpreis
#musik	#musik
musik	musik
#muslime	#muslime
muslime	muslime
müssen	müssen
muss	müssen
musste	müssen
mussten	müssen
musst	müssen
mut	mut
mutti	mutti
mützenich	mützenich
@myavonking	@myavonking
my	my
nachdem	nachdem
nachdenke	nachdenken
nachdenken	nachdenken
nachhaltiger	nachhaltig
nachhilfehlehrer	nachhilfehlehrer
nachhilfe	nachhilfe
nachmittag	nachmittag
nach	nach
nachrichtenbox	nachrichtenbox
#nachrichten	#nachrichten
nachschlag	nachschlag
nächste	nah
nächsten	nah
nächster	nah
nacht	nacht
nachvollziehbarkeit	nachvollziehbarkeit
nachweisen	nachweisen
nackt	nackt
@nadineschoen	@nadineschoen
naherholungszentrum	naherholungszentrum
näher	nah
nahles	nahles
nah	nah
nahrungseinheiten	nahrungseinheiten
naja	naja
@namenlos4	@namenlos4
namen	name
na	na
#napolitano	#napolitano
natürlich	natürlich
naza	naza
nazis	nazi
#nb8jrnp	#nb8jrnp
nba	nba
@ndaktuell	@ndaktuell
nearly	nearly
neben	neben
ne	eine
nee	nee
negativ	negativ
nehme	nehmen
nehmen	nehmen
nehm	nehm
nein	nein
@nelapanghylee	@nelapanghylee
nen	nen
nenne	nennen
nenn	nennen
nennt	nennen
neoliberaler	neoliberaler
neoliberal	neoliberal
nerds	nerds
nesenbach	nesenbach
@nessie43	@nessie43
@netnewsexpress	@netnewsexpress
@netnrd	@netnrd
@netz4ktivisten	@netz4ktivisten
#netzeitung	#netzeitung
netz	netz
netzneutralität	netzneutralität
@netzpolitik	@netzpolitik
neue	neu
neuen	neu
neuer	neu
neues	neu
neukirchner	neukirchner
neukölln	neukölln
neulich	neulich
neu	neu
neuste	neu
#neuwied	#neuwied
never	never
new	new
#news	#news
news	news
@newwaver79	@newwaver79
next	next
@niamsbadpussy	@niamsbadpussy
nich	nich
nichtmal	nichtmal
nicht	nicht
nichts	nichts
#nichtwähler	#nichtwähler
#niedersachsen	#niedersachsen
niemanden	niemand
niemand	niemand
nie	nie
niggas	niggas
@nikischerak	@nikischerak
nikki	nikki
nimmer	nimmer
nimmt	nehmen
#ni	#ni
niveau	niveau
nix	nix
n	n
nochmal	nochmal
noch	noch
nog	nog
nominiert	nominieren
#nonpd	#nonpd
nordkoreanische	nordkoreanisch
#nordkorea	#nordkorea
nordkorea	nordkorea
@norellibelli	@norellibelli
normale	normal
normalisierung	normalisierung
normal	normal
norwegen	norwegen
note	note
not	not
#npd-aufmarsch	#npd-aufmarsch
#npd	#npd
npd	npd
#nr	#nr
nr	nr
nrw	nrw
#nsa	#nsa
nsu	nsu
#null5	#null5
nun	nun
nürnberg	nürnberg
nur	nur
nutzen	nutzen
nutzer	nutzer
nutzt	nutzen
nützt	nützen
@ober_franke	@ober_franke
oberlehrerfuzzi	oberlehrerfuzzi
oberlehrer	oberlehrer
objekt	objekt
ob	ob
obwohl	obwohl
#occupygermany	#occupygermany
och	och
oder	oder
offen	offen
öffentlicher	öffentlich
offizielles	offizielle
#offshoreleaks	#offshoreleaks
offshore	offshore
of	of
öfter	öfter
ohne	ohne
oh	oh
öh	öh
#ohweh	#ohweh
okay	okay
o.k.	o.k.
ökostrom	ökostrom
#okru	#okru
oli	oli
olympia	olympia
@onerepublic	@onerepublic
online	online
on	on
o.	o.
o	o
#opennrw13	#opennrw13
#opennrw	#opennrw
opfer	opfer
optisch	optisch
#orangejuice	#orangejuice
@orangenturbo	@orangenturbo
@orf_at	@orf_at
orf	orf
organisation	organisation
organisieren	organisieren
originell	originell
österreichischen	österreichische
österreichische	österreichisch
österreich	österreich
out	out
övp	övp
#ows	#ows
paare	paar
paar	paar
#pabst	#pabst
pabst	pabst
pack	pack
@palinarojinski	@palinarojinski
pang	pang
panov9free	panov9free
#papam	#papam
papam	papam
papandreou	papandreou
@papapreuss	@papapreuss
paprika	paprika
@papstad	@papstad
päpste	papst
papstlicher	papstlicher
#papst	#papst
papst	papst
papsttafel	papsttafel
paradies	paradies
paradise	paradise
parlamentarismus	parlamentarismus
parlamentswahl	parlamentswahl
parteibuch	parteibuch
parteien	partei
parteimitglied	parteimitglied
partei	partei
passieren	passieren
passiert	passieren
@patrickgorska	@patrickgorska
@patrick_kunkel	@patrick_kunkel
patzelt	patzelt
paul	paul
pausen	pause
pause	pause
@paxter_redwyne	@paxter_redwyne
paypal	paypal
pc	pc
pdf	pdf
#peer	#peer
peer	peer
peers	peer
@peersteinbrueck	@peersteinbrueck
peinlich	peinlich
@pejanec	@pejanec
@peneu76	@peneu76
perfo	perfo
permakulturpionier	permakulturpionier
@perrieedwardxs	@perrieedwardxs
perry	perry
personalie	personalie
personalkarussell	personalkarussell
@peteraltmaier	@peteraltmaier
peter	peter
#petersdom	#petersdom
petersplatz	petersplatz
@petertauber	@petertauber
pfalz	pfalz
pferdefleischlasagne	pferdefleischlasagne
pferdefleisch	pferdefleisch
pflanze	pflanze
philipp	philipp
@phoenix_de	@phoenix_de
#photo	#photo
photo	photo
pick	pick
#pickup	#pickup
@piejae	@piejae
pils	pils
@pinot_aspirin	@pinot_aspirin
pippi	pippi
@pirateleaksnrw	@pirateleaksnrw
@piratenpartei	@piratenpartei
#piratenpartei	#piratenpartei
piratenpartei	piratenpartei
piraten	pirat
@piraten	@piraten
#piraten	#piraten
piraten	piraten
@piratenrsk	@piratenrsk
#piratenstammtisch	#piratenstammtisch
@piratenstmk	@piratenstmk
pkv	pkv
pkw	pkw
plakaten	plakat
plakate	plakat
plakat	plakat
plan	plan
planungssicherheit	planungssicherheit
plattform	plattform
playlist	playlist
play	play
plenum	plenum
plötzlich	plötzlich
plugin	plugin
pm	pm
pn	pn
@pocket	@pocket
podiumsdiskussion	podiumsdiskussion
polen	polen
#poli	#poli
politiker	politiker
#politik	#politik
politik	politik
politischen	politisch
politische	politisch
polstermöbel	polstermöbel
ponte	ponte
@pontifex	@pontifex
pontifex	pontifex
#pope	#pope
popo	popo
@porrporr	@porrporr
porzellan	porzellan
positioniert	positionieren
positiv	positiv
posten	posten
postgender	postgender
post	post
@pouyapx	@pouyapx
:-p	:-p
:p	:p
p.	p.
p	p
practice	practice
praesidentin	praesidentin
praktikanten	praktikant
praktikantin	praktikantin
präsident	präsident
pregnant	pregnant
preis	preis
preisträgerin	preisträgerin
premierminis	premierminis
prepaid	prepaid
pressekodex	pressekodex
pressekonferenz	pressekonferenz
#pressemitteilung	#pressemitteilung
pressemitteilung	pressemitteilung
presse	presse
pressetenor	pressetenor
prinzip	prinzip
#prism	#prism
privaten	privat
private	privat
privatier	privatier
privatsphäre	privatsphäre
privilegien	privilegium
priviligieren	priviligieren
probieren	probieren
probiere	probieren
probier	probieren
probleme	problem
problem	problem
profilhintergrund	profilhintergrund
prognose	prognose
programm	programm
progressiven	progressiv
projekt	projekt
prominenter	prominent
promi	promi
promotion	promotion
prompt	prompt
pro	pro
@prosieben	@prosieben
protestiert	protestieren
protokoll	protokoll
prozent	prozent
prozess	prozess
p€€r	p€€r
prüfung	prüfung
@pschnieder	@pschnieder
psychologische	psychologisch
puh	puh
pung	pung
punkt	punkt
pupst	pupst
@purple_snowdrop	@purple_snowdrop
putin	putin
quark	quark
@queer_de	@queer_de
quero	quero
quizsendung	quizsendung
#quoka	#quoka
rabatt	rabatt
@rablpeter	@rablpeter
@rachelzwitscher	@rachelzwitscher
radebeul	radebeul
radelt	radeln
radfahren	radfahren
radioeinschalten	radioeinschalten
radio	radio
@rafaelbuchegger	@rafaelbuchegger
rafiki	rafiki
#ragnitzbad	#ragnitzbad
raketen	rakete
@_rakuba	@_rakuba
ramsauer	ramsauer
ran	ran
ra	ra
rasse	rasse
#rassismus	#rassismus
rassistisch	rassistisch
raten	raten
#ratmg	#ratmg
#ratzinger	#ratzinger
rauch	rauch
raufgucken	raufgucken
raum	raum
rauschen	rauschen
raus	raus
raussuchen	raussuchen
raymond	raymond
reaktion	reaktion
@realmarkt	@realmarkt
rebellen	rebell
recall	recall
rechner	rechner
rechten	recht|rechte
recht	recht
rechtsstaat	rechtsstaat
redaktion	redaktion
reden	rede|reden
redner	redner
reduzieren	reduzieren
regentage	regentag
regierte	regiert
regiert	regieren
regierungen	regierung
#regierung	#regierung
regierung	regierung
regierungskriminalität	regierungskriminalität
regierungsprogramm	regierungsprogramm
regime	regime
regionalzügen	regionalzug
registrieren	registrieren
@regsprecher	@regsprecher
rehlinger	rehlinger
reichen	reich
rein	rein
reisen	reise|reisen
reise	reise
rekord	rekord
religion	religion
@remobernet	@remobernet
rente	rente
report	report
re	re
reservierung	reservierung
rest	rest
reuters	reuters
rheinische	rheinisch
rheinland	rheinland
#rhein	#rhein
richtige	richtig
#richtigesprüche	#richtigesprüche
richtig	richtig
richtlinie	richtlinie
richtung	richtung
#rlp	#rlp
rlp	rlp
rl	rl
robby	robby
robot	robot
rockt	rocken
@rockyomerovic	@rockyomerovic
@rolfmayer	@rolfmayer
romantisieren	romantisieren
römer	römer
römischen	römisch
#rom	#rom
rom	rom
roosevelt	roosevelt
röselei	röselei
rösler	rösler
@roterfranz	@roterfranz
rote	rot
roter	rot
@roter_schlumpf	@roter_schlumpf
#rotgrün	#rotgrün
rot	rot
round	round
@roveracland	@roveracland
#rp	#rp
#rtl	#rtl
rtl	rtl
rt	rt
rücken	rücken
rucksackreiseerfahrung	rucksackreiseerfahrung
rücktritt	rücktritt
rückwärts	rückwärts
@rudolfanders	@rudolfanders
ruft	rufen
rugenbräu	rugenbräu
ruhr	ruhr
@rullulli	@rullulli
runde	rund
rund	rund
rungen	rungen
rüstungsindustrie	rüstungsindustrie
ryan	ryan
@rz_elgass	@rz_elgass
@rzkreuznach	@rzkreuznach
@rzticker	@rzticker
#s21	#s21
s21	s21
saarland.de	saarland.de
saar	saar
sachen	sache
sache	sache
sachsen	sachsen
sacken	sacken
sack	sack
sackt	sacken
sadistischer	sadistisch
@saebelriemenbil	@saebelriemenbil
saft	saft
sagen	sagen
sag	sagen
sagte	sagen
sagt	sagen
@saloumehz	@saloumehz
salzen	salz|salzen
samba	samba
samenstau	samenstau
same	same
@sami_freak_x3	@sami_freak_x3
sammelteller	sammelteller
sandkasten	sandkasten
sang	singen
sanktionen	sanktion
@sarianas	@sarianas
sarin	sarin
@saschadiercks	@saschadiercks
saseler	saseler
@satirelupe	@satirelupe
saudämliche	saudämliche
saufen	saufen
@sba	@sba
#scbhcfg	#scbhcfg
schach	schach
schade	schade
schadstofffreie	schadstofffrei
schaffen	schaffen
schafft	schaffen
schall	schall
schatten	schatten
schäuble	schäuble
schauen	schauen
schauprozess	schauprozess
schau	schau
schau	schauen
schaut	schauen
scheiden	scheiden
scheinheiligkeit	scheinheiligkeit
#schein	#schein
scheuch	scheuch
scheuen	scheuen
schicksal	schicksal
schickt	schicken
schiss	schiss
@schlachtzeile	@schlachtzeile
schlafen	schlafen
schlaflos	schlaflos
#schlaglöchern	#schlaglöchern
schlauer	schlau
schlecht	schlecht
schluss	schluss
schmid	schmid
schmilzt	schmelzen
schmi	schmi
schmunzelnd	schmunzelnd
schnäppchenpre	schnäppchenpre
schnäppchen	schnäppchen
schnarrenberger	schnarrenberger
schneller	schnell
schokokeks	schokokeks
schönen	schön
schöneres	schön
schöner	schön
schöne	schön
schonmal	schonmal
schon	schon
schön	schön
schornstein	schornstein
schrank	schrank
schreckliche	schrecklich
schreiben	schreiben
schreien	schreien
schrieben	schreiben
schritt	schreiten
schröder	schröder
schuft	schaffen
schuldenunion	schuldenunion
schulen	schule
schule	schulen
schulgeld	schulgeld
schüßler	schüßler
#schuster	#schuster
schützen	schützen
schwäbische	schwäbisch
schwachsinn	schwachsinn
schwafeln	schwafeln
schwanz	schwanz
schwarzen	schwarz
schwarzer	schwarz
schwarze	schwarz
schwarz	schwarz
schwatter	schwatter
schweden	schweden
schweigt	schweigen
@schweiigen	@schweiigen
schweizer	schweizer
schweiz	schweiz
schwer	schwer
schwimmen	schwimmen
@schwutte	@schwutte
scientology	scientology
screen	screen
scrubs	scrubs
@sebastian0505	@sebastian0505
@sechsdreinuller	@sechsdreinuller
security	security
#seehofer	#seehofer
seehofer	seehofer
segen	segen
sehen	sehen
sehe	sehen
sehr	sehr
seid	sein
seinem	sein
seinen	sein
seiner	sein
seine	sein
sein	sein
sei	sein
seite	seite
seit	seit
sektierer	sektierer
selbst	selbst
selbstüberschätzung	selbstüberschätzung
selbstzerfleischung	selbstzerfleischung
selbstzerstörerischen	selbstzerstörerisch
selektive	selektiv
selten	selten
sendung	sendung
sepp	sepp
september	september
#serbien	#serbien
serie	serie
service	service
servus	servus
set	set
setzt	setzen
seuche	seuche
@sevilnahomy	@sevilnahomy
sexistische	sexistisch
sex	sex
sexy	sexy
@seymaisiktas	@seymaisiktas
shake	shake
shaking	shaking
show	show
shyt	shyt
sicherheit	sicherheit
sicherlich	sicherlich
sicher	sichern
sich	sich
siegerbankett	siegerbankett
siehe	sehen
sieht	sehen
sie	sie
sie	sie|sie
sind	sein
singend	singend
singt	singen
sinn	sinn
sinnvolle	sinnvoll
#sinvest	#sinvest
@siraxxes	@siraxxes
siri	siri
sittenwidrigkeit	sittenwidrigkeit
sixtinischer	sixtinische
sj	sj
ska	ska
sklaverei	sklaverei
sloterdijk	sloterdijk
@smcmuc	@smcmuc
smiley	smiley
smoke	smoken
sms	sms
#smv	#smv
snowden	snowden
@sobitte	@sobitte
social	social
socken	socke
@soeren_herbst	@soeren_herbst
sofort	sofort
#softwarpatente	#softwarpatente
#sofuckingwhat	#sofuckingwhat
sogar	sogar
solle	sollen
solln	solln
soll	sollen
sollten	sollen
sollte	sollen
sollts	sollts
sommerklam	sommerklam
sommer	sommer
sommertour	sommertour
sondern	sondern
song	song
sonst	sonst
sorry	sorry
so	so
soundtrack	soundtrack
soviel	soviel
sowas	sowas
sozialdemokraten	sozialdemokrat
soziale	sozial
sozialismus	sozialismus
sozialistische	sozialistisch
sozialliberalen	sozialliberal
@sozialpirat	@sozialpirat
sozial	sozial
sozis	sozi
spaltung	spaltung
spanien	spanien
spaniens	spanien
spannend	spannend
spannung	spannung
span	spanen
sparen	sparen
spark	spark
#spartei	#spartei
spaßbremse	spaßbremse
spaß	spaß
spätestens	spätestens
#spd-anhängern	#spd-anhängern
@spdde	@spdde
#spd-ler	#spd-ler
@spd	@spd
#spd	#spd
spd	spd
spd-zeitz.de	spd-zeitz.de
speiübel	speiübel
spektakulär	spektakulär
spekuliert	spekulieren
@spiegel_alles	@spiegel_alles
@spiegelonline	@spiegelonline
#spiegel	#spiegel
spiegel	spiegeln
#spiegel-titel	#spiegel-titel
spielen	spielen
spieler	spieler
spiele	spielen
spiel	spiel
spielste	spielste
spielt	spielen
spinnen	spinnen
spinner	spinner
spionin	spionin
#spittal	#spittal
spitzbergenweg	spitzbergenweg
spitzenkandidat	spitzenkandidat
spitzt	spitzen
spocht	spocht
sportgymnasium	sportgymnasium
sport	sport
spö	spö
#sprachlos	#sprachlos
sprecher	sprecher
sprech	sprech
@spreeradio	@spreeradio
sprengkoepfen	sprengkoepfen
spricht	sprechen
spurensuche	spurensuche
spur	spur
s.	s.
s	s
#ssnhd	#ssnhd
staaten	staat
staatskosten	staatskosten
staatsschutz	staatsschutz
staat	staat
stabile	stabil
stadion	stadion
stadtbahn	stadtbahn
stadtläufige	stadtläufige
stadt	stadt
stammtisch	stammtisch
stamp	stamp
ständig	ständig
stand	stand
stand	stehen
stärkeres	stark
@starkness	@starkness
star	star
starten	starten
startet	starten
statt	statt
staunend	staunend
stau	stau
@stbc	@stbc
steckt	stecken
steht	stehen
steigt	steigen
@steinbacherika	@steinbacherika
#steinbrück	#steinbrück
steinbrück	steinbrück
@steinekecdu	@steinekecdu
steinigt	steinigt
steinzeit	steinzeit
stelle	stelle
stelle	stellen
stellst	stellen
stellt	stellen
stellvertretend	stellvertretend
stennbrücke	stennbrücke
@stephanewald	@stephanewald
@sternde	@sternde
stern	stern
steuererhöhungen	steuererhöhung
steuerflucht	steuerflucht
steuerhinterzieher	steuerhinterzieher
steuerplänen	steuerplan
steuerung	steuerung
steuerverfolger	steuerverfolger
#steuerzahler	#steuerzahler
stimmen	stimmen
stimmen	stimme|stimmen
stimme	stimme
stimmungstief	stimmungstief
stock	stock
stoppen	stoppen
stop	stop
#storyimersten	#storyimersten
straffreiheit	straffreiheit
straight	straight
strand	strand
#strassen	#strassen
straße	straße
sträuße	strauß
strecke	strecke
streit	streit
strompreisbremse	strompreisbremse
#stronach	#stronach
stronach	stronach
st.	st.
stück	stück
studies	studies
study	study
stundenlang	stundenlang
stunden	stunde|stunden
stunde	stunde
#stura	#stura
stuttgart21	stuttgart21
stuttgart	stuttgart
substantivierung	substantivierung
suchen	suchen
suche	suche
suche	suchen
sucht	suchen
süd	süd
süess	süess
sunshineshop	sunshineshop
superbike	superbike
super	super
#sur	#sur
@susannehaun	@susannehaun
süßes	süß
süß	süß
@svanillechen	@svanillechen
@svenvolmering	@svenvolmering
#swistal	#swistal
sylvie	sylvie
sympathisch	sympathisch
symphatisch	symphatisch
#syrien	#syrien
syrien	syrien
system	system
systemwechsel	systemwechsel
sz	sz
t3n	t3n
table	table
tactics	tactics
taff	taff
tagen	tag
@tagesschau	@tagesschau
@tagesspiegel_de	@tagesspiegel_de
tagesspiegel	tagesspiegel
tages	tag
tage	tag
täglich	täglich
tag	tag
tag	tagen
tanzenden	tanzend
tanzen	tanzen
tanze	tanz
#tatort	#tatort
@tatortwat	@tatortwat
taubstellen	taubstellen
taugst	taugst
taugt	taugen
tausend	tausend
tau	tauen
@tcnator_	@tcnator_
td	td
@teamlamiya	@teamlamiya
team	team
technik	technik
techno	techno
teenies	teenies
teil	teil
telefonat	telefonat
telefoniert	telefonieren
telekommunikationsbereich	telekommunikationsbereich
@teleponyx	@teleponyx
#tempolimit	#tempolimit
teppich	teppich
@teraeuro	@teraeuro
testen	testen
teststreifen	teststreifen
@teufel100	@teufel100
teufels	teufel
@teuthorn	@teuthorn
@thedorient	@thedorient
thema	thema
themen	thema
@theotherdoris	@theotherdoris
@theresa_278	@theresa_278
theresia	theresia
the	the
thn	thn
@thodenk	@thodenk
@thomasmatzka	@thomasmatzka
@thomasrlenz	@thomasrlenz
thomas	thomas
#thonis	#thonis
#thoooooomassss	#thoooooomassss
ticker	ticker
@tic_tac_mel	@tic_tac_mel
tief	tief
tiere	tier
#tierschutz	#tierschutz
tierschutz	tierschutz
@tillide	@tillide
@tilojung	@tilojung
@timschmuckall	@timschmuckall
tirol	tirol
titanen	titan
titel	titel
tja	tja
@tobiashuch	@tobiashuch
tod	tod
toleranz	toleranz
@tommayereuropa	@tommayereuropa
too	too
top1	top1
topthemen	topthemen
#top	#top
top	top
total	total
töten	töten
to	to
tot	tot
tower	tower
traf	treffen
träge	träge
trailer	trailer
tränen	träne|tränen
transparenter	transparent
transparenz	transparenz
träumen	träumen
träume	traum
traumschön	traumschön
treffen	treffen
#trends	#trends
trennen	trennen
tribez	tribez
trickst	tricksen
trinke	trinken
trio	trio
tritterlie	tritterlie
trittin	trittin
tritt	treten
trohnt	trohnt
troika	troika
trömmelche	trömmelche
trotzdem	trotzdem
#truestory	#truestory
trufas	trufas
tschüss	tschüss
@tsmithrv	@tsmithrv
t	t
tunte	tunte
tun	tun
türkei	türkei
turnschuhe	turnschuh
tussen	tussen
tust	tun
tut	tun
#tvduell	#tvduell
tweetet	tweetet
tweete	tweete
tweets	tweets
tweet	tweet
twittern	twittern
twitterpartei	twitterpartei
@twitter_politik	@twitter_politik
twittert	twittert
#twitter	#twitter
twitter	twitter
typisch	typisch
ua	ua
übereinstimmungen	übereinstimmung
überflüssig	überflüssig
#übergangsjacke	#übergangsjacke
überhangmandate	überhangmandat
überhaupt	überhaupt
überraschendes	überraschende
überschr	überschr
überschuldet	überschulden
übertroffen	übertreffen
über	über
überwachung	überwachung
üblich	üblich
übrigens	übrigens
#ubs	#ubs
ude	ude
udo	udo
uhr	uhr
#uld	#uld
@ulrikeschmid	@ulrikeschmid
umdenken	umdenken
umfragen	umfrage
umfrage	umfrage
umgesetzt	umsetzen
umleitung	umleitung
umsteuern	umsteuern
umstimmen	umstimmen
um	um
umur	umur
umweltminister	umweltminister
unabhängige	unabhängig
unabsichtlich	unabsichtlich
unbedingt	unbedingt
…und	…und
und	und
une	une
unexpected	unexpected
unfall	unfall
ungewiss	ungewiss
unheilige	unheilig
uninteressante	uninteressant
unionsfraktionschef	unionsfraktionschef
unionswähler	unionswähler
union	union
unplugged	unplugged
unschuldsvermutung	unschuldsvermutung
unseren	unser
unserer	unser
unseres	unser
unsere	unser
unser	unser
unsichtbaren	unsichtbar
unsinn	unsinn
uns	wir
unterbezahlt	unterbezahlen
untergeht	untergehen
unterhalten	unterhalten
unterlagen	unterlage
unterricht	unterricht
unterschied	unterschied
unterstützen	unterstützen
unterstützung	unterstützung
unter	unter
unterwegs	unterwegs
un	un
unverbindlich	unverbindlich
unwichtige	unwichtig
unzulässige	unzulässig
updaten	updaten
@ureissner	@ureissner
urgestein	urgestein
urlauberin	urlauberin
urlaub	urlaub
url	url
ursprüngliche	ursprünglich
ursula	ursula
urteil	urteil
usa	usa
user	user
us	us
u	u
u.	um
u.	und
vaart	vaart
vandaag	vandaag
@vanessaleii	@vanessaleii
van	van
vater	vater
#vatican	#vatican
#vatikan	#vatikan
vatikan	vatikan
verachte	verachten
@veramariasch	@veramariasch
verändern	verändern
veranstaltet	veranstalten
veranstaltung	veranstaltung
verantwortliche	verantwortlich
verantwortlich	verantwortlich
verarbeitungszeit	verarbeitungszeit
verboten	verbieten
verdacht	verdacht
verdichtung	verdichtung
verdient	verdienen
verdrängung	verdrängung
vereinbarkeit	vereinbarkeit
vereine	vereinen
vereinigten	vereinigt
verelendet	verelenden
#verfassungsschutz	#verfassungsschutz
verfickten	verfickten
verfilzt	verfilzen
vergangener	vergangen
vergeltung	vergeltung
vergessen	vergessen
verhältnis	verhältnis
verhelfen	verhelfen
verhungern	verhungern
@verity95	@verity95
verkaufen	verkaufen
verkaufsberater	verkaufsberater
verkehr	verkehr
verkündet	verkünden
verkündung	verkündung
verkürzung	verkürzung
verk.	verk.
verlasse	verlassen
verlässt	verlassen
verlegen	verlegen
verliebt	verlieben
verlieren	verlieren
verliert	verlieren
verloren	verlieren
vermisstweet	vermisstweet
vermuten	vermuten
vernuenftige	vernuenftige
veröffentlicht	veröffentlichen
verpasst	verpassen
verrückte	verrückt
versauen	versauen
verschenken	verschenken
verschenke	verschenken
verschiedene	verschieden
verschwendung	verschwendung
versehentlich	versehentlich
#verspätung	#verspätung
verspielen	verspielen
verstanden	verstehen
verstandesveganer	verstandesveganer
verstehe	verstehen
versuchen	versuchen
versuchs	versuch
versucht	versuchen
versuch	versuch
verteidigungsministerium	verteidigungsministerium
verteilen	verteilen
vertrauen	vertrauen
ver	ver
verwechselt	verwechseln
verwundert	verwundern
verzählt	verzählen
verzweifelt	verzweifelt
#vetternwirtschaft	#vetternwirtschaft
ve	ve
veysel	veysel
via	via
video	video
vielen	viele
viele	viele
vielleicht	vielleicht
viel	viel
viel	viele
vierten	viert
vier	vier
vietnam	vietnam
villeicht	villeicht
villeroy	villeroy
@vincnw	@vincnw
@vine_sl	@vine_sl
virus	virus
vitalkur	vitalkur
#viva_conan	#viva_conan
@vivaonline	@vivaonline
viva	viva
vize	vize
vllt	vllt
vlt	vlt
@volker_beck	@volker_beck
@volkerk_	@volkerk_
volksfunk	volksfunk
volkswahl	volkswahl
voller	voll
volleyball	volleyball
völlig	völlig
volljährige	volljährig
vollsperrung	vollsperrung
vollstes	voll
voll	voll
vom	von
von	von
voranbringt	voranbringen
vorausfahrende	vorausfahrend
voraus	voraus
vorbei	vorbei
vorbereitet	vorbereiten
vorbild	vorbild
voreingenommen	voreingenommen
vorfeld	vorfeld
vorhalten	vorhalten
vorhersagen	vorhersagen
vorher	vorher
vorm	vorm
vorplatz	vorplatz
vorschläge	vorschlag
vorsitzender	vorsitzende
vorsprung	vorsprung
vorstand	vorstand
vorurteilsfrei	vorurteilsfrei
vor	vor
voting	voting
#vs	#vs
v	v
waffen	waffe
#waffen	#waffen
@wahlalternativ1	@wahlalternativ1
wahlaufrufe	wahlaufruf
wahlbeteiligung	wahlbeteiligung
wahlbetrug	wahlbetrug
wahlblog	wahlblog
wahlempfehlung	wahlempfehlung
wählen	wählen
wählergunst	wählergunst
wählerinnen	wählerin
wähler	wähler
#wahlkampf	#wahlkampf
wahlkampf	wahlkampf
wahlkreis	wahlkreis
wahlparteitag	wahlparteitag
wahlparty	wahlparty
wahlplakat	wahlplakat
wahlprogramm	wahlprogramm
wahlschlappen	wahlschlappe
wahlsieg	wahlsieg
wahlstimme	wahlstimme
wahltrend	wahltrend
wahlumfragen	wahlumfrage
wahlvolk	wahlvolk
#wahl	#wahl
wahl	wahl
wahnsinnige	wahnsinnig
währen	währen
wahrnehmung	wahrnehmung
wahrscheinlich	wahrscheinlich
#wald	#wald
walter	walter
wandel	wandel
wandern	wandern
wand	wand
wann	wann
waren	sein
wäre	sein
warnt	warnen
warnung	warnung
war	sein
warum	warum
wär	wär
waschplätzen	waschplatz
@wastlberl	@wastlberl
was	was
watch	watch
way	way
wechseln	wechseln
wechsel	wechsel
wegen	wegen
weggeholt	wegholen
weg	weg
weh	weh
weil	weil
weissen	weiß
weißer	weiß
weißes	weiß
weißt	weißen
weiß	weiß
weiß	wissen
weitere	weit
weiterhin	weiterhin
weiterschlafen	weiterschlafen
weiter	weiter
weitsicht	weitsicht
welche	welche
welch	welche
#welke	#welke
weltfireden	weltfireden
weltweiten	weltweit
@welt	@welt
#welt	#welt
welt	welt
welzer	welzer
wem	wer
@wendeiki	@wendeiki
wenden	wenden
weniger	wenige
wenigstens	wenigstens
wenig	wenige
wenns	wenns
wenn	wenn
wen	wen
werbematerialien	werbematerial
werbung	werbung
°werden	°werden
werden	werden
werde	werden
werte	wert
werte	werten
wer	wer
westens	westen
#westerwelle	#westerwelle
westerwelle	westerwelle
westliche	westlich
wette	wette
wettringer	wettringer
wettsammel	wettsammel
wg.	wg.
what	what
whiskey	whiskey
#whistlblower	#whistlblower
whistleblower	whistleblower
white	white
wichtig	wichtig
widererwartenamüsanterabend	widererwartenamüsanterabend
widersprüche	widerspruch
wider	widern
wieder	wieder
wiesbaden	wiesbaden
wieso	wieso
wie	wie
wikikpedia	wikikpedia
wildenten	wildente
wilde	wild
wild	wild
wille	wille
willst	wollen
will	wollen
wil	wil
windkraft	windkraft
winner	winner
@wintertagtraum	@wintertagtraum
wird	werden
wirft	werfen
wirklich	wirklich
wirkt	wirken
wir	sie
wirst	werden
wirtschaftsminister	wirtschaftsminister
wirtschaft	wirtschaft
wir	wir
wissenschaftler	wissenschaftler
wissen	wissen
@wissing	@wissing
wisst	wissen
@witoldwc	@witoldwc
witzig	witzig
@wiwo	@wiwo
wms	wms
wm	wm
wochenende	wochenende
wochen	woche
woche	woche
wofür	wofür
wohin	wohin
wohl	wohl
wohnen	wohnen
wohnort	wohnort
wohnungsbau	wohnungsbau
wohr	wohr
wok	wok
wolframalpha	wolframalpha
wolkenkratzer	wolkenkratzer
wollen	wollen
wolle	wollen
wollte	wollen
wollt	wollen
wordpress	wordpress
#worteausderkindheit	#worteausderkindheit
worte	wort
@wortfeld	@wortfeld
wort	wort
wo	wo
wp	wp
@wrolich	@wrolich
wucht	wucht
wünsche	wünschen
wünscht	wünschen
wunsch	wunsch
würden	werden
wurde	werden
würde	werden
würd	würd
@wuschelkeks	@wuschelkeks
wusste	wissen
wüsste	wissen
wußte	wissen
wüstensand	wüstensand
#wutyoporabola	#wutyoporabola
w	w
xddd	xddd
@xirgendwas	@xirgendwas
xl	xl
@x_qlusive	@x_qlusive
x	x
@xxjacky66	@xxjacky66
@yahoodi_ag	@yahoodi_ag
yay	yay
yep	yep
@yeti_2000	@yeti_2000
yoldfinger	yoldfinger
@youtube	@youtube
you	you
yuh	yuh
z80	z80
zach	zach
zählbare	zählbare
zahlen	zahl
zählt	zählen
zb	zb
@zdflogin	@zdflogin
#zdflogin	#zdflogin
@zdf	@zdf
#zdf	#zdf
zdf	zdf
zeichenwetti	zeichenwetti
zeichnerin	zeichnerin
zeigen	zeigen
zeigt	zeigen
zeig	zeigen
zeiht	zeihen
zeiten	zeit
zeitgeschehen	zeitgeschehen
zeitung	zeitung
zeit	zeit
zeitz	zeitz
@_zemer	@_zemer
zenit	zenit
zentrum	zentrum
zernisch	zernisch
zerredet	zerreden
zerrieben	zerreiben
zerstörung	zerstörung
#zib	#zib
#zidane	#zidane
zieht	zeihen|ziehen
zierteller	zierteller
zigaretten	zigarette
zigarette	zigarette
zitat	zitat
zitieren	zitieren
zocken	zocken
zögerliche	zögerlich
zoll	zoll
zombiedeutsche	zombiedeutsche
zoo	zoo
zufall	zufall
züge	zug
zugriff	zugriff
zug	zug
zuhauf	zuhauf
zuhause	zuhause
zukunftsoption	zukunftsoption
zukunft	zukunft
zumindest	zumindest
zum	zu
zündet	zünden
zurückgekeht	zurückgekeht
zurücktreten	zurücktreten
zurück	zurück
zürück	zürück
zur	zu
zusammenarbeit	zusammenarbeit
zusammengefasst	zusammenfassen
zusammen	zusammen
zusätzli	zusätzli
zuschauer	zuschauer
zuspammen	zuspammen
zu	zu
zwänge	zwingen|zwängen
#zwangsräumung	#zwangsräumung
zweifarbig	zweifarbig
zweifel	zweifel
zwei	zwei
zwischen	zwischen
z.	z.
