armselig	negative
ausgezeichnet	positive
böse	negative
erstklassig	positive
exzellent	positive
falsch	negative
glücklich	positive
grossartig	positive
großartig	positive
gut	positive
lieb	positive
mies	negative
minderwertig	negative
negativ	negative
phantastisch	positive
positiv	positive
richtig	positive
scheisse	negative
scheiße	negative
schlecht	negative
schön	positive
unglücklich	negative
unschön	negative
zweitklassig	negative
