!	positive
!...	positive
"	negative
#	positive
$	positive
%	negative
%link	negative
%negsmiley	negative
%possmiley	positive
%smiley	negative
%user	positive
%user-playlist	negative
%user-video	negative
&amp;	positive
&gt;	negative
&lt;	negative
'	negative
(	negative
)	negative
):	negative
*	negative
**	positive
*-*	positive
+	negative
,	positive
-	negative
.	negative
..	negative
...	positive
......	negative
/	negative
1	negative
2	negative
3	positive
4	positive
5	positive
6	negative
7	positive
8	negative
9	negative
:	negative
;	negative
</s>	negative
=	negative
?	negative
?!	negative
??	negative
???	negative
@	positive
@card@	negative
@youtube	positive
[	negative
]	negative
^	positive
_	negative
`	positive
a	positive
ab	negative
abend	positive
aber	negative
abgeschlossen.	positive
abnehmen	positive
absolut	negative
account	negative
ach	negative
afd	negative
ag	negative
ah	negative
ahnung	negative
aktuell	negative
album	positive
alle	positive
allein	negative
alleine	positive
als	negative
also	negative
alt	positive
alter	negative
am	positive
amazon	negative
an	positive
and	positive
andere	negative
anders	negative
android	negative
androidgames	positive
anfang	negative
anfangen	negative
angebot	negative
angenehm	positive
angst	negative
anschauen	positive
antwort	negative
app	negative
apple	negative
april	negative
arbeit	positive
arbeiten	positive
arm	negative
armselig	negative
arsch	negative
art	negative
artikel	negative
at	negative
au	negative
auch	negative
auf	negative
aufstehen	positive
auge	positive
aus	negative
ausgezeichnet	positive
aussehen	negative
auto	positive
außer	negative
b	negative
baby	positive
bad	positive
baden	negative
bahn	positive
bald	positive
bank	negative
barcelona	negative
bau	negative
bauen	negative
bayer	negative
bayern	negative
be	negative
bedauernswert	negative
beginnen	positive
bei	negative
beide	positive
beitrag	negative
bekommen	positive
ben	negative
benutzen	negative
bereits	negative
berlin	positive
berliner	negative
besonders	positive
besser	positive
bestellen	positive
bestimmt	negative
besuchen	positive
bett	positive
bevor	positive
bewerten	negative
bier	positive
bieten	negative
bild	positive
billig	negative
bis	positive
bisschen	positive
bitte	positive
bitten	positive
blau	negative
bleiben	negative
blick	negative
blog	negative
blöd	negative
boston	negative
brauchen	negative
bremen	negative
bringen	negative
bruder	negative
buch	positive
bundesliga	negative
bus	negative
bvb	positive
by	negative
böse	negative
c	negative
ca.	negative
cdu	negative
champions	positive
chance	negative
chef	negative
china	negative
cl	negative
club	positive
cm	negative
cool	positive
d	negative
d:	negative
da	negative
dabei	positive
dafür	positive
damit	positive
danach	positive
dank	positive
danke	positive
danken	positive
dann	positive
daran	positive
darauf	positive
dass	negative
datum	negative
davon	negative
dazu	negative
de	negative
dein	positive
denken	negative
denken|gedenken	negative
denn	negative
design	positive
deutsch	negative
deutsche	negative
deutschland	negative
di	negative
dick	positive
die	negative
dienstag	positive
dies	positive
digital	negative
ding	negative
direkt	negative
doch	negative
donnerstag	positive
doof	negative
dort	positive
dortmund	positive
dpa	negative
dran	negative
drauf	negative
draußen	positive
drehen	positive
drei	negative
drücken	negative
dsds	positive
du	positive
dumm	negative
durch	negative
dürfen	positive
dürftig	negative
düsseldorf	negative
e	negative
eben	positive
echt	negative
egal	negative
eh	negative
eher	negative
ehrlich	positive
ei	negative
eigen	negative
eigentlich	negative
ein	negative
eine	positive
einfach	negative
einige	negative
einmal	positive
eins	negative
einzig	negative
ekelerregend	negative
ekelhaft	negative
ekelig	negative
eltern	positive
empfehlen	positive
en	positive
ende	negative
endlich	positive
englisch	negative
entdecken	negative
entscheiden	negative
er	negative
erfolg	negative
erfolgreich	positive
erhalten	negative
erinnern	negative
erklären	negative
ernst	negative
ernten	negative
erreichen	negative
erst	negative
erstmal	positive
erwarten	negative
erzählen	positive
es	positive
essen	positive
etc.	negative
etwas	positive
eu	negative
euer	positive
eur	negative
euro	negative
europa	negative
ex	negative
ey	negative
f	negative
facebook	negative
fahren	positive
fall	negative
fallen	negative
fallen|fällen	negative
falls	positive
falsch	negative
familie	positive
fan	positive
fangen	positive
farbe	negative
fast	negative
fb	negative
fc	negative
fcb	negative
fdp	negative
fehlen	negative
fehler	negative
feiern	positive
fertig	negative
fest	negative
fett	negative
ff	positive
ficken	negative
fies	negative
film	negative
find	negative
finden	positive
fliegen	negative
focus	negative
folge	negative
folgen	positive
follower	positive
for	positive
fordern	negative
foto	positive
frage	positive
fragen	positive
frankfurt	negative
frau	negative
free	negative
frei	positive
freitag	positive
fressen	negative
freuen	positive
freund	positive
freundin	positive
freundlich	positive
frisch	positive
früh	negative
früher	negative
frühling	positive
fuck	negative
funktionieren	negative
fußball	negative
fähig	negative
fühlen	negative
führen	negative
fünf	negative
für	negative
fürs	positive
g	negative
galaxy	positive
game	positive
gameinsight	negative
ganz	positive
gar	negative
garten	positive
gb	negative
geben	negative
geburtstag	positive
gedanke	positive
gefallen	positive
gefecht	negative
gefühl	positive
gegen	negative
gehen	positive
gehts	positive
gehören	negative
geil	positive
geld	negative
gemein	negative
gemeinsam	positive
genau	negative
genießen	positive
genug	negative
gepostet	negative
gerade	negative
geringwertig	negative
german	negative
germany	negative
gern	positive
gerne	positive
gesamtpaket	negative
geschenk	positive
geschichte	negative
gesicht	negative
gestern	positive
gesund	positive
gesundheit	negative
gewinnen	positive
gewinnspiel	positive
gibts	positive
glauben	positive
gleich	negative
glück	positive
glücklich	positive
glückwunsch	positive
gmbh	positive
go	positive
gold	negative
goldmünze	positive
google	negative
gott	negative
gratis	negative
groß	negative
grund	negative
gruß	positive
grün	negative
grüne	negative
gucken	negative
gut	positive
gute	positive
gutschein	positive
götze	negative
günstig	positive
h	negative
haar	negative
hab	negative
haben	positive
haha	negative
halb	positive
hallo	positive
halt	negative
halten	negative
hamburg	positive
hand	negative
handy	negative
hannover	negative
happy	positive
hart	negative
hassen	negative
hast	positive
haus	negative
hd	positive
heftig	negative
heiß	negative
heißen	negative
helfen	negative
her	negative
herr	positive
herz	positive
herzlich	positive
heuen	positive
heute	positive
hey	positive
hier	positive
hilfe	positive
hin	positive
hinter	negative
hinzufügen	negative
hoch	negative
hoeness	negative
hoffen	positive
hoffentlich	negative
holen	positive
hose	negative
hotel	positive
http	negative
hund	positive
hässlich	negative
höherwertig	positive
hören	negative
hübsch	positive
i	negative
ich	positive
idee	positive
ihr	positive
immer	negative
immortalis	negative
in	negative
info	negative
interessant	negative
interessieren	negative
international	negative
internet	negative
interview	positive
ipad	negative
ipadgames	negative
iphone	negative
iphonegames	negative
irgendwann	positive
irgendwie	negative
irrig	negative
is	negative
island	negative
it	negative
ja	negative
jahr	negative
je	negative
jede	positive
jemand	positive
jetzt	positive
job	negative
jung	positive
justin	negative
k	negative
kaffee	positive
kalt	negative
kampf	negative
kaputt	negative
karte	negative
katze	positive
kaufen	negative
kaum	negative
keine	negative
kennen	positive
kg	negative
kind	negative
klar	negative
klasse	positive
klein	positive
kleinanzeige	positive
klingen	negative
km	positive
komisch	negative
kommen	positive
kommentar	negative
komplett	positive
konzert	positive
kopf	negative
korrekt	positive
kosten	negative
kostenlos	negative
krank	negative
kredit	negative
kriegen	negative
kunde	negative
kunst	positive
kurz	positive
kämpfer	negative
köln	positive
können	positive
l	negative
lachen	negative
laden	positive
land	negative
landkreis	negative
lang	positive
lange	positive
langsam	negative
langweilig	negative
lassen	negative
laufen	negative
laune	positive
laut	negative
laß	positive
league	negative
leben	negative
legen	negative
leicht	negative
leider	negative
leipzig	negative
lernen	positive
lesen	negative
let	negative
letzt	negative
leute	negative
level	negative
licht	positive
lieb	positive
liebe	positive
lieben	positive
lied	positive
liegen	negative
like	positive
link	negative
live	positive
los	positive
love	positive
lust	positive
lustig	negative
lösung	negative
m	negative
machen	positive
macht	negative
madrid	negative
mai	negative
mail	positive
mal	positive
mama	positive
man	negative
manche	negative
manchmal	negative
mangelhaft	negative
mann	positive
marketing	positive
markt	negative
me	negative
media	negative
medium	negative
mehr	negative
mein	positive
meinen	negative
meinung	negative
meist	negative
melden	positive
mensch	negative
merkel	negative
merken	negative
mi	positive
million	negative
min	negative
minderwertig	negative
minecraft	negative
mini	positive
minute	negative
mission	negative
misslich	negative
mit	negative
mitarbeiter	negative
mittwoch	positive
mm	negative
mobil	negative
mode	negative
moment	positive
monat	negative
montag	positive
morgen	positive
musik	positive
muss	positive
mutter	negative
my	negative
mädchen	negative
mögen	positive
möglich	negative
müde	negative
müller	negative
münchen	positive
müssen	positive
n	negative
na	positive
nach	negative
nachrangig	negative
nachricht	negative
nacht	negative
nah	negative
nahrungseinheiten	positive
naja	negative
name	negative
natürlich	positive
neben	negative
nee	negative
negativ	negative
nehmen	negative
nein	negative
nem	positive
nen	negative
nennen	negative
nerven	negative
nett	positive
netz	negative
neu	negative
neue	positive
new	positive
news	positive
nicht	negative
nichts	negative
nie	negative
niemand	negative
no	negative
noch	negative
nochmal	positive
nordkorea	negative
normal	positive
nowplaying	negative
nsu	negative
nun	positive
nur	negative
nutzen	negative
o	negative
ob	positive
obwohl	negative
oder	negative
of	positive
offen	positive
offiziell	negative
oft	negative
oh	negative
ohne	negative
ok	positive
okay	negative
omg	negative
on	positive
one	positive
online	negative
oo	negative
ostsee	negative
p	positive
paar	positive
paradise	positive
partei	negative
party	positive
passen	positive
passieren	negative
pc	negative
pegelmv	positive
per	positive
perfekt	positive
person	negative
photo	negative
pirat	negative
plan	positive
planen	negative
platz	negative
play	positive
politik	negative
polizei	negative
portal	negative
positiv	positive
post	negative
preis	negative
privat	positive
pro	positive
problem	negative
produkt	negative
programm	negative
projekt	negative
prozent	negative
prozess	negative
punkt	positive
pvp	positive
quoka	positive
r	positive
radio	negative
raum	positive
raus	negative
re	positive
real	positive
recht	negative
reden	negative
regen	positive
reichen	negative
rein	negative
richtig	positive
richtung	negative
rot	negative
rt	positive
rufen	positive
rum	negative
rund	negative
s	positive
sache	negative
sagen	positive
saison	negative
sammeln	positive
samstag	positive
samsung	negative
schade	negative
schaffen	negative
schauen	positive
scheinen	negative
scheißen	negative
scheußlich	negative
schicken	positive
schlafen	positive
schlagen	negative
schlecht	negative
schließen	negative
schlimm	negative
schnell	positive
schon	positive
schreiben	positive
schuld	negative
schule	negative
schwach	negative
schwarz	negative
schweiz	negative
schwer	negative
schädlich	negative
schön	positive
sehen	negative
sehr	positive
sein	negative
seit	negative
seite	negative
selber	negative
selbst	negative
serie	negative
service	positive
setzen	negative
sex	positive
sexy	positive
shirt	positive
shop	positive
show	positive
sich	negative
sicher	positive
sie	negative
sieg	negative
sie|sie	positive
singen	negative
sinn	negative
sitzen	positive
smartphone	negative
so	negative
social	negative
sofort	positive
sogar	negative
solche	negative
sollen	positive
sommer	positive
sondern	negative
song	positive
sonne	positive
sonntag	positive
sonst	negative
sorry	negative
sowas	negative
spannend	positive
sparen	negative
spaß	positive
spd	negative
spiegel	negative
spiel	negative
spielen	negative
sport	positive
sprechen	negative
spät	negative
stadt	negative
stand	negative
star	positive
stark	negative
start	positive
starten	negative
statt	negative
stehen	negative
steigen	negative
stellen	negative
sterben	negative
stern	negative
stimmen	negative
straße	negative
studie	negative
stunde	negative
stunde|stunden	negative
stuttgart	negative
suche	positive
suchen	positive
super	positive
system	negative
süß	positive
t	negative
tag	positive
tagen	positive
tatort	negative
team	positive
teil	negative
teilen	positive
telekom	negative
tendenz	negative
test	negative
teuer	negative
text	negative
the	positive
thema	negative
ticket	positive
tip	negative
tl	positive
to	positive
tod	negative
toll	positive
top	positive
tor	negative
tot	negative
total	negative
tragen	positive
training	positive
traum	positive
traurig	negative
treffen	positive
trend	negative
tribez	negative
trinken	positive
trotz	negative
trotzdem	positive
träumen	positive
tun	negative
tv	negative
tweet	positive
tweets	positive
twitter	positive
typ	negative
u	negative
uhr	positive
um	negative
un	positive
unangenehm	negative
unbedingt	positive
und	negative
unerfreulich	negative
unfall	negative
unglücklich	negative
ungünstig	negative
unrecht	negative
unser	negative
unter	negative
unterlegen	negative
unternehmen	negative
up	positive
update	negative
urlaub	positive
us	negative
usa	negative
v	negative
van	negative
vater	negative
verdienen	negative
verdorben	negative
vergessen	negative
verkauf	negative
verkaufen	positive
verkehr	negative
verlieren	negative
vermissen	positive
verpassen	negative
version	positive
verstehen	negative
versuchen	positive
veröffentlichen	negative
via	negative
video	positive
viel	negative
viele	positive
vielleicht	positive
vier	positive
voll	negative
vollendet.	positive
von	negative
vor	negative
vorbei	positive
w	positive
wach	positive
wahl	negative
wahr	negative
wahrscheinlich	negative
wann	positive
warm	negative
warten	positive
warum	negative
was	positive
wasser	negative
we	positive
webverzeichnis	negative
wechseln	negative
weg	negative
wegen	negative
weil	negative
weinen	negative
weit	negative
weiter	positive
weiß	positive
weißen	negative
welche	positive
welt	negative
wenige	negative
wenigstens	positive
wenn	negative
wer	positive
werbung	negative
werd	positive
werden	negative
wert	negative
wetter	positive
wichtig	negative
widerlich	negative
widerwärtig	negative
wie	negative
wieder	positive
wien	negative
wieso	negative
willkommen	positive
wind	negative
windows	negative
wir	positive
wirklich	negative
wirtschaft	negative
wissen	negative
wo	negative
woche	negative
wochenende	positive
wohl	positive
wohnen	positive
wohnung	positive
wollen	positive
wort	negative
wow	positive
wunderschön	positive
wunsch	positive
wählen	negative
während	positive
wär	negative
wünschen	positive
x	positive
you	negative
youtube	negative
zahlen	negative
zeigen	negative
zeihen|ziehen	negative
zeit	positive
zeitung	negative
ziel	negative
ziemlich	negative
zimmer	positive
zu	negative
zug	negative
zuhause	positive
zukunft	negative
zurück	positive
zusammen	positive
zwar	negative
zwei	positive
zweit	positive
zwischen	negative
|	positive
~	positive
°c	negative
ändern	negative
übel	negative
über	negative
überhaupt	negative
überlegen	positive
überragend	positive
übersicht	negative
übrigens	positive
♥	positive
❤	positive
