!	positive
"	negative
%link	negative
%possmiley	positive
%user	positive
'	negative
(	negative
)	negative
,	positive
-	negative
.	negative
..	negative
...	positive
/	negative
:	negative
</s>	negative
?	negative
@card@	negative
aber	negative
alle	positive
als	negative
an	positive
android	negative
androidgames	positive
angenehm	positive
arm	negative
armselig	negative
auch	negative
auf	negative
aus	negative
ausgezeichnet	positive
bedauernswert	negative
bei	negative
besser	positive
böse	negative
da	negative
dann	positive
die	negative
du	positive
dürftig	negative
eine	positive
ekelerregend	negative
ekelhaft	negative
ekelig	negative
er	negative
es	positive
falsch	negative
fies	negative
freundlich	positive
für	negative
gameinsight	negative
gehen	positive
gemein	negative
geringwertig	negative
glücklich	positive
goldmünze	positive
gut	positive
haben	positive
heute	positive
hässlich	negative
höherwertig	positive
hübsch	positive
ich	positive
ihr	positive
in	negative
irrig	negative
ja	negative
jetzt	positive
keine	negative
korrekt	positive
können	positive
lieb	positive
machen	positive
mal	positive
man	negative
mangelhaft	negative
mehr	negative
mein	positive
minderwertig	negative
misslich	negative
mit	negative
nach	negative
nachrangig	negative
negativ	negative
nett	positive
neu	negative
nicht	negative
noch	negative
nur	negative
oder	negative
positiv	positive
richtig	positive
sammeln	positive
scheußlich	negative
schlecht	negative
schlimm	negative
schon	positive
schwach	negative
schädlich	negative
schön	positive
sein	negative
sich	negative
sie	negative
sie|sie	positive
so	negative
unangenehm	negative
und	negative
unerfreulich	negative
unglücklich	negative
ungünstig	negative
unrecht	negative
unterlegen	negative
verdorben	negative
von	negative
was	positive
wenn	negative
werden	negative
widerlich	negative
widerwärtig	negative
wie	negative
wieder	positive
wir	positive
wollen	positive
zu	negative
|	positive
übel	negative
überlegen	positive
überragend	positive
