!	positive
!...	positive
"	negative
#	positive
$	positive
%	negative
%ironicsmiley	positive
%link	negative
%negsmiley	negative
%possmiley	positive
%smiley	negative
%user	positive
%user-playlist	negative
%user-video	negative
&	positive
&amp;	positive
&gt;	negative
&lt;	negative
'	negative
(	negative
)	negative
):	negative
);	negative
*	negative
**	positive
***	positive
*-*	positive
+	negative
,	positive
-	negative
.	negative
..	negative
...	positive
...!	positive
....	negative
......	negative
/	negative
1	negative
1/2	positive
10	negative
100	negative
13	negative
16	negative
2	negative
20	negative
3	positive
3:0	negative
4	positive
5	positive
50	negative
6	negative
7	positive
8	negative
9	negative
:	negative
:'(	negative
:'d	negative
::	negative
;	negative
</s>	negative
=	negative
?	negative
?!	negative
?...	positive
??	negative
???	negative
@	positive
@card@	negative
@youtube	positive
[	negative
\	positive
]	negative
]:	negative
^	positive
_	negative
`	positive
a	positive
a.	negative
ab	negative
abend	positive
aber	negative
abgeben	negative
abgeschlossen.	positive
abi	positive
abnehmen	positive
absolut	negative
absolvieren	negative
account	negative
ach	negative
achso	negative
acht	negative
achtung	negative
afd	negative
ag	negative
ah	negative
ahnung	negative
akku	negative
aktie	negative
aktion	negative
aktiv	negative
aktualisiert	negative
aktuell	negative
aku	negative
al	negative
alaba	negative
album	positive
alkohol	positive
all	negative
alle	positive
allein	negative
alleine	positive
allerdings	negative
allgemein	negative
als	negative
also	negative
alt	positive
alter	negative
alternative	negative
am	positive
amateur	positive
amazon	negative
an	positive
and	positive
andere	negative
anders	negative
android	negative
androidgames	positive
anfang	negative
anfangen	negative
angeblich	negative
angebot	negative
angenehm	positive
angst	negative
ankommen	positive
anmelden	positive
anruf	negative
anrufen	positive
ans	positive
anschauen	positive
anschlag	negative
anschluss	negative
ansehen	negative
anti	negative
antwort	negative
antworten	positive
anziehen	positive
apa	negative
app	negative
apple	negative
apps	negative
apr	negative
april	negative
aprilscherz	negative
arbeit	positive
arbeiten	positive
ard	negative
arm	negative
armselig	negative
arsch	negative
arschloch	negative
art	negative
artikel	negative
arzt	negative
as	positive
at	negative
au	negative
auch	negative
auf	negative
aufgabe	negative
aufhören	negative
aufm	positive
aufnehmen	positive
aufpassen	negative
aufregen	negative
aufs	positive
aufstehen	positive
aufwachen	positive
auge	positive
augsburg	negative
aus	negative
ausbildung	positive
ausgabe	negative
ausgezeichnet	positive
aussehen	negative
auto	positive
automatisch	negative
autor	negative
außer	negative
außerdem	negative
b	negative
b.	negative
baby	positive
backen	positive
bad	positive
baden	negative
bahn	positive
bahnhof	negative
bald	positive
balkon	positive
band	negative
bank	negative
bar	negative
barca	negative
barcelona	negative
basel	negative
bau	negative
bauen	negative
baum	negative
bayer	negative
bayerisch	negative
bayern	negative
bb	negative
bda	negative
be	negative
bedauernswert	negative
bedeuten	negative
beenden	negative
beginnen	positive
bei	negative
beide	positive
bein	negative
beispiel	negative
beitrag	negative
bekannt	negative
bekommen	positive
belohnung	positive
ben	negative
benutzen	negative
bereich	negative
bereit	negative
bereits	negative
berg	negative
bericht	negative
berichten	negative
berlin	positive
berliner	negative
beruf	negative
bescheid	positive
beschäftigen	negative
besonder	positive
besonders	positive
besser	positive
besserung	negative
beste	positive
bestehen	negative
bestellen	positive
bestimmen	negative
bestimmt	negative
bestätigen	negative
besuch	positive
besuchen	positive
bett	positive
bevor	positive
bewegen	negative
bewerten	negative
bezahlen	positive
beziehung	negative
bi	positive
bieber	negative
bier	positive
bieten	negative
big	negative
bild	positive
bildung	negative
billig	negative
bio	negative
bis	positive
bisher	negative
bisschen	positive
bitch	negative
bitte	positive
bitten	positive
black	negative
blau	negative
bleiben	negative
blick	negative
blog	negative
bloß	negative
blöd	negative
bmw	negative
boah	negative
bochum	negative
bock	positive
boden	negative
bonn	negative
borussia	negative
boston	negative
boy	negative
brandenburg	negative
brauchen	negative
braun	negative
brechen	negative
bremen	negative
brennen	negative
brief	negative
bringen	negative
bruder	negative
buch	positive
buchen	positive
buchtip	positive
bund	negative
bundesliga	negative
bundestag	negative
bunt	positive
bus	negative
business	negative
bvb	positive
by	negative
bzw.	negative
börse	negative
böse	negative
bürger	negative
büro	positive
c	negative
ca	positive
ca.	negative
call	negative
can	positive
cc	positive
cd	positive
cdu	negative
ch	positive
champions	positive
chance	negative
chat	positive
check	positive
checken	positive
chef	negative
china	negative
christian	negative
city	positive
cl	negative
club	positive
cm	negative
co	negative
code	positive
computer	negative
cont	positive
cool	positive
couch	positive
cover	positive
csu	negative
d	negative
d.	negative
d:	negative
da	negative
dabei	positive
dafür	positive
dagegen	negative
daher	positive
damals	negative
dame	positive
damit	positive
dan	positive
danach	positive
dank	positive
danke	positive
danken	positive
dankeschön	positive
dann	positive
dante	negative
daran	positive
darauf	positive
darlehen	positive
darum	negative
darüber	negative
dass	negative
dat	negative
date	positive
datum	negative
dauer	negative
dauern	negative
daumen	positive
david	negative
davon	negative
dax	negative
day	positive
days	negative
dazu	negative
de	negative
dead	negative
deal	positive
definitiv	negative
dein	positive
demnächst	positive
demo	negative
demokratie	negative
denken	negative
denken|gedenken	negative
denn	negative
derzeit	negative
deshalb	negative
design	positive
designer	positive
deswegen	negative
detail	negative
deutlich	negative
deutsch	negative
deutsche	negative
deutschland	negative
di	negative
dick	positive
die	negative
dienst	negative
dienstag	positive
dies	positive
diese	positive
diesmal	negative
digital	negative
ding	negative
direkt	negative
diskussion	negative
diskutieren	negative
diät	negative
dj	positive
dm	positive
do	positive
doch	negative
dollar	negative
domian	negative
don	negative
donnerstag	positive
doof	negative
dort	positive
dortmund	positive
download	negative
dpa	negative
dr.	negative
dran	negative
drauf	negative
draußen	positive
drehen	positive
drei	negative
dresden	negative
drin	negative
dringend	positive
dritt	negative
drohen	negative
drosseln	negative
drosselung	negative
druck	negative
drüber	positive
drücken	negative
dsds	positive
dsl	negative
dtn	negative
du	positive
duisburg	negative
dumm	negative
dunkel	negative
durch	negative
duschen	positive
dvd	positive
dürfen	positive
dürftig	negative
düsseldorf	negative
e	negative
e.	negative
ebay	negative
eben	positive
ebook	negative
echt	negative
ecke	negative
edition	positive
eftn	negative
egal	negative
eh	negative
ehe	negative
eher	negative
ehrlich	positive
ei	negative
eig	negative
eigen	negative
eigentlich	negative
ein	negative
eine	positive
einen	positive
einfach	negative
eingeben	positive
einige	negative
einkaufen	positive
einmal	positive
eins	negative
einsatz	negative
einschalten	positive
einschlafen	negative
einzig	negative
eis	negative
ekelerregend	negative
ekelhaft	negative
ekelig	negative
eltern	positive
empfehlen	positive
empfehlung	positive
en	positive
end	negative
ende	negative
enden	positive
endlich	positive
energie	negative
eng	negative
englisch	negative
entdecken	negative
entscheiden	negative
entscheidung	negative
entschuldigen	negative
entweder	negative
entwickeln	negative
entwickler	negative
entwicklung	negative
er	negative
erde	negative
erfahren	positive
erfahrung	negative
erfolg	negative
erfolgreich	positive
erfüllen	positive
ergebnis	negative
erhalten	negative
erinnern	negative
erinnerung	negative
erkennen	negative
erklären	negative
erleben	positive
erneut	negative
ernst	negative
ernsthaft	negative
ernten	negative
ernährung	negative
erotik	positive
erreichen	negative
erscheinen	negative
erst	negative
erstellen	negative
erstmal	positive
erwarten	negative
erwünscht	positive
erzählen	positive
eröffnen	positive
es	positive
essen	positive
etc.	negative
etwa	negative
etwas	positive
eu	negative
euer	positive
eur	negative
euro	negative
europa	negative
europäisch	negative
event	positive
ewig	positive
ewm	negative
ex	negative
exklusiv	negative
experte	negative
explosion	negative
extra	positive
extrem	negative
ey	negative
f	negative
facebook	negative
facts	positive
fahren	positive
fahrrad	positive
fahrt	negative
fail	negative
fall	negative
fallen	negative
fallen|fällen	negative
fallen|gefallen	negative
falls	positive
falsch	negative
familie	positive
fan	positive
fangen	positive
farbe	negative
fassen	negative
fast	negative
faul	negative
favorit	negative
faz	negative
fb	negative
fc	negative
fcb	negative
fcbayern	negative
fcbfcb	positive
fdp	negative
fehlen	negative
fehler	negative
feierabend	positive
feiern	positive
fein	positive
fenster	positive
ferien	positive
fernsehen	negative
fernseher	negative
fertig	negative
fest	negative
festival	negative
fett	negative
ff	positive
ficken	negative
fies	negative
film	negative
filmen	negative
final	positive
finale	negative
finanziell	negative
find	negative
finden	positive
finger	negative
firma	negative
fit	positive
fitness	positive
fliegen	negative
flug	positive
flughafen	negative
focus	negative
folge	negative
folgen	positive
folgend	negative
follow	positive
follower	positive
followerpower	positive
for	positive
fordern	negative
form	negative
forum	negative
foto	positive
frage	positive
fragen	positive
frank	negative
frankfurt	negative
frankreich	negative
französisch	negative
frau	negative
frauenquote	negative
free	negative
frei	positive
freiburg	negative
freiheit	negative
freitag	positive
fressen	negative
freude	positive
freuen	positive
freund	positive
freundin	positive
freundlich	positive
frisch	positive
froh	positive
from	negative
früh	negative
früher	negative
frühling	positive
frühstück	positive
fuck	negative
full	positive
fun	positive
funktionieren	negative
fuß	negative
fußball	negative
fähig	negative
fühlen	negative
führen	negative
fünf	negative
für	negative
fürs	positive
g	negative
ga	negative
galaxy	positive
gambling	negative
game	positive
gameinsight	negative
games	negative
gang	negative
ganz	positive
gar	negative
garten	positive
gast	negative
gb	negative
ge	positive
geb	positive
geben	negative
gebiet	negative
gebraucht	negative
geburtstag	positive
gebäude	negative
gedanke	positive
gefahr	negative
gefallen	positive
gefecht	negative
gefährlich	negative
gefühl	positive
gegen	negative
gegenüber	negative
gehen	positive
gehts	positive
geht’s	positive
gehören	negative
geil	positive
gelb	negative
geld	negative
gelten	negative
gemein	negative
gemeinsam	positive
genau	negative
genauso	negative
generation	negative
genial	positive
genießen	positive
genug	negative
gepostet	negative
ger	negative
gerade	negative
gericht	negative
geringwertig	negative
german	negative
germany	negative
gern	positive
gerne	positive
gerät	negative
gerücht	negative
gesamtpaket	negative
geschenk	positive
geschichte	negative
geschäft	negative
gesellschaft	negative
gesetz	negative
gesicht	negative
gespannt	positive
gespräch	positive
gestern	positive
gesund	positive
gesundheit	negative
get	positive
gewinn	negative
gewinnen	positive
gewinnspiel	positive
gibts	positive
girl	positive
girls	positive
glas	negative
glauben	positive
gleich	negative
glück	positive
glücken	positive
glücklich	positive
glückwunsch	positive
gmbh	positive
gntm	negative
go	positive
gold	negative
goldmünze	positive
golf	negative
gomez	negative
good	positive
google	negative
got	positive
gott	negative
gratis	negative
gratulieren	positive
grau	positive
greifswald	negative
grenze	negative
groß	negative
großartig	positive
grund	negative
gruppe	negative
gruß	positive
größe	negative
grün	negative
grüne	negative
grüßen	positive
gucken	negative
gut	positive
gute	positive
gutschein	positive
gönnen	positive
götze	negative
günstig	positive
h	negative
ha	positive
haar	negative
hab	negative
haben	positive
habs	positive
hach	positive
haha	negative
hahah	positive
hahaha	negative
hai	negative
halb	positive
halbfinale	positive
halle	negative
hallo	positive
halt	negative
halten	negative
hamburg	positive
hamburger	negative
hammer	positive
hand	negative
handeln	negative
handy	negative
hannover	negative
happy	positive
hart	negative
hassen	negative
hast	positive
hauen	negative
hauptsache	negative
haus	negative
hausen	positive
hd	positive
he	negative
heben	negative
heftig	negative
hehe	positive
heiraten	positive
heiß	negative
heißen	negative
helfen	negative
hell	positive
her	negative
herr	positive
herrlich	positive
hertha	positive
herz	positive
herzlich	positive
hessen	negative
heuen	positive
heute	positive
heutig	negative
hey	positive
hi	positive
hier	positive
high	positive
hilfe	positive
himmel	positive
hin	positive
hinten	negative
hinter	negative
hinweis	negative
hinzufügen	negative
hm	negative
hmm	negative
hoch	negative
hoeness	negative
hoffen	positive
hoffentlich	negative
hoffnung	negative
holen	positive
holz	positive
home	negative
hose	negative
hot	positive
hotel	positive
how	negative
hpa	negative
hsv	positive
ht	negative
htc	negative
htt	negative
http	negative
humor	negative
hund	positive
hunger	negative
hurra	negative
hälfte	negative
hängen	negative
hässlich	negative
höherwertig	positive
hölle	negative
hören	negative
hübsch	positive
i	negative
i'm	negative
ich	positive
ideal	positive
idee	positive
if	negative
ihr	positive
ii	negative
ik	negative
ikea	negative
immer	negative
immerhin	negative
immortalis	negative
in	negative
individuell	positive
info	negative
information	negative
informieren	negative
inhalt	negative
inkl	negative
innen	positive
inner	negative
insel	negative
instagram	positive
interessant	negative
interesse	negative
interessieren	negative
international	negative
internet	negative
interview	positive
ios	negative
ipad	negative
ipadgames	negative
iphone	negative
iphonegames	negative
irgendwann	positive
irgendwas	negative
irgendwie	negative
irgendwo	positive
irrig	negative
is	negative
isch	negative
island	negative
istanbul	negative
it	negative
italien	negative
iv	negative
j	negative
ja	negative
jaa	negative
jacke	negative
jahr	negative
james	negative
japan	negative
jauch	negative
je	negative
jede	positive
jemand	positive
jetz	positive
jetzt	positive
jij	negative
jo	positive
job	negative
jobs	negative
journalist	negative
jugend	negative
juli	negative
jung	positive
junge	negative
jungs	positive
juni	negative
just	positive
justin	negative
jährige	negative
jähriger	negative
k	negative
ka	positive
kaffee	positive
kalt	negative
kamera	positive
kampf	negative
kanal	positive
kaputt	negative
karlsruhe	negative
karriere	negative
karte	negative
kassel	negative
katze	positive
kauf	negative
kaufen	negative
kaum	negative
ke	negative
keine	negative
keks	positive
keller	negative
kennen	positive
kerl	negative
kg	negative
kid	negative
kiel	positive
kim	negative
kind	negative
kindle	positive
kino	negative
kirche	negative
klappen	positive
klar	negative
klasse	positive
klauen	negative
kleid	positive
klein	positive
kleinanzeige	positive
klicken	positive
klingen	negative
kloppen	positive
km	positive
knapp	negative
ko	negative
kochen	positive
kollege	positive
kollektion	negative
komisch	negative
kommen	positive
kommend	positive
kommentar	negative
komplett	positive
komt	negative
kontakt	positive
konto	negative
konzert	positive
kopf	negative
korrekt	positive
kosten	negative
kostenlos	negative
kotzen	negative
kraft	negative
kraftfahrzeug	negative
krank	negative
krass	negative
kreativ	positive
kredit	negative
kreis	negative
krieg	negative
kriegen	negative
krise	negative
kritik	negative
kritisieren	negative
kuchen	positive
kultur	negative
kunde	negative
kunst	positive
kurs	negative
kurz	positive
kämpfen	negative
kämpfer	negative
köln	positive
könig	negative
können	positive
körper	positive
küche	positive
kündigen	negative
küssen	positive
l	negative
la	positive
lachen	negative
laden	positive
lady	positive
lage	negative
lahm	negative
land	negative
landkreis	negative
lang	positive
lange	positive
langeweile	positive
langsam	negative
langweilig	negative
laptop	negative
lassen	negative
lasttweet	negative
lauf	positive
laufen	negative
laune	positive
laut	negative
laß	positive
league	negative
leben	negative
leck	positive
lecker	positive
led	negative
leer	negative
legen	negative
lehrer	negative
leicht	negative
leid	negative
leiden	negative
leider	negative
leipzig	negative
leistung	negative
lernen	positive
lesen	negative
let	negative
letzt	negative
leute	negative
level	negative
lewandowski	positive
lg	positive
licht	positive
lieb	positive
liebe	positive
lieben	positive
lied	positive
liefern	negative
liegen	negative
life	positive
liga	negative
like	positive
liked	negative
link	negative
links	negative
liste	negative
live	positive
lohnen	negative
lokal	negative
london	negative
los	positive
love	positive
luft	positive
luftdruck	negative
lust	positive
lustig	negative
lächeln	positive
löschen	negative
lösen	negative
lösung	negative
m	negative
m.	negative
mac	positive
machen	positive
macht	negative
madrid	negative
magazin	positive
mai	negative
mail	positive
mails	negative
main	negative
mainz	positive
make	positive
mal	positive
mama	positive
man	negative
management	negative
manager	negative
manche	negative
manchmal	negative
mangelhaft	negative
mann	positive
mannheim	positive
mannschaft	negative
marathon	negative
mario	positive
mark	negative
marke	negative
marketing	positive
markt	negative
martin	negative
mathe	negative
max	positive
mb	positive
me	negative
media	negative
medium	negative
meer	positive
mega	negative
mehr	negative
mehrere	negative
mein	positive
meinen	negative
meinung	negative
meist	negative
meiste	positive
meister	positive
melden	positive
menge	negative
mensch	negative
menschen	negative
mercedes	negative
merkel	negative
merken	negative
messe	negative
met	negative
mi	positive
michael	positive
microsoft	negative
milliarde	negative
million	negative
min	negative
minderwertig	negative
mindestens	negative
minecraft	negative
mini	positive
minute	negative
mio	negative
mir	negative
mission	negative
misslich	negative
mist	negative
mit	negative
mitarbeiter	negative
mitglied	negative
mitmachen	positive
mittag	positive
mitte	negative
mittlerweile	negative
mittwoch	positive
mm	negative
mobil	negative
mode	negative
modell	negative
modern	positive
moin	positive
moment	positive
momentan	negative
monat	negative
monster	negative
montag	positive
morgen	positive
morgens	positive
mund	negative
museum	positive
music	positive
musik	positive
musikwunsch	negative
muss	positive
mutter	negative
my	negative
mädchen	negative
mädel	positive
märz	negative
mögen	positive
möglich	negative
möglichkeit	negative
müde	negative
müller	negative
münchen	positive
müssen	positive
n	negative
na	positive
nach	negative
nachbar	positive
nachdem	negative
nachdenken	positive
nachher	positive
nachmittag	positive
nachrangig	negative
nachricht	negative
nachrichten	negative
nacht	negative
nachts	negative
nackt	negative
nah	negative
nahrungseinheiten	positive
naja	negative
name	negative
nase	negative
natur	negative
natürlich	positive
nazi	negative
neben	negative
nee	negative
negativ	negative
nehmen	negative
nein	negative
nem	positive
nen	negative
nennen	negative
ner	negative
nerven	negative
nett	positive
netz	negative
netzwerk	negative
neu	negative
neue	positive
new	positive
news	positive
ni	negative
nice	positive
nicht	negative
nichts	negative
nie	negative
niemals	negative
niemand	negative
night	positive
no	negative
noch	negative
nochmal	positive
nord	negative
nordkorea	negative
normal	positive
not	negative
now	negative
nowplaying	negative
nr.	negative
nrw	negative
nsu	negative
nu	positive
nummer	negative
nun	positive
nur	negative
nutzen	negative
nähe	positive
nämlich	negative
nö	negative
nürnberg	negative
o	negative
ob	positive
obama	negative
oben	positive
obwohl	negative
och	negative
oder	negative
of	positive
off	negative
offen	positive
offenbar	negative
offiziell	negative
oft	negative
oh	negative
ohne	negative
ohr	negative
ok	positive
okay	negative
okru	negative
oma	positive
omg	negative
on	positive
one	positive
online	negative
oo	negative
op	negative
open	negative
opfer	negative
ordentlich	positive
original	positive
ort	negative
ostern	positive
ostsee	negative
ots	negative
out	negative
outlet	positive
p	positive
p.	positive
paar	positive
packen	negative
paket	negative
papa	positive
paradise	positive
paris	negative
park	positive
part	negative
partei	negative
partner	positive
party	positive
passen	positive
passend	positive
passieren	negative
paul	negative
pause	positive
pc	negative
peene	negative
pegel	negative
pegelmv	positive
peinlich	negative
penis	negative
pennen	negative
per	positive
perfekt	positive
person	negative
persönlich	negative
peter	positive
pferd	positive
photo	negative
pi	positive
pirat	negative
pizza	positive
plan	positive
planen	negative
platz	negative
play	positive
plus	negative
plötzlich	negative
pm	negative
pol	negative
politik	negative
politiker	negative
politisch	negative
polizei	negative
pool	positive
porno	negative
portal	negative
positiv	positive
post	negative
pr	negative
praktisch	positive
praxis	negative
preis	negative
presse	negative
pressemitteilung	negative
privat	positive
pro	positive
probieren	positive
problem	negative
produkt	negative
profi	positive
profil	negative
programm	negative
projekt	negative
protest	negative
prozent	negative
prozess	negative
präsentieren	negative
präsident	negative
prüfung	positive
ps	positive
punkt	positive
pur	negative
putzen	positive
pvp	positive
q	positive
qualität	negative
que	positive
quoka	positive
r	positive
rabatt	negative
radio	negative
ram	negative
random	negative
rauchen	positive
raum	positive
raus	negative
re	positive
reaktion	negative
real	positive
rechnen	negative
recht	negative
red	positive
reden	negative
reduzieren	negative
rege	negative
regen	positive
regierung	negative
region	negative
regnen	positive
reich	negative
reichen	negative
reif	positive
reihe	negative
rein	negative
reise	positive
reisen	positive
rennen	positive
respekt	negative
rest	positive
retten	negative
retweeten	positive
rezept	positive
rhein	negative
richtig	positive
richtung	negative
riechen	negative
riesig	negative
robbe	negative
rock	negative
rolle	negative
roman	negative
rot	negative
rt	positive
rtl	negative
rufen	positive
ruhe	positive
ruhig	positive
rum	negative
rund	negative
runde	positive
runtastic	negative
runter	negative
ryck	negative
rücken	negative
s	positive
s.	positive
s21	negative
sa	negative
sache	negative
sachsen	negative
sagen	positive
saison	negative
sammeln	positive
samstag	positive
samsung	negative
satz	positive
sau	negative
sauber	positive
sc	negative
schade	negative
schaden	negative
schaffen	negative
schalk	negative
scharf	negative
schatz	positive
schau	positive
schauen	positive
scheinen	negative
scheitern	negative
scheiße	negative
scheißen	negative
schenken	positive
scheußlich	negative
schick	positive
schicken	positive
schießen	negative
schlaf	positive
schlafen	positive
schlagen	negative
schlager	positive
schlecht	negative
schließen	negative
schlimm	negative
schluss	negative
schmecken	negative
schmerz	negative
schnee	positive
schnell	positive
schnäppchen	positive
schokolade	positive
schon	positive
schonmal	positive
school	negative
schreiben	positive
schreien	positive
schritt	negative
schufa	negative
schuh	negative
schuld	negative
schule	negative
schulen	negative
schwach	negative
schwanz	negative
schwarz	negative
schweinsteiger	negative
schweiz	negative
schweizer	negative
schwer	negative
schwester	negative
schwierig	negative
schwimmen	positive
schwul	negative
schädlich	negative
schön	positive
schöne	positive
schüler	negative
schützen	negative
se	negative
sechs	negative
see	negative
seele	positive
seh	negative
sehen	negative
sehr	positive
sein	negative
seit	negative
seite	negative
sekunde	negative
selber	negative
selbst	negative
selten	negative
seminar	negative
senden	positive
sendung	negative
seo	negative
serie	negative
seriös	positive
server	negative
service	positive
set	positive
setzen	negative
sex	positive
sexy	positive
shirt	positive
shit	negative
shop	positive
show	positive
si	negative
sich	negative
sicher	positive
sicherheit	negative
sichern	negative
sie	negative
sieben	negative
sieg	negative
siegen	negative
sie|sie	positive
singen	negative
single	positive
sinn	negative
sinnvoll	negative
situation	negative
sitzen	positive
sky	negative
skype	positive
smartphone	negative
smartphones	negative
sms	positive
so	negative
social	negative
soeben	negative
sofort	positive
software	negative
sogar	negative
sohn	negative
solange	negative
solche	negative
sollen	positive
sommer	positive
sondern	negative
song	positive
sonne	positive
sonnig	positive
sonntag	positive
sonst	negative
sony	negative
soo	negative
sooo	negative
sorgen	negative
sorry	negative
soviele	negative
sowas	negative
soweit	positive
sowie	negative
sowieso	negative
sozial	negative
spanien	negative
spanisch	negative
spannen	negative
spannend	positive
sparen	negative
spaß	positive
spd	negative
special	positive
sperren	negative
spiegel	negative
spiegeln	negative
spiel	negative
spielen	negative
spieler	negative
sport	positive
sprache	negative
sprechen	negative
springen	positive
spruch	positive
spät	negative
st	negative
st.	negative
staat	negative
stadion	negative
stadt	negative
staffel	negative
stand	negative
star	positive
stardoll	negative
stark	negative
start	positive
starten	negative
statt	negative
stau	negative
stecken	negative
stehen	negative
steigen	negative
stein	positive
steinbrück	negative
stelle	positive
stellen	negative
stellenangebot	negative
sterben	negative
stern	negative
steuer	negative
still	positive
stimme	negative
stimmen	negative
stimmung	positive
stockend	negative
stolz	positive
stoppen	negative
store	negative
story	negative
straße	negative
stream	negative
streit	negative
stress	positive
strom	negative
student	positive
studie	negative
studio	negative
stunde	negative
stunden	negative
stunde|stunden	negative
stuttgart	negative
ständig	negative
stören	negative
stück	negative
suche	positive
suchen	positive
suite	positive
super	positive
support	positive
syrien	negative
system	negative
sü	negative
süß	positive
t	negative
tablet	negative
tag	positive
tagen	positive
tanzen	positive
tarif	negative
tasche	negative
tatort	negative
tatsächlich	negative
team	positive
technik	positive
technisch	negative
tee	positive
teil	negative
teilen	positive
telefon	positive
telekom	negative
telmi	negative
temp	negative
temperatur	positive
tendenz	negative
termin	positive
test	negative
testen	positive
teuer	negative
text	negative
thatcher	negative
the	positive
thema	negative
this	negative
thomas	negative
ticket	positive
tief	positive
tier	negative
timeline	negative
tip	negative
tisch	positive
titel	positive
titten	positive
tja	negative
tl	positive
to	positive
tochter	positive
tod	negative
toll	positive
tom	positive
ton	negative
top	positive
topthemen	negative
tor	negative
tot	negative
total	negative
tote	negative
tour	positive
tragen	positive
trailer	negative
trainer	negative
training	positive
trauen	negative
traum	positive
traurig	negative
treffen	positive
treiben	negative
trend	negative
treten	negative
tribez	negative
trinken	positive
trotz	negative
trotzdem	positive
träumen	positive
tumblr	positive
tun	negative
tv	negative
tweet	positive
tweets	positive
twitter	positive
twittern	positive
typ	negative
täglich	negative
töten	negative
türe	positive
türkisch	negative
u	negative
uhr	positive
uli	negative
um	negative
umfrage	negative
un	positive
unangenehm	negative
unbedingt	positive
und	negative
unerfreulich	negative
unfall	negative
unglaublich	negative
unglücklich	negative
ungünstig	negative
uni	negative
unrecht	negative
unser	negative
unten	negative
unter	negative
unterlegen	negative
unternehmen	negative
unterschied	negative
unterstützen	negative
unterstützung	positive
unterwegs	positive
up	positive
update	negative
uptime	negative
urlaub	positive
us	negative
usa	negative
user	negative
v	negative
van	negative
vater	negative
veranstaltung	negative
verbieten	negative
verdammen	negative
verdammt	negative
verdienen	negative
verdorben	negative
verein	negative
verfügbar	negative
vergessen	negative
vergleich	negative
vergleichen	negative
verkauf	negative
verkaufen	positive
verkehr	negative
verkehrsunfall	negative
verlassen	positive
verletzen	negative
verlieben	negative
verlieren	negative
vermissen	positive
vermutlich	negative
verpassen	negative
verrückt	positive
verschieden	negative
version	positive
versprechen	negative
verstehen	negative
versuch	positive
versuchen	positive
vertrag	negative
vertrauen	negative
verwenden	negative
verändern	negative
veröffentlichen	negative
via	negative
video	positive
viel	negative
viele	positive
vielleicht	positive
vier	positive
vllt	positive
vo	negative
vogel	negative
voll	negative
vollendet.	positive
von	negative
vor	negative
vorbei	positive
vorher	negative
vorm	positive
vorne	negative
vorstellen	negative
vorteil	positive
vortrag	negative
vs.	negative
vw	negative
völlig	negative
w	positive
wa	positive
wach	positive
wachsen	negative
wagen	negative
wahl	negative
wahnsinn	negative
wahr	negative
wahrheit	negative
wahrscheinlich	negative
wald	negative
wand	negative
wann	positive
warm	negative
warnen	negative
wars	negative
warten	positive
warum	negative
was	positive
wasser	negative
wat	negative
we	positive
web	negative
webseite	negative
website	negative
webverzeichnis	negative
wechsel	negative
wechseln	negative
weder	negative
weg	negative
wegen	negative
weh	negative
weil	negative
wein	positive
weinen	negative
weisen	negative
weit	negative
weiter	positive
weiterhin	negative
weiß	positive
weißen	negative
welche	positive
welt	negative
weltweit	negative
wenige	negative
weniger	negative
wenigstens	positive
wenn	negative
wenns	negative
wer	positive
werbung	negative
werd	positive
werden	negative
werder	negative
werfen	negative
wert	negative
west	negative
westfalen	negative
wetter	positive
what	negative
whatsapp	positive
wichtig	negative
widerlich	negative
widerwärtig	negative
wie	negative
wieder	positive
wien	negative
wieso	negative
wieviele	negative
wild	negative
willkommen	positive
wind	negative
windows	negative
winter	negative
wir	positive
wirken	negative
wirklich	negative
wirtschaft	negative
wissen	negative
with	positive
witz	negative
witzig	negative
wlan	positive
wo	negative
wobei	negative
woche	negative
wochenende	positive
woher	negative
wohl	positive
wohnen	positive
wohnung	positive
wolfsburg	negative
wollen	positive
wordpress	positive
world	positive
wort	negative
worteausderkindheit	negative
wow	positive
wtf	negative
wunder	negative
wunderbar	positive
wundern	negative
wunderschön	positive
wunsch	positive
wählen	negative
während	positive
wär	negative
wünschen	positive
würd	positive
württemberg	negative
x	positive
xbox	negative
xx	negative
y	positive
ya	positive
yay	positive
yeah	positive
york	negative
you	negative
your	negative
youtube	negative
z	negative
z.	negative
zahl	negative
zahlen	negative
zdf	negative
zehn	negative
zeichen	negative
zeichnen	positive
zeigen	negative
zeihen|ziehen	negative
zeit	positive
zeitung	negative
zerstören	negative
zeuge	negative
ziehen	negative
ziel	negative
ziemlich	negative
zimmer	positive
zitat	negative
zoll	negative
zu	negative
zubehör	negative
zuerst	negative
zufrieden	positive
zug	negative
zuhause	positive
zukunft	negative
zumindest	negative
zurück	positive
zusammen	positive
zustand	negative
zwar	negative
zwei	positive
zweit	positive
zwischen	negative
zypern	negative
zählen	negative
zürich	negative
|	positive
~	positive
°	negative
°c	negative
ähnlich	negative
ändern	negative
öffentlich	negative
öffnen	positive
österreich	negative
übel	negative
üben	negative
über	negative
überall	negative
überhaupt	negative
überlegen	positive
übernehmen	negative
überragend	positive
übersicht	negative
übrigens	positive
★	negative
♡	positive
♥	positive
❤	positive
