!	positive
"	negative
%link	negative
%negsmiley	negative
%possmiley	positive
%user	positive
%user-video	negative
&amp;	positive
&gt;	negative
'	negative
(	negative
)	negative
*	negative
+	negative
,	positive
-	negative
.	negative
..	negative
...	positive
/	negative
1	negative
2	negative
3	positive
4	positive
5	positive
:	negative
;	negative
</s>	negative
?	negative
@card@	negative
[	negative
]	negative
a	positive
ab	negative
aber	negative
alle	positive
als	negative
also	negative
alt	positive
an	positive
andere	negative
android	negative
androidgames	positive
angenehm	positive
arm	negative
armselig	negative
auch	negative
auf	negative
aus	negative
ausgezeichnet	positive
bedauernswert	negative
bei	negative
bekommen	positive
berlin	positive
besser	positive
bewerten	negative
bild	positive
bis	positive
brauchen	negative
böse	negative
cm	negative
da	negative
dank	positive
dann	positive
dass	negative
dein	positive
denken	negative
denn	negative
deutsch	negative
deutschland	negative
die	negative
dies	positive
doch	negative
du	positive
durch	negative
dürftig	negative
echt	negative
eigentlich	negative
eine	positive
einfach	negative
ekelerregend	negative
ekelhaft	negative
ekelig	negative
er	negative
ernten	negative
erst	negative
es	positive
essen	positive
euro	negative
facebook	negative
falsch	negative
fies	negative
finden	positive
foto	positive
frau	negative
freuen	positive
freundlich	positive
für	negative
gameinsight	negative
ganz	positive
geben	negative
gegen	negative
gehen	positive
geil	positive
geld	negative
gemein	negative
gepostet	negative
gerade	negative
geringwertig	negative
glauben	positive
gleich	negative
glücklich	positive
goldmünze	positive
groß	negative
gut	positive
haben	positive
heute	positive
hier	positive
hässlich	negative
höherwertig	positive
hübsch	positive
i	negative
ich	positive
ihr	positive
immer	negative
in	negative
ipad	negative
ipadgames	negative
iphone	negative
irrig	negative
ja	negative
jahr	negative
jede	positive
jetzt	positive
keine	negative
kennen	positive
klein	positive
kommen	positive
korrekt	positive
können	positive
lassen	negative
leben	negative
leute	negative
lieb	positive
lieben	positive
m	negative
machen	positive
mal	positive
man	negative
mangelhaft	negative
mann	positive
mehr	negative
mein	positive
mensch	negative
minderwertig	negative
mission	negative
misslich	negative
mit	negative
morgen	positive
mögen	positive
müssen	positive
nach	negative
nachrangig	negative
nacht	negative
nah	negative
nahrungseinheiten	positive
negativ	negative
nein	negative
nett	positive
neu	negative
nicht	negative
nichts	negative
nie	negative
noch	negative
nur	negative
ob	positive
oder	negative
oh	negative
ohne	negative
online	negative
positiv	positive
richtig	positive
s	positive
sagen	positive
sammeln	positive
schauen	positive
scheußlich	negative
schlecht	negative
schlimm	negative
schon	positive
schreiben	positive
schwach	negative
schädlich	negative
schön	positive
sehen	negative
sehr	positive
sein	negative
sich	negative
sie	negative
sie|sie	positive
so	negative
sollen	positive
spiel	negative
stehen	negative
suchen	positive
tag	positive
tendenz	negative
the	positive
toll	positive
tribez	negative
tun	negative
twitter	positive
uhr	positive
um	negative
unangenehm	negative
und	negative
unerfreulich	negative
unglücklich	negative
ungünstig	negative
unrecht	negative
unser	negative
unter	negative
unterlegen	negative
verdorben	negative
via	negative
video	positive
viele	positive
voll	negative
von	negative
vor	negative
warum	negative
was	positive
weg	negative
weil	negative
welt	negative
wenn	negative
wer	positive
werden	negative
widerlich	negative
widerwärtig	negative
wie	negative
wieder	positive
wir	positive
wissen	negative
wo	negative
woche	negative
wohl	positive
wollen	positive
zeit	positive
zu	negative
zwei	positive
|	positive
übel	negative
über	negative
überlegen	positive
überragend	positive
