!	positive
!...	positive
"	negative
#	positive
#eldena	negative
#pöl	negative
#wieck	negative
$	positive
%	negative
%ironicsmiley	positive
%link	negative
%mail	positive
%negsmiley	negative
%negsmileyen	negative
%possmiley	positive
%possmiley3	positive
%possmiley33	positive
%possmileye	negative
%possmileyie	negative
%smiley	negative
%user	positive
%user-playlist	negative
%user-video	negative
&	positive
&amp;	positive
&gt;	negative
&lt;	negative
'	negative
(	negative
(8	negative
)	negative
):	negative
);	negative
*	negative
**	positive
***	positive
*-*	positive
+	negative
,	positive
-	negative
.	negative
..	negative
..!	positive
...	positive
...!	positive
....	negative
......	negative
...?	positive
._.	negative
/	negative
0:0	negative
1	negative
1,5	negative
1/2	positive
10	negative
100	negative
11	negative
12	negative
13	negative
14	negative
15	positive
16	negative
17	negative
18	positive
19	positive
1:0	negative
1:1	negative
1d_	positive
2	negative
2-	negative
2/2	negative
20	negative
200	positive
20]_	positive
21	positive
22	positive
22]_	positive
23]_	negative
24	positive
24]_	negative
25	positive
25]_	negative
28]_	negative
2:0	negative
2:1	negative
2x_	positive
3	positive
3-	positive
30	negative
30]_	negative
32]_	negative
33]_	negative
35]_	negative
36]_	negative
37]_	negative
38]_	negative
39]_	negative
3:0	negative
3:2	negative
3d_	positive
4	positive
40	positive
40]_	negative
41]_	negative
43]_	negative
46]_	negative
47]_	negative
48]_	negative
49]_	negative
5	positive
50	negative
500	positive
6	negative
60	negative
7	positive
70	negative
8	negative
80	negative
9	negative
90	negative
:	negative
:'(	negative
:'d	negative
:(	negative
::	negative
:p	negative
;	negative
</s>	negative
=	negative
?	negative
?!	negative
?...	positive
??	negative
???	negative
????	negative
@	positive
@card@	negative
@youtube	positive
[	negative
\	positive
]	negative
]:	negative
^	positive
_	negative
`	positive
a	positive
a.	negative
a1	positive
aachen	negative
ab	negative
abend	positive
abends	positive
abenteuer	positive
aber	negative
abgeben	negative
abgefahren	negative
abgeordnete	negative
abgeschlossen.	positive
abholen	positive
abi	positive
abnehmen	positive
abo	negative
abonennten	positive
about	positive
abschaffen	negative
abschied	negative
abschließen	negative
abschluss	positive
absolut	negative
absolvieren	negative
abstimmen	negative
abstimmung	negative
account	negative
accounts	negative
ach	negative
achja	positive
achso	negative
acht	negative
achten	negative
achtung	negative
action	negative
ad	negative
adidas	negative
adresse	positive
afd	negative
affe	negative
affäre	negative
afghanistan	negative
afrika	negative
ag	negative
again	negative
agentur	negative
aggressiv	negative
ah	negative
aha	negative
ahh	positive
ahnung	negative
ai	negative
air	positive
airport	positive
akku	negative
aktie	negative
aktion	negative
aktiv	negative
aktualisieren	negative
aktualisiert	negative
aktuell	negative
aku	negative
akzeptieren	negative
al	negative
alaba	negative
album	positive
aldi	negative
alex	positive
alexander	negative
alkohol	positive
all	negative
alle	positive
allein	negative
alleine	positive
aller	negative
allerdings	negative
allgemein	negative
alltag	negative
als	negative
also	negative
alt	positive
alter	negative
alternativ	positive
alternative	negative
althagen	negative
am	positive
amanda	negative
amateur	positive
amazon	negative
amerika	negative
amerikanisch	negative
amsterdam	positive
amt	negative
an	positive
analyse	negative
anbieten	positive
anbieter	negative
and	positive
andere	negative
anders	negative
andrea	negative
andreas	positive
android	negative
androidgames	positive
anfang	negative
anfangen	negative
anfrage	negative
angeblich	negative
angebot	negative
angebotsende	negative
angehen	negative
angela	negative
angenehm	positive
angriff	negative
angst	negative
angucken	negative
anhalt	negative
anhänger	negative
anhören	negative
anime	negative
anklam	negative
ankommen	positive
ankündigen	negative
anlage	negative
anlass	negative
anleger	negative
anleitung	positive
anmelden	positive
anmeldung	negative
anna	positive
anne	positive
annehmen	negative
anonym	negative
anonymous	negative
anruf	negative
anrufen	positive
ans	positive
anschauen	positive
anscheinend	negative
anschlag	negative
anschluss	negative
ansehen	negative
ansonsten	positive
ansprechen	positive
anspruch	negative
anstatt	positive
anstrengend	positive
anti	negative
antrag	negative
antwort	negative
antworten	positive
antwort|antworten	negative
anwalt	negative
anzeige	negative
anzeigen	negative
anzeiger	positive
anzeige|anzeigen	negative
anziehen	positive
ap	negative
apa	negative
apfel	negative
app	negative
appen	negative
apple	negative
apps	negative
apr	negative
april	negative
aprilscherz	negative
arbeit	positive
arbeiten	positive
arbeitgeber	negative
arbeitsplatz	negative
arbeit|arbeiten	positive
ard	negative
are	positive
arena	negative
arg	negative
argument	negative
arm	negative
armselig	negative
armut	negative
arm|arme	negative
around	positive
arsch	negative
arschloch	negative
art	negative
artikel	negative
arzt	negative
as	positive
at	negative
atmen	positive
attacke	negative
attraktiv	positive
au	negative
auch	negative
audi	positive
audio	positive
auf	negative
aufbau	positive
aufbauen	negative
auffallen	negative
aufgabe	negative
aufgeben	negative
aufgrund	negative
aufhören	negative
auflösung	negative
aufm	positive
aufmerksamkeit	negative
aufnahme	negative
aufnehmen	positive
aufpassen	negative
aufregen	negative
aufruf	negative
aufräumen	positive
aufs	positive
aufstehen	positive
aufstieg	negative
auftauchen	negative
auftrag	negative
auftritt	positive
aufwachen	positive
auge	positive
augsburg	negative
august	negative
auktion	negative
aus	negative
ausbildung	positive
ausgabe	negative
ausgeben	negative
ausgehen	negative
ausgezeichnet	positive
ausland	negative
ausprobieren	positive
aussage	negative
ausschlafen	positive
aussehen	negative
aussicht	positive
ausstellung	negative
australien	negative
austria	positive
ausverkaufen	negative
auswahl	negative
auto	positive
autobahn	negative
autofahrer	negative
automatisch	negative
autor	negative
außer	negative
außerdem	negative
ava	positive
award	positive
awesome	negative
aww	positive
awww	positive
b	negative
b.	negative
ba	positive
baby	positive
backen	positive
bad	positive
baden	negative
badewanne	negative
bahn	positive
bahnbilderde	negative
bahnhof	negative
bald	positive
balkon	positive
ball	negative
banane	negative
band	negative
bangen	negative
bank	negative
bankgeheimnis	negative
bar	negative
barca	negative
barcelona	negative
barhöft	negative
bart	negative
barth	negative
basel	negative
basis	negative
basketball	positive
basteln	positive
batman	positive
battlefield	negative
bau	negative
bauarbeit	negative
bauch	negative
bauen	negative
bauer	negative
baum	negative
baustelle	negative
bayer	negative
bayerisch	negative
bayern	negative
bayreuth	positive
bb	negative
bda	negative
bdk13	negative
be	negative
beach	negative
beachten	negative
beantworten	positive
beat	positive
beauty	positive
bedanken	positive
bedauernswert	negative
bedeuten	negative
bedeutung	negative
beenden	negative
befinden	negative
befürchten	negative
begeistern	positive
beginn	negative
beginnen	positive
begleiten	positive
begriff	negative
begrüßen	positive
behalten	negative
behandeln	negative
behaupten	negative
behörde	negative
bei	negative
beide	positive
beileid	negative
bein	negative
beispiel	negative
beitrag	negative
beißen	negative
bekannt	negative
bekennen	negative
bekommen	positive
beleidigen	negative
beliebt	negative
belohnung	positive
bemerken	negative
ben	negative
benutzen	negative
benötigen	negative
beobachten	negative
bequem	positive
ber	negative
berater	negative
beratung	negative
bereich	negative
bereit	negative
bereiten	negative
bereits	negative
berg	negative
bericht	negative
berichten	negative
berlin	positive
berliner	negative
bern	negative
beruf	negative
beruflich	positive
beruhigen	positive
berühmt	negative
berühren	positive
bescheid	positive
bescheuert	negative
beschissen	negative
beschließen	negative
beschreiben	negative
beschweren	negative
beschäftigen	negative
besitzen	negative
besonder	positive
besonders	positive
besorgen	positive
besser	positive
besserung	negative
bestandsdatenauskunft	negative
beste	positive
bestehen	negative
bestehend	negative
bestellen	positive
bestellung	negative
bestimmen	negative
bestimmt	negative
bestseller	negative
bestätigen	negative
besuch	positive
besuchen	positive
besucher	negative
beta	negative
betrachten	negative
betreffen	negative
betreiben	negative
betrieb	negative
betrinken	positive
bett	positive
bevor	positive
bewegen	negative
bewegung	negative
beweis	negative
beweisen	negative
bewerben	positive
bewerbung	positive
bewerten	negative
bewertung	negative
bewusst	negative
bewölken	negative
bezahlen	positive
bezeichnen	negative
beziehen	negative
beziehung	negative
bezirk	negative
bgh.	negative
bi	positive
bieber	negative
bielefeld	negative
biene	negative
bier	positive
bieten	negative
big	negative
bike	positive
bild	positive
bilden	negative
bildung	negative
bill	positive
billig	negative
bin	negative
binden	positive
bio	negative
bioshock	positive
birthday	negative
bis	positive
bisher	negative
bislang	negative
bisschen	positive
bitch	negative
bitches	negative
bitcoin	negative
bitte	positive
bitten	positive
bitter	negative
bl	negative
bla	negative
black	negative
blackberry	negative
blasen	positive
blatt	negative
blau	negative
bleiben	negative
blick	negative
blicken	negative
blind	negative
block	negative
blocken	negative
blog	negative
blogger	positive
blogs	negative
blond	positive
bloß	negative
blu	negative
blue	positive
blume	positive
blut	negative
blöd	negative
bmw	negative
bo	negative
boah	negative
boateng	negative
bochum	negative
bock	positive
bocken	negative
boden	negative
body	negative
bombe	negative
bombe|bomben	negative
bon	positive
bond	negative
bonität	negative
bonn	negative
book	negative
boot	negative
borussia	negative
bosch	positive
boss	negative
boston	negative
bostonmarathon	negative
bot	negative
botschaft	negative
box	negative
boy	negative
br	negative
branche	negative
brand	negative
brandenburg	negative
brauch	positive
brauchen	negative
brauchen|gebrauchen	negative
braun	negative
braunschweig	positive
brav	positive
bravo	positive
breaking	negative
brechen	negative
breit	negative
bremen	negative
brennen	negative
brief	negative
brigitte	negative
brille	positive
bringen	negative
britisch	negative
bro	positive
brot	negative
browser	negative
browsergame	negative
bruder	negative
brust	positive
brötchen	positive
brücke	negative
btw	positive
buch	positive
buchen	positive
buchstabe	negative
buchtip	positive
bull	negative
bund	negative
bundesliga	negative
bundesregierung	negative
bundestag	negative
bundestagswahl	negative
bundeswehr	negative
bundesweit	negative
bunt	positive
burger	negative
bus	negative
bushido	negative
business	negative
but	negative
button	positive
buyten	negative
bvb	positive
bvbmcf	positive
bvbrmd	negative
by	negative
bye	positive
bzw	negative
bzw.	negative
bär	negative
börse	negative
böse	negative
bühne	negative
bürger	negative
büro	positive
c	negative
c.	negative
c1	positive
ca	positive
ca.	negative
café	positive
call	negative
cam	positive
can	positive
canon	negative
card	negative
cc	positive
cd	positive
cdu	negative
cent	negative
center	positive
cest	negative
ch	positive
champions	positive
chance	negative
chaos	negative
charakter	positive
charts	negative
chat	positive
check	positive
checken	positive
chef	negative
chelsea	negative
chemie	negative
chemnitz	negative
chf	negative
chillen	positive
china	negative
chinesisch	negative
chip	negative
chris	positive
christian	negative
christoph	positive
city	positive
cl	negative
claudia	positive
cloud	positive
club	positive
cm	negative
co	negative
co.	negative
coach	positive
coaching	positive
code	positive
cola	negative
com	negative
come	positive
comeback	negative
comic	positive
commerce	negative
community	positive
computer	negative
cont	positive
content	negative
cool	positive
couch	positive
cover	positive
cpu	negative
cro	positive
csr	negative
csu	negative
cup	positive
d	negative
d.	negative
d:	negative
da	negative
dabei	positive
dach	positive
dadurch	negative
dafür	positive
dagegen	negative
daheim	positive
daher	positive
dahin	positive
daily	negative
damals	negative
dame	positive
damit	positive
dan	positive
danach	positive
dance	positive
daniel	negative
dank	positive
danke	positive
danken	positive
dankeschön	positive
dann	positive
dante	negative
daran	positive
darauf	positive
daraus	negative
darin	negative
dark	negative
darlehen	positive
darmstadt	positive
darum	negative
darüber	negative
das	negative
dass	negative
dat	negative
date	positive
datei	negative
datenschutz	negative
datum	negative
dauer	negative
dauerhaft	negative
dauern	negative
dauernd	negative
daumen	positive
david	negative
davon	negative
davor	negative
dax	negative
day	positive
days	negative
dazu	negative
db	negative
ddr	negative
de	negative
dead	negative
deal	positive
debatte	negative
decke	positive
decken	negative
defekt	negative
definitiv	negative
deh	negative
dein	positive
del	negative
demi	positive
demnächst	positive
demo	negative
demokratie	negative
denken	negative
denken|gedenken	negative
denn	negative
dennoch	positive
depression	negative
der	negative
derby	negative
derzeit	negative
deshalb	negative
design	positive
designer	positive
desktop	positive
desto	negative
deswegen	negative
detail	negative
deutlich	negative
deutsch	negative
deutsche	negative
deutschland	negative
dey	negative
dfb	negative
di	negative
dia	negative
dialog	negative
dicht	negative
dick	positive
die	negative
dienen	negative
dienst	negative
dienstag	positive
dies	positive
diese	positive
diesmal	negative
dieter	negative
digital	negative
dildo	negative
ding	negative
dingen	negative
direction	positive
direkt	negative
dirk	negative
diskussion	negative
diskutieren	negative
disney	positive
display	negative
diät	negative
dj	positive
dm	positive
do	positive
doch	negative
doktor	negative
doku	negative
doll	negative
dollar	negative
domian	negative
don	negative
donau	negative
done	negative
dong	negative
donnerstag	positive
doof	negative
doppelt	negative
dorf	negative
dort	positive
dortmund	positive
down	negative
download	negative
dpa	negative
dr	negative
dr.	negative
drama	negative
dran	negative
drauf	negative
draußen	positive
dreck	negative
drehen	positive
drei	negative
dresden	negative
drin	negative
dringend	positive
dritt	negative
droge	negative
drohen	negative
dropbox	positive
drosselkom	negative
drosseln	negative
drosselung	negative
druck	negative
drucken	negative
drucker	negative
drum	positive
drüber	positive
drücken	negative
dsds	positive
dsl	negative
dtn	negative
du	positive
dubai	negative
duell	negative
duisburg	negative
dumm	negative
dummheit	negative
dunkel	negative
durch	negative
durchaus	negative
durchs	positive
dus	positive
dusche	positive
duschen	positive
dvd	positive
dämlich	negative
döner	positive
dünn	negative
dürfen	positive
dürftig	negative
düsseldorf	negative
e	negative
e.	negative
easy	positive
ebay	negative
eben	positive
ebenfalls	positive
ebenso	negative
ebook	negative
ebooks	negative
echt	negative
echteliebe	positive
ecke	negative
edel	positive
edition	positive
effekt	negative
effektiv	negative
effzeh	positive
eftn	negative
egal	negative
eh	negative
ehe	negative
ehemalig	negative
eher	negative
ehren	positive
ehrlich	positive
ei	negative
eig	negative
eigen	negative
eigentlich	negative
eilen	negative
ein	negative
eindeutig	negative
eindruck	positive
eine	positive
einen	positive
einer	negative
einfach	negative
einfallen	negative
einführung	negative
eingeben	positive
einige	negative
einkauf	positive
einkaufen	positive
einladen	positive
einladung	positive
einmal	positive
eins	negative
einsam	positive
einsatz	negative
einschalten	positive
einschlafen	negative
einsetzen	negative
einstellen	negative
einstellung	negative
eintracht	negative
eintrag	negative
einzeln	negative
einzig	negative
einzigartig	positive
eis	negative
eisbär	negative
eishockey	negative
ekelerregend	negative
ekelhaft	negative
ekelig	negative
el	positive
elf	negative
elite	negative
eltern	positive
em	negative
email	positive
empfangen	negative
empfehlen	positive
empfehlung	positive
en	positive
end	negative
ende	negative
enden	positive
endgültig	negative
endlich	positive
energie	negative
energiewende	negative
eng	negative
engel	positive
england	negative
englisch	negative
entdecken	negative
entfernen	negative
entfolgt	positive
entgegen	negative
enthalten	negative
entscheiden	negative
entscheidung	negative
entschuldigen	negative
entschuldigung	negative
entspannen	positive
entspannt	positive
entstehen	negative
enttäuschen	negative
enttäuscht	negative
entweder	negative
entwickeln	negative
entwickler	negative
entwicklung	negative
ep	negative
episode	negative
er	negative
erdbeben	negative
erde	negative
erfahren	positive
erfahrung	negative
erfinden	negative
erfolg	negative
erfolgreich	positive
erfurt	positive
erfüllen	positive
ergeben	negative
ergebnis	negative
erhalten	negative
erhältlich	negative
erhöhen	negative
erinnern	negative
erinnerung	negative
erkennen	negative
erkenntnis	negative
erklären	negative
erklärung	negative
erlauben	negative
erleben	positive
erledigen	negative
ermitteln	negative
ermittlung	negative
ermöglichen	negative
erneut	negative
ernst	negative
ernsthaft	negative
ernten	negative
ernährung	negative
erotik	positive
erotisch	positive
erreichen	negative
erscheinen	negative
erschießen	negative
ersetzen	negative
erst	negative
erstaunlich	negative
erste	negative
erstellen	negative
erstmal	positive
erstmals	positive
ertragen	negative
erwachsen	positive
erwarten	negative
erweitern	negative
erwin	positive
erwischen	negative
erwähnen	negative
erwünscht	positive
erzielen	negative
erzählen	positive
eröffnen	positive
eröffnung	positive
es	positive
escort	positive
essen	positive
et	positive
etc.	negative
etwa	negative
etwas	positive
eu	negative
euer	positive
eur	negative
euro	negative
europa	negative
europäisch	negative
even	negative
event	positive
events	negative
eventuell	positive
ever	positive
ewig	positive
ewm	negative
ex	negative
exklusiv	negative
experte	negative
explosion	negative
extern	negative
extra	positive
extrem	negative
ey	negative
ezb	negative
f	negative
f.	negative
f1	negative
fa	negative
face	negative
facebook	negative
facts	positive
fahren	positive
fahren|führen	negative
fahrer	negative
fahrrad	positive
fahrt	negative
fahrzeug	negative
fail	negative
fair	positive
fake	negative
fakt	negative
faktum	negative
fall	negative
fallen	negative
fallen|fällen	negative
fallen|gefallen	negative
falls	positive
falsch	negative
familie	positive
fan	positive
fangen	positive
fantastisch	positive
fantasy	negative
farbe	negative
fashion	positive
fassen	negative
fast	negative
faul	negative
favorit	negative
faz	negative
fb	negative
fbi	negative
fc	negative
fcb	negative
fcbayern	negative
fcbfcb	positive
fcbjuv	negative
fcbwob	negative
fcn	positive
fdp	negative
feat	negative
feedback	positive
feel	negative
fehlen	negative
fehlend	negative
fehler	negative
feier	positive
feierabend	positive
feiern	positive
feiertag	positive
fein	positive
feind	negative
feld	negative
fenster	positive
ferien	positive
fernsehen	negative
fernseher	negative
fertig	negative
fest	negative
festival	negative
festplatte	positive
feststellen	negative
fett	negative
feucht	positive
feuchte	positive
feuer	negative
feuern	positive
feuerwehr	negative
ff	positive
ffm	positive
fi	positive
ficken	negative
fies	negative
fifa	negative
figur	negative
film	negative
filmen	negative
final	positive
finale	negative
finanz	negative
finanziell	negative
finanzierung	negative
find	negative
finden	positive
finds	negative
finger	negative
finnland	negative
fire	negative
firefox	negative
firma	negative
first	positive
fisch	positive
fit	positive
fitness	positive
fix	positive
flasche	negative
flat	positive
flatrate	negative
fleisch	negative
fleißig	positive
flexibel	positive
fliegen	negative
flucht	negative
flug	positive
flughafen	negative
flugzeug	negative
focus	negative
folge	negative
folgen	positive
folgend	negative
follow	positive
follower	positive
followerpower	positive
food	positive
for	positive
ford	negative
fordern	negative
forderung	negative
forex	negative
form	negative
format	negative
formel	negative
forscher	negative
fortuna	negative
forum	negative
forward	positive
foto	positive
fotograf	positive
fotografieren	positive
fotze	negative
fr	positive
frage	positive
fragen	positive
frank	negative
frankfurt	negative
frankfurter	negative
frankreich	negative
franz	negative
französisch	negative
frau	negative
frauenquote	negative
frauentausch	negative
free	negative
frei	positive
freiburg	negative
freiheit	negative
freitag	positive
freiwillig	positive
freizeit	positive
fremd	negative
fressen	negative
freude	positive
freuen	positive
freund	positive
freunden	positive
freundin	positive
freundlich	positive
freundschaft	positive
frieden	negative
friedrich	negative
friends	negative
frisch	positive
friseur	positive
frisur	positive
fritz	positive
froh	positive
from	negative
fröhlich	positive
früh	negative
früher	negative
frühling	positive
frühstück	positive
frühstücken	positive
fuck	negative
fucking	negative
full	positive
fun	positive
funktion	negative
funktionieren	negative
fur	positive
furchtbar	negative
fussball	positive
fuß	negative
fußball	negative
fähig	negative
fähre	negative
fällen	positive
fördern	negative
fü	positive
fühlen	negative
führen	negative
führung	negative
führungskraft	negative
füllen	negative
fünf	negative
für	negative
fürchten	negative
fürs	positive
fürth	negative
g	negative
g.	negative
ga	negative
gaat	negative
gabriel	negative
gak	positive
gala	positive
galaxy	positive
galerie	negative
gambling	negative
game	positive
gameinsight	negative
gameplay	positive
games	negative
gang	negative
ganz	positive
gar	negative
garantie	negative
garantieren	negative
garnicht	negative
garten	positive
gas	negative
gast	negative
gay	negative
gb	negative
ge	positive
geb	positive
geben	negative
gebiet	negative
gebloggt	negative
gebot	negative
gebrauchen	negative
gebraucht	negative
geburtstag	positive
gebären	negative
gebäude	negative
gedanke	positive
gefahr	negative
gefallen	positive
gefecht	negative
gefährlich	negative
gefängnis	negative
gefühl	positive
gegen	negative
gegenseitig	positive
gegenteil	negative
gegenüber	negative
gegner	negative
gehalt	negative
geheim	negative
geheimdiät	negative
geheimnis	negative
gehen	positive
gehirn	negative
gehn	positive
gehts	positive
geht’s	positive
gehören	negative
gehören|hören	negative
geil	positive
geist	negative
gelb	negative
geld	negative
gelegenheit	positive
gelingen	negative
gelten	negative
gemein	negative
gemeinde	negative
gemeinsam	positive
gemüse	positive
gemütlich	positive
gen	negative
genau	negative
genauso	negative
generation	negative
generell	negative
genial	positive
genießen	positive
gentleman	positive
genug	negative
georg	negative
george	negative
gepflegt	positive
geplant	negative
gepostet	negative
ger	negative
gerade	negative
gerechtigkeit	negative
gericht	negative
gering	negative
geringwertig	negative
german	negative
germany	negative
gern	positive
gerne	positive
gerät	negative
gerücht	negative
gesamt	negative
gesamtpaket	negative
geschehen	negative
geschenk	positive
geschichte	negative
geschlecht	negative
geschmack	negative
geschäft	negative
gesellschaft	negative
gesetz	negative
gesicht	negative
gespannt	positive
gespräch	positive
gestalten	positive
gestern	positive
gestrig	negative
gesucht	positive
gesund	positive
gesundheit	negative
get	positive
getwittert	negative
gewalt	negative
gewicht	negative
gewinn	negative
gewinnen	positive
gewinner	positive
gewinnspiel	positive
gewiss	negative
gewöhnen	negative
gg	negative
gibts	positive
girl	positive
girls	positive
gitarre	positive
gladbach	negative
glas	negative
glass	negative
glatt	positive
glaube	negative
glauben	positive
gleich	negative
gleichen	negative
gleichzeitig	positive
global	negative
glück	positive
glücken	positive
glücklich	positive
glückwunsch	positive
gmbh	positive
gntm	negative
go	positive
god	negative
goethe	negative
gold	negative
golden	negative
goldmünze	positive
golf	negative
gomez	negative
good	positive
google	negative
got	positive
gott	negative
gps	negative
gr	negative
gr.	negative
grafik	negative
grandios	positive
gratis	negative
gratulation	positive
gratulieren	positive
grau	positive
green	positive
greifen	negative
greifswald	negative
grenze	negative
griechenland	negative
griechisch	negative
grill	positive
grillen	positive
grinsen	positive
gronkh	positive
grosse	negative
group	positive
groß	negative
großartig	positive
grund	negative
grundsätzlich	negative
grund|gründen	negative
gruppe	negative
gruselig	negative
gruß	positive
größe	negative
grün	negative
gründen	negative
grüne	negative
grüßen	positive
gt	positive
gucken	negative
gustavo	negative
gut	positive
gute	positive
gute.	positive
gutschein	positive
gutten	positive
gönnen	positive
götze	negative
günstig	positive
h	negative
ha	positive
haar	negative
haaren	negative
hab	negative
haben	positive
habs	positive
hach	positive
hacken	negative
hacker	negative
hafen	positive
hagen	positive
haha	negative
hahah	positive
hahaha	negative
hahahah	negative
hahahaha	negative
hai	negative
halb	positive
halbfinal	negative
halbfinale	positive
halbzeit	negative
halle	negative
halligalli	negative
hallo	positive
hals	negative
halt	negative
halten	negative
ham	negative
hamburg	positive
hamburger	negative
hammer	positive
han	negative
hand	negative
handball	negative
handel	negative
handeln	negative
handelsblatt	negative
handy	negative
hannover	negative
hans	negative
happy	positive
hardcore	negative
harry	positive
hart	negative
hartz	negative
hase	positive
hashtag	negative
hass	negative
hassen	negative
hast	positive
hasten	negative
hate	negative
hats	negative
hauen	negative
hauptbahnhof	negative
hauptsache	negative
haus	negative
hausaufgabe	positive
hausen	positive
haushalt	negative
haustier	positive
haut	negative
have	positive
hbf	positive
hd	positive
he	negative
heart	negative
heben	negative
heeft	positive
heftig	negative
hehe	positive
hehehe	positive
heidelberg	positive
heidi	positive
heilbronn	negative
heim	positive
heimat	negative
heimlich	positive
heiraten	positive
heise	negative
heizen	positive
heizung	positive
heiß	negative
heißen	negative
held	positive
helfen	negative
helfer	positive
hell	positive
her	negative
heraus	negative
herausforderung	negative
herbst	negative
here	negative
herr	positive
herrlich	positive
hersteller	negative
hertha	positive
herum	positive
herunter	negative
herz	positive
herzen	positive
herzlich	positive
hessen	negative
het	negative
heuen	positive
heute	positive
heutig	negative
heutzutage	negative
hey	positive
heynckes	negative
hh	positive
hi	positive
hier	positive
high	positive
highlight	positive
hihi	positive
hilfe	positive
himmel	positive
hin	positive
hinten	negative
hinter	negative
hintergrund	negative
hinterher	negative
hinweis	negative
hinzufügen	negative
hipster	negative
hirn	negative
historisch	negative
hit	positive
hitler	negative
hm	negative
hmm	negative
hmmm	negative
ho	negative
hobby	positive
hoch	negative
hochgeladen	positive
hochschule	negative
hochwertig	positive
hochzeit	positive
hoeness	negative
hof	positive
hoffen	positive
hoffenheim	negative
hoffentlich	negative
hoffnung	negative
holen	positive
holstein	negative
holz	positive
home	negative
homepage	negative
homo	negative
horror	negative
hose	negative
hot	positive
hotel	positive
house	negative
how	negative
hp	negative
hpa	negative
hr	negative
hsv	positive
ht	negative
htc	negative
htt	negative
http	negative
huch	negative
hum	negative
humor	negative
hund	positive
hundert	negative
hunger	negative
hungern	negative
hurra	negative
hust	negative
hut	positive
hä	negative
hälfte	negative
hängen	negative
hässlich	negative
hätt	negative
häufig	negative
höhe	negative
höherwertig	positive
hölle	negative
hören	negative
hös	negative
hübsch	positive
i	negative
i'm	negative
i.	positive
ice	negative
ich	positive
ichs	negative
ick	positive
id	positive
ideal	positive
idee	positive
idiot	negative
if	negative
ignorieren	negative
ih	negative
ihr	positive
ii	negative
iii	negative
ik	negative
ikea	negative
illegal	negative
im	negative
immer	negative
immerhin	negative
immernoch	negative
immobilie	negative
immortalis	negative
in	negative
indem	positive
indien	negative
individuell	positive
industrie	negative
info	negative
information	negative
informieren	negative
ingenieur	negative
inhalt	negative
initiative	negative
inkl	negative
inklusive	negative
innen	positive
inner	negative
innerhalb	negative
innovation	negative
innovativ	positive
insel	negative
insgesamt	negative
instagram	positive
installieren	negative
institut	negative
intelligent	positive
intensiv	positive
interessant	negative
interesse	negative
interessieren	negative
intern	negative
international	negative
internet	negative
interview	positive
intro	positive
investieren	negative
investor	negative
inzwischen	negative
ios	negative
ipad	negative
ipadgames	negative
iphone	negative
iphonegames	negative
ipod	negative
iran	negative
irgendeine	negative
irgendwann	positive
irgendwas	negative
irgendwelche	negative
irgendwer	negative
irgendwie	negative
irgendwo	positive
iron	negative
ironie	negative
irre	negative
irrig	negative
is	negative
isch	negative
islam	negative
island	negative
israel	negative
isses	negative
ist.	negative
istanbul	negative
it	negative
italien	negative
italienisch	negative
itunes	negative
iv	negative
j	negative
j.	negative
ja	negative
jaa	negative
jaaa	positive
jaaaa	positive
jack	negative
jacke	negative
jagen	negative
jahr	negative
jaja	negative
james	negative
jan	positive
jap	positive
japan	negative
japanisch	negative
jarmen	negative
jauch	negative
java	positive
je	negative
jean	negative
jeans	positive
jede	positive
jedenfalls	negative
jedoch	negative
jemals	positive
jemand	positive
jen	negative
jesus	negative
jetz	positive
jetzt	positive
jij	negative
jo	positive
joa	negative
job	negative
jobangebot	positive
jobs	negative
joggen	positive
johann	negative
john	negative
joiz	negative
jong	negative
journalist	negative
jugend	negative
jugendliche	negative
juhu	positive
juli	negative
julia	positive
jung	positive
junge	negative
jungs	positive
juni	negative
junior	positive
jupp	positive
just	positive
justin	negative
justiz	negative
juve	negative
juventus	negative
juvfcb	negative
jz	positive
jährig	negative
jährige	negative
jähriger	negative
jürgen	negative
k	negative
k.	positive
ka	positive
kabel	negative
kacken	negative
kaffee	positive
kalender	positive
kalt	negative
kamera	positive
kampagne	negative
kampf	negative
kamu	negative
kan	positive
kanal	positive
kandidat	negative
kanns	negative
kannste	positive
kanzlerin	negative
kapieren	negative
kapitel	negative
kaputt	negative
karl	negative
karlshagen	negative
karlsruhe	negative
karnin	negative
karriere	negative
karte	negative
kasse	negative
kassel	negative
kategorie	negative
kater	negative
katze	positive
kauen	negative
kauf	negative
kaufen	negative
kaum	negative
ke	negative
keine	negative
keks	positive
keller	negative
kennen	positive
kennenlernen	positive
kerl	negative
kette	negative
kevin	negative
kg	negative
ki	negative
kicker	negative
kid	negative
kiel	positive
kilo	positive
kim	negative
kind	negative
kindergarten	negative
kindheit	negative
kindle	positive
king	positive
kino	negative
kippen	negative
kirche	negative
kita	negative
klagen	negative
klamotte	negative
klappen	positive
klar	negative
klasse	positive
klassiker	negative
klassisch	negative
klauen	negative
klaus	negative
klausur	negative
kleid	positive
klein	positive
kleinanzeige	positive
kleine	positive
klick	positive
klicken	positive
klingeln	positive
klingen	negative
klinik	negative
klo	negative
kloppen	positive
klug	positive
klären	negative
km	positive
knacken	negative
knapp	negative
know	negative
ko	negative
koblenz	positive
koch	positive
kochen	positive
koffer	positive
kohle	negative
kohlenhydrat	negative
kollege	positive
kollegin	positive
kollektion	negative
kom	negative
komisch	negative
kommen	positive
kommend	positive
kommentar	negative
kommentieren	negative
kommission	negative
kommunikation	negative
kompetent	positive
komplett	positive
kompliment	positive
komt	negative
konferenz	negative
konflikt	negative
konkret	negative
konkurrenz	negative
kontakt	positive
konto	negative
kontrolle	negative
konzentrieren	negative
konzept	negative
konzern	negative
konzert	positive
kopf	negative
kopfhörer	negative
kopfschmerz	negative
korea	negative
korrekt	positive
koserow	negative
kosten	negative
kostenfrei	negative
kostenlos	negative
kostenloser	negative
kotzen	negative
kraft	negative
kraftfahrzeug	negative
krank	negative
krankenhaus	negative
krankheit	negative
krass	negative
kreativ	positive
kredit	negative
kreditkarte	negative
kreis	negative
kreisfrei	negative
kreuz	negative
krieg	negative
kriegen	negative
krimi	negative
krise	negative
kritik	negative
kritisch	negative
kritisieren	negative
kroos	negative
kräftig	positive
kuchen	positive
kuh	negative
kultur	negative
kumpel	positive
kunde	negative
kunst	positive
kurs	negative
kurz	positive
kurzversion	negative
kuscheln	positive
kuss	positive
kw	negative
kämpfen	negative
kämpfer	negative
käse	negative
köln	positive
kölner	negative
könig	negative
können	positive
körper	positive
küche	positive
kühl	positive
kühlschrank	positive
kümmern	positive
kündigen	negative
künftig	negative
künstler	negative
küssen	positive
l	negative
la	positive
labern	negative
lachen	negative
lache|lachen	positive
laden	positive
lady	positive
lage	negative
lager	negative
lahm	negative
lan	positive
land	negative
landen	negative
landkreis	negative
landtag	negative
lang	positive
lange	positive
langeweile	positive
langsam	negative
langweilig	negative
lanz	negative
laptop	negative
lassen	negative
last	positive
lasttweet	negative
lauf	positive
laufen	negative
laufend	negative
laune	positive
laura	positive
laut	negative
lauten	negative
lauterbach	negative
lautfm	negative
lawak	negative
laß	positive
le	positive
league	negative
leaks	negative
leben	negative
lebensmittel	negative
leck	positive
lecken	negative
lecker	positive
led	negative
leder	positive
leer	negative
legal	negative
legen	negative
lego	positive
lehnen	negative
lehrer	negative
lehrerin	negative
leicht	negative
leid	negative
leiden	negative
leidenschaft	positive
leider	negative
leipzig	negative
leise	positive
leisten	negative
leistung	negative
leiter	positive
leitung	negative
lena	positive
lernen	positive
les	positive
lesen	negative
leser	negative
lese|lesen	negative
let	negative
lets	positive
letzt	negative
letztens	positive
leute	negative
level	negative
leverkusen	negative
lewandowski	positive
lg	positive
licht	positive
lieb	positive
liebe	positive
lieben	positive
liebevoll	positive
liebe|lieben	positive
liebling	positive
lied	positive
liefern	negative
liegen	negative
life	positive
liga	negative
light	negative
like	positive
liked	negative
liken	positive
likes	negative
limit	positive
line	positive
linie	negative
link	negative
linke	negative
links	negative
linux	negative
lippe	positive
lisa	positive
liste	negative
liter	negative
little	positive
live	positive
livecam	negative
livestream	negative
liveticker	negative
lkw	negative
loch	negative
locken	positive
locker	positive
logo	negative
lohnen	negative
lokal	negative
london	negative
look	positive
looking	positive
los	positive
losen	negative
lotto	negative
love	positive
lp	positive
lt	negative
lu	positive
luft	positive
luftdruck	negative
lufthansa	negative
lust	positive
lustig	negative
luven	negative
luxus	positive
lächeln	positive
lächerlich	negative
längst	negative
löschen	negative
lösen	negative
lösung	negative
löwe	negative
lübeck	positive
lüftung	negative
lügen	negative
m	negative
m.	negative
m1ö	positive
mac	positive
macbook	negative
machen	positive
macht	negative
made	negative
madrid	negative
mafia	negative
magazin	positive
magdeburg	negative
magen	negative
mai	negative
mail	positive
mails	negative
main	negative
mainz	positive
make	positive
mal	positive
malaga	negative
malen	positive
maler	positive
mallorca	negative
mama	positive
man	negative
management	negative
manager	negative
manche	negative
manchmal	negative
mandzukic	negative
mangelhaft	negative
mann	positive
mannheim	positive
mannschaft	negative
marathon	negative
marc	positive
marco	positive
margaret	negative
maria	positive
marie	positive
mario	positive
mark	negative
marke	negative
marketing	positive
markt	negative
markt.	negative
markus	positive
mars	positive
martin	negative
martinez	negative
maschine	negative
massage	positive
masse	negative
massiv	negative
master	positive
material	negative
mathe	negative
matthias	positive
mau	negative
maus	positive
max	positive
maß	negative
mb	positive
mc	positive
me	negative
meckern	negative
mecklenburg	negative
media	negative
medium	negative
medizin	negative
meer	positive
mega	negative
meh	negative
mehr	negative
mehrere	negative
mehrheit	negative
mei	negative
mein	positive
meinen	negative
meinung	negative
meist	negative
meiste	positive
meistens	negative
meister	positive
meisterschaft	negative
melden	positive
meldung	negative
men	negative
menge	negative
mensch	negative
menschen	negative
menschheit	negative
menschlich	negative
mer	positive
mercedes	negative
merkel	negative
merken	negative
messe	negative
messer	negative
messi	negative
met	negative
metal	negative
meter	negative
methode	negative
mi	positive
mia	negative
miasanmeister	negative
miasanmia	positive
michael	positive
microsoft	negative
mies	negative
miete	negative
milch	negative
milliarde	negative
million	negative
mimimi	negative
min	negative
mind	positive
minderwertig	negative
mindestens	negative
minecraft	negative
mini	positive
minister	negative
minute	negative
mio	negative
mir	negative
miss	negative
miss50percent	positive
mission	negative
misslich	negative
mist	negative
mit	negative
mitarbeiter	negative
mitbekommen	negative
mitbringen	positive
miteinander	positive
mitglied	negative
mitmachen	positive
mitnehmen	positive
mittag	positive
mitte	negative
mitten	positive
mittlerweile	negative
mittwoch	positive
mix	negative
ml	negative
mm	negative
mo	negative
mobil	negative
mode	negative
model	negative
modell	negative
modern	positive
moin	positive
mollath	negative
moment	positive
momentan	negative
monat	negative
mond	negative
money	negative
monitor	positive
monsanto	negative
monster	negative
montag	positive
mord	negative
more	negative
morgen	positive
morgens	positive
morning	positive
motiv	negative
motivation	positive
motor	negative
motorrad	negative
motto	negative
movie	negative
mp3	negative
mr.	negative
much	negative
muller	negative
mum	negative
mund	negative
munich	negative
museum	positive
music	positive
musicalradiode	negative
musik	positive
musikwunsch	negative
muss	positive
mut	negative
mutter	negative
mutti	positive
my	negative
m²	positive
mächtig	negative
mädchen	negative
mädel	positive
männlich	negative
märz	negative
möbel	positive
mögen	positive
möglich	negative
möglichkeit	negative
mönchengladbach	negative
müde	negative
müll	negative
müller	negative
münchen	positive
münchner	positive
münster	negative
müssen	positive
n	negative
n24	negative
na	positive
nach	negative
nachbar	positive
nachdem	negative
nachdenken	positive
nachhaltig	negative
nachhaltigkeit	negative
nachher	positive
nachhilfe	negative
nachmittag	positive
nachrangig	negative
nachricht	negative
nachrichten	negative
nacht	negative
nachts	negative
nackt	negative
nagel	positive
nah	negative
nahe	negative
nahrungseinheiten	positive
naja	negative
name	negative
nase	negative
nass	negative
national	negative
natur	negative
natürlich	positive
nazi	negative
nba	positive
nd	negative
neben	negative
nebenbei	positive
nebenjob	positive
nee	negative
need	positive
negativ	negative
nehm	positive
nehmen	negative
neidisch	negative
nein	negative
nem	positive
nen	negative
nennen	negative
neonazi	negative
ner	negative
nerven	negative
nervig	negative
nerv|nerven	negative
nett	positive
netz	negative
netzneutralität	negative
netzwerk	negative
neu	negative
neue	positive
neuendorf	negative
neugierig	positive
neuigkeit	negative
neun	negative
neuwertig	negative
never	negative
new	positive
news	positive
newsletter	negative
next	positive
ni	negative
nice	positive
nicht	negative
nicht.	negative
nichtmal	negative
nichts	negative
nie	negative
niederlage	negative
niederlande	negative
niedersachsen	negative
niederschlag	negative
niedlich	negative
niedrig	negative
niedrigwasser	negative
niemals	negative
niemand	negative
niggas	negative
night	positive
nike	positive
nintendo	negative
niveau	negative
no	negative
noch	negative
nochmal	positive
nog	positive
nokia	negative
nord	negative
norden	negative
nordkorea	negative
nordrhein	negative
nordsee	negative
normal	positive
not	negative
note	negative
notebook	negative
now	negative
nowplaying	negative
np	negative
npd	negative
nr	positive
nr.	negative
nrw	negative
nsu	negative
nu	positive
nuh	negative
null	negative
nummer	negative
nun	positive
nur	negative
nutella	negative
nutte	negative
nutzen	negative
nutzer	negative
nutzung	negative
nw	negative
nähe	positive
nähen	positive
nämlich	negative
nö	negative
nötig	negative
nürnberg	negative
o	negative
o.	negative
o2	negative
ob	positive
obama	negative
oben	positive
ober	negative
oberhausen	positive
obst	negative
obwohl	negative
och	negative
oder	negative
of	positive
off	negative
offen	positive
offenbar	negative
offensichtlich	negative
office	positive
official	negative
offiziell	negative
offline	negative
offshore	negative
oft	negative
oh	negative
oha	negative
ohh	negative
ohne	negative
ohr	negative
ohrwurm	positive
ok	positive
okay	negative
oke	positive
okru	negative
oktober	negative
oldenburg	positive
oliver	negative
oma	positive
omg	negative
on	positive
one	positive
online	negative
oo	negative
ook	negative
op	negative
opa	negative
opel	negative
open	negative
opfer	negative
ops	negative
optimal	positive
option	negative
or	positive
orange	negative
ordentlich	positive
ordnung	negative
organisieren	positive
original	positive
ort	negative
osnabrück	negative
ost	negative
ostern	positive
ostsee	negative
ots	negative
otto	negative
out	negative
outdoor	positive
outfit	positive
outlet	positive
over	positive
ovp	negative
p	positive
p.	positive
pa	negative
paar	positive
pack	negative
packen	negative
pad	negative
paket	negative
panik	negative
panne	negative
papa	positive
papier	negative
papst	negative
paradise	positive
paris	negative
park	positive
parlament	negative
part	negative
partei	negative
parteitag	negative
partie	negative
partner	positive
party	positive
pass	negative
passen	positive
passend	positive
passieren	negative
passwort	negative
patient	negative
paul	negative
pauli	positive
pause	positive
pc	negative
pdf	negative
pech	negative
peene	negative
peer	negative
pegel	negative
pegelmv	positive
peinlich	negative
penis	negative
pennen	negative
people	negative
per	positive
perfekt	positive
person	negative
personal	negative
persönlich	negative
pervers	negative
peter	positive
petition	negative
pfalz	negative
pferd	positive
pflege	negative
pflegen	positive
pflicht	negative
phase	positive
philip	positive
phoenix	negative
phone	negative
photo	negative
physik	positive
pi	positive
pic	positive
pink	negative
pirat	negative
piraten	negative
piratenpartei	negative
piratinnenkon	negative
pissen	negative
pizza	positive
pk	negative
pkw	negative
plakat	negative
plan	positive
planen	negative
planet	negative
planung	negative
plattform	negative
platz	negative
platzen	negative
play	positive
player	positive
playstation	negative
please	positive
pleite	negative
pls	positive
plus	negative
plz	negative
plötzlich	negative
pm	negative
po	negative
podcast	negative
pokal	positive
pol	negative
polen	negative
politik	negative
politiker	negative
politisch	negative
polizei	negative
polizist	negative
pony	positive
pool	positive
pop	negative
porn	positive
porno	negative
porsche	negative
portal	negative
portugal	negative
position	negative
positiv	positive
post	negative
posten	negative
poster	positive
potsdam	negative
power	positive
pr	negative
praktikum	negative
praktisch	positive
praxis	negative
preis	negative
preiswert	positive
preis|preisen	positive
premiere	positive
premium	positive
presse	negative
pressemitteilung	negative
pressen	negative
prima	positive
prinz	positive
prinzessin	positive
prinzip	negative
privat	positive
pro	positive
pro7	negative
probieren	positive
problem	negative
produkt	negative
produktion	negative
produzieren	negative
prof	negative
professionell	positive
profi	positive
profil	negative
profitieren	negative
programm	negative
projekt	negative
prost	positive
protest	negative
prozent	negative
prozess	negative
präsentieren	negative
präsident	negative
prüfen	negative
prüfung	positive
ps	positive
ps3	negative
puh	negative
punk	negative
punkt	positive
pur	negative
pussy	negative
putin	negative
putzen	positive
pvp	positive
pünktlich	positive
q	positive
qm	negative
qq	negative
qualität	negative
quartal	negative
quasi	negative
que	positive
quelle	negative
quoka	positive
quot	negative
quote	negative
r	positive
r.	negative
rabatt	negative
racing	negative
rad	negative
radio	negative
rahmen	negative
ram	negative
rammstein	positive
ran	negative
random	negative
rangeln	positive
ranking	negative
rap	negative
rapper	negative
rasen	negative
rassismus	negative
rat	negative
raten	negative
ratgeber	negative
ratschlag	negative
rauchen	positive
raum	positive
raus	negative
ray	positive
re	positive
ready	positive
reagieren	negative
reaktion	negative
real	positive
realität	negative
rechnen	negative
rechner	positive
rechnung	negative
recht	negative
rechts	negative
recht|rechte	negative
recht|rechts	negative
red	positive
rede	positive
reden	negative
reduzieren	negative
rege	negative
regel	negative
regelmässig	negative
regeln	negative
regel|regeln	negative
regen	positive
regensburg	negative
regieren	negative
regierung	negative
regierungsbezirk	negative
region	negative
regional	negative
regnen	positive
reich	negative
reichen	negative
reif	positive
reifen	negative
reihe	negative
rein	negative
reise	positive
reisen	positive
reise|reisen	negative
reiten	positive
reißen	negative
rekord	negative
relativ	positive
release	negative
religion	negative
remix	negative
rennen	positive
rente	negative
rentner	negative
report	negative
respekt	negative
rest	positive
restaurant	positive
retten	negative
rettung	negative
retweet	positive
retweeten	positive
retweetet	positive
review	negative
revolution	negative
rezension	negative
rezept	positive
rhein	negative
rheinland	negative
ribery	negative
ribéry	negative
richten	negative
richter	negative
richtig	positive
richtung	negative
riechen	negative
riese	negative
riesig	negative
right	negative
ring	negative
risiko	negative
rl	positive
rmdbvb	negative
robbe	negative
robert	negative
rock	negative
rocken	positive
roger	negative
rolle	negative
rollen	negative
roller	negative
rom	negative
roman	negative
romantisch	positive
rosa	negative
rose	positive
rosemarie	negative
rostock	positive
rot	negative
roth	negative
rp	negative
rt	positive
rtl	negative
rtl2	negative
ruf	negative
rufen	positive
ruhe	positive
ruhen	positive
ruhig	positive
ruhr	positive
rum	negative
run	negative
rund	negative
runde	positive
runtastic	negative
runter	negative
russisch	positive
russland	negative
ryck	negative
räumen	negative
rüber	positive
rücken	negative
s	positive
s.	positive
s04	negative
s21	negative
s3	negative
s4	negative
sa	negative
saarland	negative
sache	negative
sachen	negative
sachsen	negative
sack	negative
sagen	positive
saison	negative
salat	negative
sale	positive
salzburg	negative
sami	positive
sammeln	positive
sammlung	negative
samstag	positive
samsung	negative
san	negative
sap	negative
sarah	positive
sassnitz	negative
sat	negative
satt	negative
satz	positive
sau	negative
sauber	positive
sauer	negative
saufen	positive
say	negative
sc	negative
sch	negative
schade	negative
schaden	negative
schaf	negative
schaffen	negative
schalk	negative
schalten	negative
scharf	negative
schatten	negative
schatz	positive
schau	positive
schauen	positive
schaufensterpuppe	negative
schauspieler	negative
scheinbar	negative
scheinen	negative
scheitern	negative
scheiße	negative
scheißen	negative
schenken	positive
scherz	negative
scheußlich	negative
schick	positive
schicken	positive
schicksal	negative
schieben	negative
schief	negative
schießen	negative
schlaf	positive
schlafen	positive
schlag	negative
schlagen	negative
schlager	positive
schlampe	negative
schlank	positive
schlau	positive
schlecht	negative
schleswig	negative
schließen	negative
schließlich	positive
schlimm	negative
schloss	positive
schlumpf	negative
schluss	negative
schlüssel	positive
schmecken	negative
schmeißen	negative
schmerz	negative
schmerzen	negative
schmidt	negative
schmuck	positive
schnee	positive
schneiden	negative
schnell	positive
schnäppchen	positive
scho	negative
schokolade	positive
schon	positive
schonmal	positive
school	negative
schrank	positive
schrecklich	negative
schreiben	positive
schreibtisch	positive
schreien	positive
schritt	negative
schröder	negative
schufa	negative
schuh	negative
schuld	negative
schule	negative
schulen	negative
schuss	negative
schutz	negative
schwach	negative
schwanger	negative
schwanz	negative
schwarz	negative
schweigen	negative
schwein	negative
schweinsteiger	negative
schweiz	negative
schweizer	negative
schwer	negative
schwerpunkt	negative
schwester	negative
schwierig	negative
schwierigkeit	negative
schwimmbad	positive
schwimmen	positive
schwul	negative
schädlich	negative
schämen	negative
schätzen	negative
schäuble	negative
schön	positive
schöne	positive
schönheit	positive
schüler	negative
schützen	negative
score	negative
se	negative
sebastian	negative
sechs	negative
see	negative
seele	positive
seh	negative
sehen	negative
sehnen	positive
sehr	positive
sein	negative
seit	negative
seite	negative
sekunde	negative
selb	negative
selbe	negative
selber	negative
selbst	negative
selten	negative
seltsam	negative
seminar	negative
senden	positive
sender	negative
sendung	negative
senior	negative
senken	negative
seo	negative
september	negative
serie	negative
seriös	positive
server	negative
service	positive
set	positive
setzen	negative
sex	positive
sexkontakte	positive
sexuell	negative
sexy	positive
sg	negative
share	negative
she	positive
shirt	positive
shit	negative
shop	positive
shoppen	positive
shopping	positive
show	positive
si	negative
sich	negative
sicher	positive
sicherheit	negative
sicherlich	negative
sichern	negative
sicht	negative
sie	negative
sieben	negative
sieg	negative
siegen	negative
siehe	positive
siemens	negative
sie|sie	positive
silber	positive
sim	positive
sind.	negative
singen	negative
single	positive
sinken	negative
sinn	negative
sinnlos	negative
sinnvoll	negative
situation	negative
sitz	positive
sitzen	positive
skandal	negative
sky	negative
skybuli	negative
skycl	negative
skype	positive
slapen	negative
smart	positive
smartphone	negative
smartphones	negative
sms	positive
smurfsvillage	positive
so	negative
sobald	positive
social	negative
socialmedia	negative
socke	negative
soeben	negative
sofa	positive
sofort	positive
software	negative
sogar	negative
sohn	negative
solange	negative
solar	negative
solche	negative
soll	negative
sollen	positive
somit	positive
sommer	positive
sondern	negative
song	positive
sonne	positive
sonnen	positive
sonnenschein	positive
sonnig	positive
sonntag	positive
sonst	negative
sony	negative
soo	negative
sooo	negative
soooo	positive
sorge	negative
sorgen	negative
sorge|sorgen	positive
sorry	negative
sound	positive
soviele	negative
sowas	negative
soweit	positive
sowie	negative
sowieso	negative
sowohl	positive
sozial	negative
sp	negative
spam	negative
spanien	negative
spanisch	negative
spannen	negative
spannend	positive
spannung	negative
sparen	negative
spargel	positive
sparkasse	positive
spaß	positive
spd	negative
spdbpt	negative
special	positive
spenden	positive
sperma	positive
sperren	negative
spezialist	negative
speziell	positive
spiegel	negative
spiegeln	negative
spiel	negative
spielen	negative
spieler	negative
spieltag	negative
spielzeug	negative
spiel|spielen	negative
spinnen	negative
spitze	negative
spontan	positive
sport	positive
sportlich	positive
spotify	negative
sprache	negative
sprechen	negative
springen	positive
spritzen	negative
spruch	positive
spur	negative
spur|spuren	negative
spät	negative
spätestens	negative
spüren	negative
sry	negative
ssnhd	negative
st	negative
st.	negative
staat	negative
staatsanwaltschaft	negative
stadion	negative
stadt	negative
staffel	negative
stahlbrode	negative
stand	negative
standard	positive
standort	negative
star	positive
stardoll	negative
stark	negative
start	positive
starten	negative
station	negative
statistik	negative
statt	negative
status	negative
stau	negative
std	negative
stecken	negative
stefan	positive
stehen	negative
stehlen	negative
steigen	negative
steigend	negative
steigern	negative
stein	positive
steinbrück	negative
stelle	positive
stellen	negative
stellenangebot	negative
stellenanzeige	negative
stelle|stellen	negative
sterben	negative
stern	negative
steuer	negative
steuerhinterziehung	negative
steueroase	negative
steve	negative
stiftung	negative
stil	positive
still	positive
stimme	negative
stimmen	negative
stimme|stimmen	negative
stimmung	positive
stinken	negative
stock	negative
stocken	negative
stockend	negative
stockfotos	negative
stoff	negative
stolz	positive
stop	negative
stoppen	negative
store	negative
story	negative
stoßen	negative
strafe	negative
stralsund	negative
strand	positive
strategie	negative
straße	negative
stream	negative
strecke	negative
street	negative
streichen	negative
streik	negative
streit	negative
streiten	positive
stress	positive
strom	negative
stronach	negative
student	positive
studie	negative
studieren	positive
studio	negative
studium	negative
stufe	negative
stuhl	positive
stunde	negative
stunden	negative
stunde|stunden	negative
sturm	negative
stuttgart	negative
style	negative
ständig	negative
stärken	negative
stören	negative
störung	negative
stück	negative
stürzen	negative
stützen	negative
suche	positive
suchen	positive
suche|suchen	positive
suchmaschinen	negative
suite	positive
summer	positive
sun	positive
super	positive
support	positive
surfen	negative
sv	negative
swag	negative
sweet	positive
sympathisch	positive
syrien	negative
system	negative
sz	negative
szene	negative
sü	negative
süd	positive
süden	negative
südkorea	negative
süß	positive
t	negative
t.	negative
ta	positive
tablet	negative
tag	positive
tagebuch	negative
tagen	positive
tagesschau	negative
tagesspiegel	negative
talent	positive
talk	negative
tanz	negative
tanzen	positive
tarif	negative
tasche	negative
tasse	positive
tastatur	positive
tat	negative
tatort	negative
tatsächlich	negative
tattoo	positive
tauchen	negative
tausch	negative
tauschen	positive
tausend	negative
taz	negative
te	negative
team	positive
tech	positive
technik	positive
technisch	negative
technologie	negative
teddy	positive
tee	positive
tegen	negative
teil	negative
teilen	positive
teilnehmen	negative
teilnehmer	negative
teilweise	negative
telefon	positive
telefonieren	positive
telekom	negative
tell	negative
telmi	negative
temp	negative
temperatur	positive
ten	negative
tendenz	negative
tennis	positive
termin	positive
terrasse	positive
terror	negative
test	negative
testen	positive
teuer	negative
teufel	negative
text	negative
th	negative
thanks	positive
that	positive
thatcher	negative
the	positive
theater	negative
thema	negative
thiessow	positive
this	negative
thomas	negative
thüringen	negative
ticker	negative
ticket	positive
tief	positive
tier	negative
tim	negative
time	positive
timeline	negative
timen	positive
timmendorf	negative
tip	negative
tippen	negative
tirol	negative
tisch	positive
titel	positive
titten	positive
tja	negative
tl	positive
to	positive
tochter	positive
tod	negative
today	negative
together	positive
toilette	negative
toll	positive
tom	positive
ton	negative
tonne	negative
too	negative
tool	negative
top	positive
topthemen	negative
tor	negative
tot	negative
total	negative
tote	negative
touch	negative
tour	positive
tourismus	negative
trading	negative
traffic	negative
tragen	positive
trailer	negative
trainer	negative
trainieren	positive
training	positive
transfer	negative
transparenz	negative
trauen	negative
traum	positive
traumhaft	positive
traurig	negative
treffen	positive
treffen|triefen	positive
treiben	negative
trend	negative
trennen	negative
treppe	positive
treten	negative
treu	positive
tribez	negative
trick	negative
trier	negative
trikot	positive
trinken	positive
trocken	positive
trotz	negative
trotzdem	positive
träne|tränen	negative
träumen	positive
ts	negative
tschüss	positive
tt	negative
tu	positive
tumblr	positive
tun	negative
turin	positive
tutorial	positive
tv	negative
tweet	positive
tweeten	positive
tweets	positive
twitter	positive
twitterer	positive
twittern	positive
twittert	negative
two	negative
twoff	positive
typ	negative
typisch	negative
täglich	negative
täter	negative
tödlich	negative
töten	negative
tür	positive
türe	positive
türkei	negative
türkisch	negative
tüv	negative
u	negative
ucl	negative
uf	negative
uh	negative
uhr	positive
uhrzeit	negative
ui	positive
uli	negative
ulm	negative
ultra	negative
um	negative
umarmen	positive
umbringen	negative
umfrage	negative
umgang	negative
umgebung	positive
umgehen	negative
ums	positive
umsatz	negative
umsonst	negative
umwelt	negative
umzug	negative
un	positive
unabhängig	negative
unangenehm	negative
unbedingt	positive
unbekannt	negative
und	negative
unendlich	positive
unerfreulich	negative
unfall	negative
unfassbar	negative
ungefähr	negative
ungeschnitten	negative
unglaublich	negative
unglücklich	negative
ungünstig	negative
uni	negative
union	negative
universität	negative
unkompliziert	positive
unmöglich	negative
unnötig	negative
unrecht	negative
unser	negative
unten	negative
unter	negative
unterhalten	positive
unterhaltung	positive
unterlegen	negative
unternehmen	negative
unternehmer	negative
unterricht	negative
unterscheiden	negative
unterschied	negative
unterschiedlich	negative
unterschreiben	negative
unterstützen	negative
unterstützung	positive
unterwegs	positive
unverbindlich	negative
up	positive
update	negative
ups	negative
uptime	negative
ur	negative
urlaub	positive
urteil	negative
us	negative
usa	negative
usb	negative
user	negative
usw	negative
v	negative
v.	negative
vaart	negative
van	negative
vater	negative
vdsl50	negative
ve	negative
venezuela	negative
ver	negative
verabschieden	positive
veranstaltung	negative
verarscht	negative
verbesser	negative
verbessern	negative
verbieten	negative
verbinden	positive
verbindung	negative
verbot	negative
verbreiten	negative
verbrennen	negative
verbringen	positive
verdacht	negative
verdammen	negative
verdammt	negative
verdienen	negative
verdorben	negative
verein	negative
verfahren	negative
verfolgen	negative
verfügbar	negative
verfügung	negative
vergangen	negative
vergangenheit	negative
vergeben	negative
vergehen	positive
vergessen	negative
vergleich	negative
vergleichen	negative
verhalten	negative
verhindern	negative
verhältnis	negative
verkauf	negative
verkaufen	positive
verkehr	negative
verkehrsrecht	negative
verkehrsunfall	negative
verlag	negative
verlangen	negative
verlassen	positive
verletzen	negative
verletzte	negative
verlieben	negative
verlieren	negative
verlosen	positive
verlust	negative
verlängern	negative
vermessen|vermissen	positive
vermissen	positive
vermuten	negative
vermutlich	negative
vermögen	negative
vernünftig	positive
verpassen	negative
verpflichten	negative
verraten	negative
verrücken	negative
verrückt	positive
versand	negative
versauen	negative
verschenken	negative
verschieben	negative
verschieden	negative
verschwinden	negative
versicherung	negative
version	positive
versprechen	negative
verspätung	positive
verstand	positive
verstecken	negative
verstehen	negative
versuch	positive
versuchen	positive
verteidigen	negative
verteilen	negative
vertrag	negative
vertrauen	negative
vertrieb	negative
verwenden	negative
verwirren	negative
verwöhnen	positive
verzichten	negative
verändern	negative
veränderung	negative
veröffentlichen	negative
vettel	negative
vfb	positive
vfl	negative
via	negative
video	positive
viel	negative
viele	positive
vielfalt	negative
vielleicht	positive
vier	positive
viert	negative
viertel	negative
virtuell	negative
virus	negative
vllt	positive
vo	negative
vodafone	negative
vogel	negative
voice	positive
voicekids	negative
volk	negative
voll	negative
vollendet.	positive
vollkommen	negative
von	negative
vor	negative
vorallem	negative
vorbei	positive
vorbereiten	positive
vorbereitung	negative
vorbild	negative
vorfreude	positive
vorhanden	negative
vorher	negative
vorhin	positive
vorlesung	positive
vorm	positive
vorne	negative
vorpommern	negative
vorschlag	positive
vorsicht	negative
vorstand	negative
vorstellen	negative
vorstellung	negative
vorteil	positive
vortrag	negative
vorwurf	negative
vs.	negative
vw	negative
völlig	negative
w	positive
w.	negative
wa	positive
wach	positive
wachsen	negative
wachstum	negative
waffe	negative
wagen	negative
wahl	negative
wahlkampf	negative
wahnsinn	negative
wahr	negative
wahrheit	negative
wahrscheinlich	negative
wald	negative
wand	negative
wandern	positive
wann	positive
ware	negative
warm	negative
warnemünde	positive
warnen	negative
warnung	negative
wars	negative
warten	positive
warum	negative
was	positive
waschen	positive
wasser	negative
wat	negative
watch	negative
way	positive
wdr	negative
we	positive
web	negative
webcam	negative
weben	negative
webseite	negative
website	negative
webverzeichnis	negative
webvideopreis	negative
wechsel	negative
wechseln	negative
wecken	positive
wecker	positive
weder	negative
weet	negative
weg	negative
wegen	negative
weh	negative
wehren	negative
weib	negative
weiblich	positive
weich	positive
weihnachten	positive
weil	negative
wein	positive
weinen	negative
weis	positive
weise	negative
weisen	negative
weit	negative
weiter	positive
weiterhin	negative
weiß	positive
weißen	negative
wel	negative
welche	positive
wellen	negative
wellness	positive
welpe	negative
welt	negative
weltweit	negative
wembley	positive
wen	negative
wenden	positive
wenig	negative
wenige	negative
weniger	negative
wenigstens	positive
wenn	negative
wenns	negative
wer	positive
werben	negative
werbung	negative
werd	positive
werden	negative
werder	negative
werfen	negative
werk	negative
wert	negative
wertvoll	positive
west	negative
weste|westen	negative
westfalen	negative
wettbewerb	negative
wetten	positive
wetter	positive
wettern	negative
wg	positive
what	negative
whatsapp	positive
white	negative
who	negative
why	negative
wi	positive
wichtig	negative
widerlich	negative
widerwärtig	negative
wie	negative
wieder	positive
wiederholen	negative
wiedersehen	positive
wien	negative
wiener	negative
wiesbaden	negative
wieso	negative
wieviele	negative
wii	negative
wil	negative
wild	negative
wille	negative
willkommen	positive
win	positive
wind	negative
windows	negative
winken	positive
winter	negative
wir	positive
wirds	positive
wirken	negative
wirklich	negative
wirkung	negative
wirtschaft	negative
wismar	negative
wissen	negative
wissenschaft	negative
wit	negative
with	positive
wittow	positive
witz	negative
witzig	negative
wlan	positive
wm	negative
wo	negative
wobei	negative
woche	negative
wochen	positive
wochenende	positive
wofür	negative
woher	negative
wohin	positive
wohl	positive
wohnen	positive
wohnung	positive
wohnzimmer	positive
wolf	negative
wolfgang	negative
wolfsburg	negative
wolgast	negative
wolke	negative
wolkig	negative
wollen	positive
wordpress	positive
work	positive
workshop	positive
world	positive
wort	negative
worteausderkindheit	negative
wow	positive
wozu	positive
wtf	negative
wulff	negative
wunder	negative
wunderbar	positive
wundern	negative
wunderschön	positive
wundervoll	positive
wunsch	positive
wuppertal	negative
wurst	negative
wut	negative
wählen	negative
wähler	negative
während	positive
wär	negative
wärme	positive
wärs	negative
wünschen	positive
würd	positive
württemberg	negative
würzburg	positive
x	positive
x3	positive
xbox	negative
xd	positive
xi	negative
xing	negative
xml	negative
xx	negative
xxx	positive
y	positive
ya	positive
yahoo	negative
yay	positive
yeah	positive
yes	positive
yg	negative
yo	positive
yoga	positive
yolo	negative
york	negative
you	negative
young	positive
your	negative
youtube	negative
yt	negative
yu	negative
z	negative
z.	negative
zahl	negative
zahlen	negative
zahlreich	negative
zahn	negative
zahnarzt	negative
zb	negative
zdf	negative
ze	negative
zehn	negative
zeichen	negative
zeichnen	positive
zeigen	negative
zeihen	positive
zeihen|ziehen	negative
zeit	positive
zeitpunkt	negative
zeitung	negative
zentral	negative
zentrum	negative
zerstören	negative
zeug	negative
zeuge	negative
ziehen	negative
ziel	negative
ziemlich	negative
zigarette	negative
zimmer	positive
zins	negative
zitat	negative
zocken	positive
zoll	negative
zu	negative
zubehör	negative
zucker	negative
zuerst	negative
zufall	negative
zufrieden	positive
zufällig	positive
zug	negative
zuhause	positive
zuhören	positive
zukunft	negative
zukünftig	negative
zuletzt	negative
zumindest	negative
zurück	positive
zusammen	positive
zusammenhang	negative
zuschauer	negative
zustand	negative
zusätzlich	positive
zuverlässig	positive
zuviele	negative
zwangsräumung	negative
zwar	negative
zwei	positive
zweimal	positive
zweit	positive
zwingen	negative
zwischen	negative
zypern	negative
zählen	negative
zürich	negative
{	negative
|	positive
}	positive
~	positive
°	negative
°c	negative
ägypten	negative
äh	negative
ähm	positive
ähnlich	negative
ändern	negative
änderung	negative
ärger	negative
ärgern	positive
ö	negative
öffentlich	negative
öffentlichkeit	negative
öffnen	positive
öfter	negative
öl	negative
österreich	negative
övp	negative
übel	negative
üben	negative
über	negative
überall	negative
überblick	negative
überhaupt	negative
überleben	negative
überlegen	positive
übermorgen	negative
übernehmen	negative
überragend	positive
überraschen	positive
überraschend	negative
überraschung	positive
übers	positive
übersicht	negative
überstehen	positive
übertreiben	negative
überwachung	negative
überzeugen	positive
übrig	positive
übrigens	positive
übung	negative
■	negative
▪	negative
★	negative
☺	positive
♡	positive
♥	positive
♫	negative
✔	negative
❤	positive
