!	positive
"	negative
%	negative
%link	negative
%negsmiley	negative
%possmiley	positive
%smiley	negative
%user	positive
%user-video	negative
&amp;	positive
&gt;	negative
&lt;	negative
'	negative
(	negative
)	negative
):	negative
*	negative
+	negative
,	positive
-	negative
.	negative
..	negative
...	positive
/	negative
1	negative
2	negative
3	positive
4	positive
5	positive
6	negative
7	positive
8	negative
:	negative
;	negative
</s>	negative
=	negative
?	negative
?!	negative
??	negative
@	positive
@card@	negative
@youtube	positive
[	negative
]	negative
^	positive
_	negative
`	positive
a	positive
ab	negative
abend	positive
aber	negative
abgeschlossen.	positive
ach	negative
aktuell	negative
album	positive
alle	positive
als	negative
also	negative
alt	positive
an	positive
andere	negative
android	negative
androidgames	positive
angenehm	positive
app	negative
apple	negative
april	negative
arbeit	positive
arbeiten	positive
arm	negative
armselig	negative
auch	negative
auf	negative
aus	negative
ausgezeichnet	positive
auto	positive
b	negative
bald	positive
bayern	negative
bedauernswert	negative
bei	negative
beide	positive
bekommen	positive
berlin	positive
besser	positive
bett	positive
bewerten	negative
bieten	negative
bild	positive
bis	positive
bisschen	positive
bitte	positive
bitten	positive
bleiben	negative
blog	negative
brauchen	negative
bringen	negative
buch	positive
bvb	positive
böse	negative
c	negative
cm	negative
cool	positive
d	negative
d:	negative
da	negative
dabei	positive
dafür	positive
damit	positive
dank	positive
danke	positive
danken	positive
dann	positive
dass	negative
dazu	negative
de	negative
dein	positive
denken	negative
denn	negative
deutsch	negative
deutschland	negative
die	negative
dies	positive
ding	negative
doch	negative
dortmund	positive
drei	negative
du	positive
durch	negative
dürfen	positive
dürftig	negative
e	negative
eben	positive
echt	negative
egal	negative
eh	negative
eher	negative
eigen	negative
eigentlich	negative
ein	negative
eine	positive
einfach	negative
einmal	positive
ekelerregend	negative
ekelhaft	negative
ekelig	negative
ende	negative
endlich	positive
er	negative
erfolg	negative
ernten	negative
erst	negative
es	positive
essen	positive
etwas	positive
eu	negative
euer	positive
euro	negative
facebook	negative
fahren	positive
falsch	negative
fan	positive
fast	negative
fc	negative
fertig	negative
fies	negative
film	negative
finden	positive
folge	negative
folgen	positive
foto	positive
frage	positive
fragen	positive
frau	negative
frei	positive
freuen	positive
freund	positive
freundlich	positive
früh	negative
frühling	positive
fußball	negative
fühlen	negative
für	negative
gameinsight	negative
ganz	positive
gar	negative
gb	negative
geben	negative
gegen	negative
gehen	positive
gehören	negative
geil	positive
geld	negative
gemein	negative
genau	negative
gepostet	negative
gerade	negative
geringwertig	negative
gerne	positive
gestern	positive
gewinnen	positive
glauben	positive
gleich	negative
glück	positive
glücklich	positive
goldmünze	positive
google	negative
gott	negative
gratis	negative
groß	negative
gucken	negative
gut	positive
gute	positive
h	negative
hab	negative
haben	positive
hallo	positive
halt	negative
halten	negative
hamburg	positive
handy	negative
hassen	negative
haus	negative
hd	positive
heißen	negative
helfen	negative
herz	positive
heute	positive
hier	positive
hinzufügen	negative
hoch	negative
hoffen	positive
hässlich	negative
höherwertig	positive
hören	negative
hübsch	positive
i	negative
ich	positive
ihr	positive
immer	negative
immortalis	negative
in	negative
info	negative
internet	negative
ipad	negative
ipadgames	negative
iphone	negative
iphonegames	negative
irgendwie	negative
irrig	negative
is	negative
it	negative
ja	negative
jahr	negative
je	negative
jede	positive
jemand	positive
jetzt	positive
job	negative
jung	positive
kaufen	negative
keine	negative
kennen	positive
kind	negative
klar	negative
klein	positive
kleinanzeige	positive
km	positive
kommen	positive
kopf	negative
korrekt	positive
kostenlos	negative
kurz	positive
können	positive
lachen	negative
land	negative
lang	positive
lange	positive
lassen	negative
laufen	negative
leben	negative
leider	negative
lernen	positive
lesen	negative
let	negative
letzt	negative
leute	negative
lieb	positive
liebe	positive
lieben	positive
liegen	negative
link	negative
live	positive
los	positive
m	negative
machen	positive
mai	negative
mal	positive
man	negative
manchmal	negative
mangelhaft	negative
mann	positive
me	negative
mehr	negative
mein	positive
meinen	negative
mensch	negative
minderwertig	negative
minute	negative
mission	negative
misslich	negative
mit	negative
monat	negative
morgen	positive
musik	positive
mögen	positive
münchen	positive
müssen	positive
n	negative
na	positive
nach	negative
nachrangig	negative
nachricht	negative
nacht	negative
nah	negative
nahrungseinheiten	positive
naja	negative
natürlich	positive
negativ	negative
nehmen	negative
nein	negative
nen	negative
nett	positive
neu	negative
neue	positive
news	positive
nicht	negative
nichts	negative
nie	negative
noch	negative
nun	positive
nur	negative
o	negative
ob	positive
oder	negative
of	positive
oh	negative
ohne	negative
ok	positive
okay	negative
on	positive
online	negative
ostsee	negative
paar	positive
pegelmv	positive
play	positive
portal	negative
positiv	positive
problem	negative
raus	negative
recht	negative
reden	negative
richtig	positive
rt	positive
s	positive
sagen	positive
sammeln	positive
schaffen	negative
schauen	positive
scheißen	negative
scheußlich	negative
schlafen	positive
schlecht	negative
schlimm	negative
schnell	positive
schon	positive
schreiben	positive
schule	negative
schwach	negative
schwarz	negative
schädlich	negative
schön	positive
sehen	negative
sehr	positive
sein	negative
seit	negative
seite	negative
selbst	negative
sex	positive
sich	negative
sicher	positive
sie	negative
sie|sie	positive
sitzen	positive
so	negative
sofort	positive
sogar	negative
sollen	positive
sondern	negative
sonne	positive
sonntag	positive
sonst	negative
sowas	negative
spaß	positive
spiel	negative
spielen	negative
sprechen	negative
spät	negative
stadt	negative
statt	negative
stehen	negative
stellen	negative
stimmen	negative
stunde|stunden	negative
suchen	positive
super	positive
süß	positive
t	negative
tag	positive
teil	negative
tendenz	negative
the	positive
thema	negative
tip	negative
to	positive
toll	positive
top	positive
total	negative
treffen	positive
tribez	negative
trotzdem	positive
tun	negative
tv	negative
tweet	positive
twitter	positive
u	negative
uhr	positive
um	negative
unangenehm	negative
und	negative
unerfreulich	negative
unglücklich	negative
ungünstig	negative
unrecht	negative
unser	negative
unter	negative
unterlegen	negative
v	negative
verdienen	negative
verdorben	negative
vergessen	negative
verkauf	negative
verkaufen	positive
verstehen	negative
via	negative
video	positive
viel	negative
viele	positive
vielleicht	positive
voll	negative
von	negative
vor	negative
w	positive
wann	positive
warten	positive
warum	negative
was	positive
weg	negative
wegen	negative
weil	negative
weit	negative
weiter	positive
weiß	positive
welche	positive
welt	negative
wenige	negative
wenn	negative
wer	positive
werden	negative
wetter	positive
wichtig	negative
widerlich	negative
widerwärtig	negative
wie	negative
wieder	positive
wieso	negative
wir	positive
wirklich	negative
wissen	negative
wo	negative
woche	negative
wochenende	positive
wohl	positive
wollen	positive
wort	negative
wünschen	positive
x	positive
you	negative
zeigen	negative
zeit	positive
zu	negative
zurück	positive
zusammen	positive
zwei	positive
zwischen	negative
|	positive
~	positive
übel	negative
über	negative
überlegen	positive
überragend	positive
♥	positive
