!	positive
!...	positive
"	negative
#	positive
#eldena	negative
#oie	negative
#pöl	negative
#sex	negative
#wieck	negative
$	positive
%	negative
%ironicsmiley	positive
%link	negative
%mail	positive
%negsmiley	negative
%negsmileye	negative
%negsmileyen	negative
%negsmileyeria	negative
%possmiley	positive
%possmiley3	positive
%possmiley33	positive
%possmiley333	positive
%possmileyas	negative
%possmileyder	negative
%possmileye	negative
%possmileyer	negative
%possmileyie	negative
%possmileyu	positive
%possmileyuml	negative
%smiley	negative
%user	positive
%user-playlist	negative
%user-video	negative
&	positive
&amp;	positive
&gt;	negative
&lt;	negative
'	negative
(	negative
(8	negative
(;	positive
)	negative
):	negative
);	negative
*	negative
**	positive
***	positive
****	negative
*-*	positive
+	negative
+1	positive
,	positive
-	negative
-,-	negative
.	negative
..	negative
..!	positive
...	positive
...!	positive
....	negative
......	negative
...?	positive
..._...	negative
..?	negative
._.	negative
._...	negative
/	negative
0:0	negative
0:2	negative
1	negative
1)_	negative
1,2	negative
1,5	negative
1-	negative
1/2	positive
1/3	negative
1/4	negative
1/5	negative
1/7	negative
1/8	negative
10	negative
10-	positive
100	negative
1000	positive
11	negative
12	negative
13	negative
14	negative
15	positive
150	positive
16	negative
17	negative
18	positive
19	positive
1:0	negative
1:1	negative
1:2	negative
1d_	positive
1h_	negative
1x_	positive
2	negative
2)_	negative
2,5	negative
2-	negative
2/2	negative
20	negative
200	positive
2000	negative
20]_	positive
21	positive
21]_	positive
22	positive
22]_	positive
23	positive
23]_	negative
24	positive
24]_	negative
24h_	negative
25	positive
25]_	negative
26	negative
27	negative
28	positive
28]_	negative
2:0	negative
2:1	negative
2h_	positive
2x_	positive
3	positive
3)_	negative
3,5	negative
3-	positive
3/4	negative
30	negative
300	positive
30]_	negative
32	negative
32]_	negative
33	positive
33]_	negative
34]_	negative
35	positive
35]_	negative
36]_	negative
37	positive
37]_	negative
38]_	negative
39	negative
39]_	negative
3:0	negative
3:2	negative
3d_	positive
3x_	negative
4	positive
4-	positive
40	positive
40]_	negative
41	positive
41]_	negative
43]_	negative
45	negative
46]_	negative
47]_	negative
48]_	negative
49]_	negative
4:1	negative
4s_	positive
4x_	negative
5	positive
5-	negative
50	negative
500	positive
59	negative
5s_	negative
6	negative
60	negative
7	positive
7-	positive
70	negative
75	negative
8	negative
80	negative
9	negative
90	negative
99	negative
:	negative
:'(	negative
:'d	negative
:(	negative
::	negative
:d	positive
:p	negative
;	negative
</s>	negative
=	negative
?	negative
?!	negative
?...	positive
??	negative
??!	negative
???	negative
????	negative
?????	negative
@	positive
@card@	negative
@youtube	positive
[	negative
\	positive
]	negative
]:	negative
^	positive
_	negative
`	positive
a	positive
a.	negative
a1	positive
a2	negative
a3	negative
a4	negative
a5	negative
a6	negative
a7	negative
a8	negative
aa	negative
aachen	negative
aalen	negative
ab	negative
aba	negative
abbrechen	negative
abend	positive
abendblatt	positive
abendessen	positive
abends	positive
abenteuer	positive
aber	negative
abgabe	negative
abgeben	negative
abgefahren	negative
abgehen	negative
abgeordnete	negative
abgeschlossen.	positive
abholen	positive
abhängig	negative
abi	positive
abitur	positive
ablaufen	negative
ablehnen	negative
ablenken	positive
ablenkung	positive
abmahnung	negative
abnehmen	positive
abnehmlösung	negative
abo	negative
abonennten	positive
abonnent	positive
abonnieren	positive
about	positive
abs	negative
absage	negative
absagen	negative
absatz	negative
abschaffen	negative
abschaffung	negative
abschalten	positive
abschied	negative
abschließen	negative
abschluss	positive
absehen	negative
abseits	negative
absetzen	negative
absicht	negative
absolut	negative
absolutemehrheit	negative
absolvieren	negative
abstand	negative
abstieg	negative
abstiegskampf	negative
abstimmen	negative
abstimmung	negative
absturz	negative
absurd	negative
abteilung	negative
abwarten	negative
abwechslung	positive
ac	negative
acc	positive
accessoire	positive
account	negative
accounts	negative
acer	negative
ach	negative
achja	positive
achso	negative
acht	negative
achten	negative
achtung	negative
action	negative
ad	negative
ada	negative
adac	negative
adam	positive
adapter	negative
add	positive
ade	negative
adidas	negative
adler	negative
admin	positive
adobe	negative
adresse	positive
adventure	positive
af	positive
afd	negative
affe	negative
affiliate	positive
affäre	negative
afghanistan	negative
afrika	negative
after	positive
afx	negative
ag	negative
again	negative
agb	negative
age	negative
agent	negative
agentur	negative
aggressiv	negative
ah	negative
aha	negative
ahaha	negative
ahahaha	negative
ahh	positive
ahhh	negative
ahnen	negative
ahnung	negative
ai	negative
ain	negative
aint	negative
air	positive
airline	positive
airlines	negative
airport	positive
aja	negative
ak	negative
aka	negative
akademie	negative
akku	negative
ako	negative
akt	negative
aktie	negative
aktion	negative
aktionstag	negative
aktionär	negative
aktiv	negative
aktivieren	negative
aktivist	negative
aktivität	negative
aktualisieren	negative
aktualisiert	negative
aktuell	negative
aku	negative
akw	negative
akzent	positive
akzeptieren	negative
al	negative
alaba	negative
alarm	negative
albern	negative
albert	negative
album	positive
aldi	negative
alex	positive
alexander	negative
ali	negative
alice	negative
aliens	negative
alkohol	positive
all	negative
allah	negative
alle	positive
allein	negative
alleine	positive
allen	positive
aller	negative
allerdings	negative
allergie	negative
allerseits	positive
allgemein	negative
allgemeine	negative
allgäu	positive
allianz	negative
alltag	negative
alone	negative
alonso	negative
alp	positive
alpha	negative
alptraum	negative
als	negative
also	negative
alt	positive
alte	negative
alter	negative
alternativ	positive
alternative	negative
althagen	negative
altmaier	negative
altona	negative
altstadt	positive
alu	positive
alufelgen	negative
aluminium	negative
always	negative
am	positive
amanda	negative
amateur	positive
amateure	negative
amazing	positive
amazon	negative
ambiente	positive
amd	negative
american	positive
amerika	negative
amerikaner	negative
amerikanisch	negative
ami	negative
amor	positive
amp	negative
amp;	negative
ampel	negative
amsterdam	positive
amt	negative
amtlich	negative
amüsant	negative
an	positive
an.	negative
anal	positive
analog	negative
analyse	negative
analysieren	negative
analyst	negative
anbau	negative
anbieten	positive
anbieter	negative
anblick	negative
and	positive
andauernd	negative
ander	negative
andere	negative
anders	negative
andre	negative
andrea	negative
andreas	positive
android	negative
androidgames	positive
andy	positive
anerkennung	negative
anfang	negative
anfangen	negative
anfassen	negative
anfrage	negative
anfragen	negative
anfänger	positive
anfühlen	negative
ang	negative
angabe	negative
angeben	negative
angeblich	negative
angebot	negative
angebotsende	negative
angehen	negative
angehörige	negative
angel	negative
angela	negative
angenehm	positive
angesichts	negative
angestellte	negative
angreifen	negative
angriff	negative
angst	negative
angucken	negative
anhalt	negative
anhänger	negative
anhören	negative
animal	negative
anime	negative
ankauf	negative
anklage	negative
anklam	negative
ankommen	positive
ankündigen	negative
ankündigung	negative
anlage	negative
anlass	negative
anlegen	positive
anleger	negative
anleihe	negative
anleitung	positive
anlässlich	negative
anmachen	negative
anmelden	positive
anmeldung	negative
ann	positive
anna	positive
anne	positive
annehmen	negative
annewill	negative
anonym	negative
anonymous	negative
anpassen	negative
anpfiff	negative
anpissen	negative
anregung	positive
anruf	negative
anrufen	positive
anrufer	negative
ans	positive
ansage	negative
ansagen	positive
ansatz	negative
anschauen	positive
anscheinend	negative
anschlag	negative
anschliessend	positive
anschließen	negative
anschluss	negative
anschreiben	positive
ansehen	negative
ansicht	negative
ansonsten	positive
ansprechen	positive
anspruch	negative
anspruchsvoll	positive
anstatt	positive
anstellen	negative
anstrengend	positive
anständig	positive
anteil	negative
anti	negative
antifa	negative
antik	negative
antrag	negative
antreten	negative
antun	negative
antwort	negative
antworten	positive
antwort|antworten	negative
anwalt	negative
anwendung	negative
anwesend	positive
anzahl	negative
anzeige	negative
anzeigen	negative
anzeiger	positive
anzeige|anzeigen	negative
anziehen	positive
anzug	positive
anzünden	negative
ao	positive
ap	negative
apa	negative
apfel	negative
apotheke	negative
app	negative
appe	negative
appen	negative
appetit	positive
applaus	positive
apple	negative
apps	negative
appstore	negative
apr	negative
april	negative
aprilscherz	negative
apropos	negative
aquaristik	negative
aquarium	negative
ar	negative
arabisch	negative
arbeit	positive
arbeiten	positive
arbeiter	negative
arbeitgeber	negative
arbeitnehmer	negative
arbeitslos	negative
arbeitslose	negative
arbeitslosigkeit	negative
arbeitsmarkt	negative
arbeitsplatz	negative
arbeitstag	positive
arbeit|arbeiten	positive
architekt	positive
architektur	negative
archiv	negative
ard	negative
are	positive
arena	negative
arg	negative
argentinien	negative
argh	negative
argument	negative
arm	negative
armband	negative
armee	negative
armselig	negative
armut	negative
arm|arme	negative
arnautovic	negative
around	positive
arrogant	negative
arsch	negative
arschloch	negative
arsenal	negative
art	negative
arte	negative
arten	negative
article	positive
artikel	negative
arts	positive
arzt	negative
as	positive
aschaffenburg	negative
asiatisch	negative
asien	negative
ask	negative
aso	positive
asozial	negative
ass	positive
assad	negative
assi	negative
assistent	negative
asus	negative
at	negative
atem	negative
athen	negative
atmen	positive
atmosphäre	positive
atom	negative
atomangriff	negative
atommüll	negative
attack	negative
attacke	negative
attackieren	negative
attentat	negative
attentäter	negative
attraktiv	positive
au	negative
aua	negative
auch	negative
auch.	positive
audi	positive
audio	positive
aue	negative
auf	negative
aufbau	positive
aufbauen	negative
auffallen	negative
aufgabe	negative
aufgeben	negative
aufgeregt	positive
aufgrund	negative
aufhalten	negative
aufheben	negative
aufhängen	negative
aufhören	negative
aufkleber	negative
aufklärung	negative
aufladen	positive
auflage	negative
auflösen	negative
auflösung	negative
aufm	positive
aufmachen	negative
aufmerksam	positive
aufmerksamkeit	negative
aufn	negative
aufnahme	negative
aufnehmen	positive
aufpassen	negative
aufregen	negative
aufregend	positive
aufregung	negative
aufruf	negative
aufräumen	positive
aufs	positive
aufschrei	negative
aufsichtsrat	negative
aufstand	negative
aufstehen	positive
aufsteiger	negative
aufstellen	negative
aufstellung	positive
aufstieg	negative
auftakt	negative
auftauchen	negative
auftrag	negative
auftreten	negative
auftritt	positive
aufwachen	positive
aufwachsen	negative
aufwand	negative
aufwendig	negative
auge	positive
augen	positive
augenblick	negative
augenbraue	negative
augsburg	negative
augsburger	negative
august	negative
auktion	negative
auml	negative
aur	negative
aus	negative
aus.	negative
ausbau	negative
ausbauen	negative
ausbildung	positive
ausblick	negative
ausdenken	negative
ausdruck	negative
ausdrücken	negative
auseinander	negative
ausfahrt	positive
ausfall	negative
ausfallen	negative
ausflug	positive
ausführlich	negative
ausgabe	negative
ausgeben	negative
ausgehen	negative
ausgerechnet	negative
ausgewählt	negative
ausgezeichnet	positive
ausgleich	negative
ausgründen	positive
aushalten	negative
auslachen	positive
ausland	negative
auslosung	positive
ausländer	negative
ausländisch	negative
auslösen	negative
ausm	negative
ausmachen	negative
ausnahme	negative
ausnahmsweise	negative
ausnutzen	negative
auspacken	positive
ausprobieren	positive
ausrasten	negative
ausrede	negative
ausreichend	negative
aussage	negative
ausschalten	negative
ausschlafen	positive
ausschließen	negative
ausschnitt	negative
ausschuss	negative
aussehen	negative
aussicht	positive
aussprechen	negative
aussteigen	positive
ausstellung	negative
aussuchen	negative
austausch	positive
austauschen	negative
australien	negative
austria	positive
ausverkaufen	negative
auswahl	negative
auswendig	negative
auswirkung	negative
auswählen	negative
auszeichnen	negative
auszeichnung	negative
ausziehen	positive
auto	positive
autobahn	negative
autofahrer	negative
autogramm	positive
autokorrektur	negative
automatisch	negative
autor	negative
autorin	positive
autsch	negative
außenminister	negative
außenßen	negative
außer	negative
außerdem	negative
außergewöhnlich	positive
außerhalb	negative
av	negative
ava	positive
avatar	positive
avnds	positive
aw	negative
award	positive
awards	positive
away	negative
awesome	negative
aww	positive
awww	positive
awwww	negative
axel	negative
az	negative
azubi	positive
b	negative
b.	negative
ba	positive
babe	positive
babes	negative
babo	negative
baby	positive
babysitter	positive
bach	negative
bachelor	positive
back	negative
backen	positive
backup	positive
bad	positive
baden	negative
badewanne	negative
badezimmer	positive
badstuber	negative
bag	negative
bah	negative
bahn	positive
bahnbilderde	negative
bahnen	negative
bahnhof	negative
bahn|bahnen	positive
bahrain	negative
balance	positive
bald	positive
bali	negative
balkon	positive
ball	negative
bamberg	positive
bambi	negative
banane	negative
band	negative
bandbreite	negative
bandname	negative
bangen	negative
banget	negative
bangladesch	negative
bank	negative
bankablehnung	negative
banker	negative
bankgeheimnis	negative
banner	positive
bar	negative
barack	positive
barbara	positive
barbie	positive
barca	negative
barcelona	negative
bargeld	negative
barhöft	negative
barometer	negative
bart	negative
barth	negative
barça	negative
base	positive
basel	negative
basf	negative
basic	negative
basis	negative
basketball	positive
basler	negative
bass	positive
basteln	positive
basti	positive
batman	positive
batterie	negative
battle	positive
battlefield	negative
bau	negative
bauarbeit	negative
bauch	negative
bauen	negative
bauer	negative
baum	negative
baumarkt	negative
baustelle	negative
bay	negative
bayer	negative
bayerisch	negative
bayern	negative
bayreuth	positive
bayrisch	negative
bb	negative
bbc	negative
bda	negative
bdk13	negative
be	negative
beach	negative
beachten	negative
beamter	negative
beantragen	negative
beantworten	positive
bearbeiten	positive
beat	positive
beate	positive
beatrice	positive
beatrix	negative
beautiful	positive
beauty	positive
beben	negative
beck	positive
becken	negative
becker	negative
bed	negative
bedanken	positive
bedarf	negative
bedauernswert	negative
bedenken	negative
bedeuten	negative
bedeutung	negative
bedienen	negative
bedingung	negative
bedrohen	negative
bedrohung	negative
bedürfnis	positive
beeilen	positive
beeindrucken	negative
beeindruckend	negative
beeinflussen	negative
beenden	negative
befinden	negative
befreien	negative
befreunden	positive
befürchten	negative
begeben	positive
begegnen	positive
begegnung	positive
begehen	negative
begeistern	positive
begeistert	positive
beginn	negative
beginnen	positive
begleiten	positive
begleitung	positive
begreifen	negative
begrenzt	negative
begriff	negative
begründung	negative
begrüßen	positive
behalten	negative
behandeln	negative
behandlung	negative
behaupten	negative
beheben	negative
beherrschen	negative
behindern	negative
behindert	negative
behinderung	negative
behörde	negative
bei	negative
beibringen	negative
beide	positive
beige	negative
beileid	negative
bein	negative
beinahe	negative
beinen	negative
being	negative
beispiel	negative
beitrag	negative
beißen	negative
bekannt	negative
bekannte	positive
bekanntlich	negative
bekennen	negative
beklagen	negative
bekloppt	negative
bekommen	positive
bekämpfen	negative
belassen	negative
belasten	negative
belegen	negative
beleidigen	negative
beleidigung	negative
beleuchtung	negative
belgien	negative
belieben	negative
belieber	negative
beliebers	negative
beliebt	negative
believe	negative
bella	positive
bellen	negative
belohnen	negative
belohnung	positive
bemerken	negative
bemühen	positive
ben	negative
benehmen	negative
beneiden	positive
benennen	negative
benjamin	negative
bent	negative
benutzen	negative
benutzt	positive
benz	negative
benzin	negative
benötigen	negative
beobachten	negative
bequem	positive
ber	negative
beraten	positive
berater	negative
beratung	negative
berechnen	negative
bereich	negative
bereit	negative
bereiten	negative
bereits	negative
bereuen	negative
berg	negative
bergen	negative
bericht	negative
berichten	negative
berichterstattung	negative
berlin	positive
berliner	negative
bern	negative
bernd	positive
berner	negative
bernhard	negative
beruf	negative
berufen	negative
beruflich	positive
beruhigen	positive
berühmt	negative
berühren	positive
besaufen	negative
bescheid	positive
bescheißen	negative
bescheuert	negative
beschissen	negative
beschließen	negative
beschluss	negative
beschreiben	negative
beschreibung	positive
beschwerde	negative
beschweren	negative
beschäftigen	negative
beschäftigt	negative
beschäftigte	negative
beschäftigung	positive
beseitigen	negative
besetzen	negative
besiegen	negative
besitzen	negative
besitzer	negative
besonder	positive
besonders	positive
besorgen	positive
besorgt	positive
besprechen	negative
besser	positive
besserung	negative
bestandsdatenauskunft	negative
beste	positive
bestehen	negative
bestehend	negative
bestelle	negative
bestellen	positive
bestellung	negative
bestens	positive
bestimmen	negative
bestimmt	negative
bestrafen	negative
bestseller	negative
beständig	negative
bestätigen	negative
besuch	positive
besuchen	positive
besucher	negative
besuch|besuchen	positive
beta	negative
beteiligen	negative
beteiligung	negative
beten	positive
beton	positive
betonen	negative
betrachten	negative
betreffen	negative
betreiben	negative
betreten	negative
betreuung	positive
betrieb	negative
betriebsrat	negative
betriebssystem	negative
betrinken	positive
betrug	negative
betrunken	positive
betrügen	negative
bett	positive
better	negative
bettwäsche	negative
beurteilen	negative
bevor	positive
bevorzugen	negative
bevölkerung	negative
bewahren	negative
bewegen	negative
bewegung	negative
beweis	negative
beweisen	negative
bewerben	positive
bewerbung	positive
bewerten	negative
bewertung	negative
bewohner	negative
bewundern	positive
bewusst	negative
bewölken	negative
bezahlen	positive
bezahlt	negative
bezeichnen	negative
beziehen	negative
beziehung	negative
beziehungsstatus	positive
bezirk	negative
bezug	negative
bezüglich	negative
bge	negative
bgh	negative
bgh.	negative
bgt	negative
bh	positive
bi	positive
bibel	negative
bibliothek	negative
bids	negative
bieber	negative
bielefeld	negative
bien	positive
biene	negative
bier	positive
bieten	negative
big	negative
bike	positive
bikini	positive
bilanz	negative
bild	positive
bilden	negative
bildschirm	negative
bildung	negative
bill	positive
billig	negative
bin	negative
binden	positive
bio	negative
bioshock	positive
bir	positive
birthday	negative
bis	positive
bisch	negative
bischof	negative
bisher	negative
bisherig	negative
bislang	negative
bisschen	positive
bissel	positive
bissl	positive
biste	positive
bit	negative
bitch	negative
bitches	negative
bitcoin	negative
bitcoins	negative
bitte	positive
bittel	positive
bitten	positive
bitter	negative
bj	negative
bj.	negative
bkh	negative
bl	negative
bla	negative
black	negative
blackberry	negative
blank	negative
blasen	positive
blase|blasen	negative
blatt	negative
blau	negative
bleiben	negative
blick	negative
blicken	negative
blind	negative
blitz	negative
blitzer	negative
block	negative
blocken	negative
blockieren	negative
blog	negative
bloggen	positive
blogger	positive
blogpost	positive
blogs	negative
blond	positive
blondine	positive
blood	negative
blowjob	positive
bloß	negative
blu	negative
blue	positive
bluetooth	negative
blume	positive
bluse	positive
blut	negative
bluten	negative
blutig	negative
blöd	negative
blödsinn	negative
blühen	negative
blüte	negative
bmw	negative
bn	positive
bo	negative
boa	negative
boah	negative
boar	negative
board	positive
boateng	negative
bob	positive
bochum	negative
bock	positive
bocken	negative
bodden	negative
boden	negative
bodensee	positive
body	negative
boeing	negative
bohren	negative
bombe	negative
bomben	negative
bombenanschlag	negative
bomber	negative
bombe|bomben	negative
bon	positive
bond	negative
bonität	negative
bonn	negative
bonus	positive
book	negative
books	negative
boom	negative
boomen	positive
boot	negative
bord	positive
boris	negative
born	negative
borussia	negative
bosch	positive
boss	negative
boston	negative
bostonmarathon	negative
bot	negative
bote	negative
botschaft	negative
botschafter	positive
bottrop	positive
bout	positive
box	negative
boxen	negative
box|boxen	negative
boy	negative
br	negative
branche	negative
brand	negative
brandenburg	negative
brandneu	positive
brasilien	negative
braten	positive
brauch	positive
brauchen	negative
brauchen|gebrauchen	negative
braun	negative
braunschweig	positive
brav	positive
bravo	positive
brd	negative
break	negative
breaking	negative
brechen	negative
breisgau	negative
breit	negative
bremen	negative
bremer	negative
bremerhaven	negative
bremsen	negative
brennen	negative
brenner	positive
brief	negative
briefkasten	negative
brigitte	negative
brille	positive
bringen	negative
brite	negative
britisch	negative
british	positive
bro	positive
brot	negative
brother	negative
brown	negative
browser	negative
browsergame	negative
bruder	negative
bruno	positive
brust	positive
brutal	negative
bruyne	negative
brötchen	positive
brücke	negative
brüllen	negative
brüssel	negative
bs	negative
bsc	negative
bt	negative
btw	positive
btw13	negative
bu	negative
buat	negative
buch	positive
buchen	positive
buchstabe	negative
buchtip	positive
bude	positive
budget	negative
buffon	negative
bug	negative
buiten	negative
bull	negative
bulle	negative
bullshit	negative
bumsen	negative
bund	negative
bundesbank	negative
bundeskanzlerin	negative
bundesland	negative
bundesliga	negative
bundespräsident	negative
bundesrat	negative
bundesregierung	negative
bundestag	negative
bundestagswahl	negative
bundesverfassungsgericht	negative
bundeswehr	negative
bundesweit	negative
bunt	positive
burg	negative
burgenland	negative
burger	negative
burn	negative
burnout	negative
bus	negative
busch	negative
busfahrer	positive
bushido	negative
business	negative
but	negative
butter	negative
button	positive
buy	positive
buyten	negative
bvb	positive
bvbmal	positive
bvbmcf	positive
bvbrmd	negative
bw	negative
by	negative
bye	positive
bz	negative
bzw	negative
bzw.	negative
bäcker	positive
bäh	negative
bär	negative
böblingen	negative
börse	negative
böse	negative
bühne	negative
bündnis	negative
bürger	negative
bürgermeister	negative
büro	positive
c	negative
c.	negative
c1	positive
c2	positive
c3	positive
ca	positive
ca.	negative
cabrio	positive
cache	negative
cafe	positive
café	positive
call	negative
cam	positive
camp	positive
campus	negative
can	positive
candy	negative
cannabis	negative
canon	negative
captain	positive
car	positive
cara	negative
card	negative
care	positive
carl	negative
carolingntm	negative
case	positive
cash	negative
casino	negative
casper	positive
casting	negative
castle	positive
cat	positive
cause	negative
cc	positive
ccm	negative
cd	positive
cds	negative
cdu	negative
ce	positive
cent	negative
center	positive
ceo	positive
cest	negative
ch	positive
cha	positive
challenge	positive
champion	positive
champions	positive
championsleague	positive
chan	positive
chance	negative
change	negative
channel	negative
chaos	negative
charakter	positive
charlie	positive
charmant	positive
charme	positive
charts	negative
chat	positive
chatte	positive
chatten	positive
check	positive
checken	positive
chef	negative
chefin	positive
chefredakteur	negative
chelsea	negative
chemie	negative
chemnitz	negative
chf	negative
chihuahua	negative
chill	positive
chillen	positive
china	negative
chinese	negative
chinesisch	negative
chip	negative
choreo	negative
chris	positive
christ	negative
christian	negative
christina	positive
christine	positive
christlich	negative
christoph	positive
chrome	negative
chronik	negative
chuck	negative
ciao	positive
circus	negative
city	positive
cl	negative
clan	negative
class	positive
classic	positive
claudia	positive
clean	positive
clever	positive
client	negative
clip	negative
clips	negative
cloud	positive
clown	negative
club	positive
cm	negative
co	negative
co.	negative
co2	negative
coach	positive
coaching	positive
cocktail	positive
cod	negative
code	positive
cola	negative
collection	positive
com	negative
come	positive
comeback	negative
comedy	negative
comic	positive
coming	negative
commerce	negative
commerzbank	negative
community	positive
computer	negative
con	positive
concert	positive
consultant	positive
consulting	negative
cont	positive
content	negative
contest	positive
control	positive
controller	positive
cook	negative
cool	positive
core	positive
corporate	negative
cosplay	positive
cottbus	negative
couch	positive
countdown	negative
courtsider	negative
cousin	positive
cousine	positive
cover	positive
cpu	negative
crash	negative
crazy	positive
creed	negative
creme	negative
crew	positive
crm	negative
cro	positive
cross	positive
crowdfunding	negative
cry	negative
crystal	negative
csr	negative
csrracing	negative
csu	negative
cup	positive
cut	negative
cute	negative
cuz	positive
cyber	negative
d	negative
d.	negative
d:	negative
da	negative
da.	positive
dabei	positive
dach	positive
dachen	negative
dad	negative
dadurch	negative
dafuq	negative
dafür	positive
dagegen	negative
dah	negative
daheim	positive
daher	positive
dahin	positive
dahinter	negative
daily	negative
daimler	negative
damals	negative
dame	positive
damit	positive
damn	negative
dan	positive
dana	positive
danach	positive
dance	positive
dancen	positive
daneben	negative
dani	positive
daniel	negative
daniele	positive
dank	positive
dankbar	positive
danke	positive
danken	positive
dankeschön	positive
dann	positive
dante	negative
dapd	negative
dar	negative
daran	positive
darauf	positive
daraus	negative
darin	negative
dark	negative
darlehen	positive
darmstadt	positive
darstellen	negative
darum	negative
darunter	negative
darüber	negative
das	negative
dass	negative
dasselbe	positive
dat	negative
data	negative
date	positive
datei	negative
datenbank	negative
datenschutz	negative
dating	positive
datum	negative
dauer	negative
dauerhaft	negative
dauern	negative
dauernd	negative
daumen	positive
david	negative
davon	negative
davor	negative
dawanda	positive
dax	negative
day	positive
days	negative
dazu	negative
dazwischen	negative
db	negative
dc	negative
dd	positive
ddr	negative
de	negative
dead	negative
deaktivieren	negative
deal	positive
dear	negative
death	positive
debatte	negative
debk	negative
debüt	negative
decke	positive
deckel	negative
decken	negative
deep	positive
defekt	negative
defiance	negative
definieren	negative
definition	negative
definitiv	negative
deh	negative
dein	positive
deko	positive
del	negative
dellen	negative
deluxe	positive
dementieren	negative
demi	positive
demnächst	positive
demo	negative
demokratie	negative
demokratisch	negative
demonstration	negative
demonstrieren	negative
demos	negative
den	positive
denken	negative
denken|gedenken	negative
denn	negative
dennis	positive
dennoch	positive
depp	negative
depression	negative
depressiv	negative
der	negative
derb	negative
derby	negative
dere	negative
dermaßen	negative
derzeit	negative
des	negative
deshalb	negative
design	positive
designer	positive
designerstück	positive
desktop	positive
dessous	positive
desto	negative
deswegen	negative
detail	negative
deuten	negative
deutlich	negative
deutsch	negative
deutsche	negative
deutschland	negative
deutschsprachig	positive
devise	negative
dey	negative
dezember	negative
dezent	negative
dfb	negative
dfbpokal	negative
dgap	negative
dhl	positive
di	negative
dia	negative
diabetes	negative
diagnose	negative
dialekt	negative
dialog	negative
diamant	positive
diamond	positive
diane	positive
dicht	negative
dick	positive
did	negative
die	negative
dieb	negative
diebstahl	negative
diego	negative
diejenige	negative
diejenigen	negative
dienen	negative
dienst	negative
dienstag	positive
dienstleister	negative
dienstleistung	negative
dies	positive
diese	positive
diesel	positive
dieselb	negative
diesjährig	negative
diesmal	negative
dieter	negative
dietikon	negative
digital	negative
digittrade	negative
diktator	negative
dil	negative
dildo	negative
din	negative
ding	negative
dingen	negative
dinner	positive
dino	negative
direct	negative
direction	positive
direkt	negative
dirk	negative
dirty	negative
dis	negative
disco	positive
diskret	positive
diskriminierung	negative
diskussion	negative
diskutieren	negative
disney	positive
display	negative
dit	negative
dito	positive
divers	negative
diy	positive
diät	negative
dj	positive
djsjsjdj	negative
dlc	negative
dm	positive
dms	negative
dn	positive
dna	negative
dnt	negative
do	positive
doc	positive
doch	negative
doctor	negative
dog	positive
dogs	negative
doktor	negative
doku	negative
dokument	negative
dokumentation	negative
doll	negative
dollar	negative
dom	positive
domain	positive
domains	negative
domian	negative
dominieren	negative
don	negative
donald	positive
donau	negative
done	negative
dong	negative
donnerstag	positive
dont	negative
doof	negative
dopa	negative
doppel	positive
doppelt	negative
dorf	negative
dort	positive
dortmund	positive
dortmunder	negative
dose	negative
double	positive
down	negative
download	negative
downloaden	negative
dozent	positive
dpa	negative
dr	negative
dr.	negative
drache|drachen	negative
dragon	negative
dragovic	negative
drama	negative
dramatisch	negative
dran	negative
drauf	negative
draus	positive
draußen	positive
draw	positive
draxler	negative
dream	positive
dreams	positive
dreck	negative
dreckig	negative
dreh	positive
drehen	positive
drei	negative
dreieck	negative
dreier	positive
dreierpack	negative
dreimal	negative
dreist	negative
dresden	negative
dresdner	negative
dress	positive
drin	negative
dringend	positive
drink	positive
drinnen	positive
dritt	negative
drittel	negative
drive	negative
droge	negative
drohen	negative
drohn	negative
drohung	negative
dropbox	positive
dropshipping	negative
drossel	negative
drosselkom	negative
drosseln	negative
drosselung	negative
druck	negative
drucken	negative
drucker	negative
drum	positive
drunter	positive
drängen	negative
drüber	positive
drücken	negative
dsds	positive
dsl	negative
dt	negative
dtn	negative
du	positive
dual	positive
dubai	negative
dubstep	negative
ducati	negative
duell	negative
duft	negative
duisburg	negative
dumm	negative
dummheit	negative
dunkel	negative
dunkelheit	negative
dunkeln	negative
duo	positive
durch	negative
durchaus	negative
durcheinander	negative
durchhalten	positive
durchlesen	negative
durchs	positive
durchschnittlich	negative
durchschnittsgeschwindigkeit	negative
durchsetzen	negative
dus	positive
dusche	positive
duschen	positive
dusche|duschen	positive
dutch	negative
dutchland	negative
duty	negative
dutzend	negative
dvd	positive
dvds	positive
dx	negative
dynamisch	negative
dynamo	negative
dämlich	negative
dänemark	negative
dö	negative
döner	positive
dösen	negative
dünn	negative
dürfen	positive
dürftig	negative
düsseldorf	negative
e	negative
e.	negative
ea	negative
earth	positive
easy	positive
eat	positive
ebay	negative
eben	positive
ebene	negative
ebenfalls	positive
ebenso	negative
ebook	negative
ebooks	negative
ec	positive
echh13	positive
echt	negative
echteliebe	positive
ecke	negative
ecken	negative
ed	negative
edel	positive
edelstahl	negative
edited	negative
edition	positive
een	negative
effekt	negative
effektiv	negative
effizient	positive
effzeh	positive
eftn	negative
eg	negative
egal	negative
ego	negative
eh	negative
ehe	negative
ehefrau	negative
ehemalig	negative
ehemann	positive
eher	negative
ehm	negative
ehre	negative
ehren	positive
ehrlich	positive
ei	negative
eifach	negative
eifersüchtig	negative
eig	negative
eig.	negative
eigen	negative
eigenschaft	negative
eigentlich	negative
eignen	negative
eilen	negative
eilmeldung	negative
eimer	positive
ein	negative
einander	negative
einbauen	negative
einblick	negative
einbrecher	negative
einbruch	negative
einchecken	positive
eindeutig	negative
eindruck	positive
eine	positive
einen	positive
einer	negative
einfach	negative
einfallen	negative
einfamilienhaus	negative
einfluss	negative
einfügen	negative
einführen	negative
einführung	negative
eingeben	positive
eingehen	negative
einheit	negative
einhorn	positive
einig	negative
einige	negative
einigen	negative
einigung	negative
einkauf	positive
einkaufen	positive
einkommen	negative
einladen	positive
einladung	positive
einmal	positive
einmalig	positive
einnahme	negative
einpacken	positive
einreichen	negative
einrichten	positive
einrichtung	positive
eins	negative
einsam	positive
einsamkeit	negative
einsatz	negative
einschalten	positive
einschlafen	negative
einsetzen	negative
einst	negative
einsteigen	positive
einsteiger	negative
einstein	positive
einstellen	negative
einstellung	negative
einstieg	negative
eintracht	negative
eintrag	negative
eintragen	positive
eintreffen	negative
eintritt	negative
einwandfrei	positive
einwohner	negative
einzeln	negative
einziehen	negative
einzig	negative
einzigartig	positive
einzige	negative
einzug	negative
eis	negative
eisbär	negative
eisenstadt	negative
eisern	negative
eishockey	negative
eiskalt	negative
ek	negative
ekelerregend	negative
ekelhaft	negative
ekelig	negative
eklig	negative
el	positive
elbe	positive
electronic	positive
elefant	negative
elegant	positive
elektrisch	positive
elektro	positive
elektronik	negative
elektronisch	negative
element	negative
elend	negative
elf	negative
elfmeter	negative
elia	positive
elite	negative
eltern	positive
em	negative
email	positive
emails	negative
emma	positive
emo	negative
emotion	negative
emotional	negative
empfang	positive
empfangen	negative
empfehlen	positive
empfehlenswert	positive
empfehlung	positive
empfinden	negative
empfänger	negative
empire	positive
ems	negative
en	positive
end	negative
ende	negative
enden	positive
endgültig	negative
endlager	negative
endlich	positive
endlos	positive
endspurt	negative
energie	negative
energiewende	negative
energy	positive
eng	negative
engagement	negative
engagieren	negative
engel	positive
engine	positive
england	negative
englisch	negative
english	negative
enjoy	positive
enorm	negative
ensemble	negative
entdecken	negative
ente	negative
enterprise	negative
entertainment	negative
entfernen	negative
entfernt	negative
entfernung	negative
entfolgen	positive
entfolgt	positive
entführen	negative
entgegen	negative
entgehen	negative
enthalten	negative
enthüllen	negative
enthüllung	negative
entlang	positive
entlassen	negative
entscheiden	negative
entscheidend	negative
entscheidung	negative
entschuldigen	negative
entschuldigung	negative
entspannen	positive
entspannt	positive
entspannung	positive
entsprechen	negative
entsprechend	negative
entstehen	negative
enttäuschen	negative
enttäuscht	negative
enttäuschung	negative
entweder	negative
entwickeln	negative
entwickler	negative
entwicklung	negative
entwurf	negative
eos	positive
ep	negative
epic	negative
episch	negative
episode	negative
er	negative
erdbeben	negative
erdbeere	positive
erde	negative
erde|erden	negative
erdrutsch	negative
ereignis	negative
erfahren	positive
erfahrung	negative
erfassen	negative
erfinden	negative
erfindung	negative
erfolg	negative
erfolgen	negative
erfolgreich	positive
erfolgreiche	positive
erfreuen	positive
erfurt	positive
erfüllen	positive
erfüllung	positive
ergeben	negative
ergebnis	negative
ergänzen	negative
erhalt	negative
erhalten	negative
erheben	negative
erholen	positive
erholsam	positive
erholung	positive
erhältlich	negative
erhöhen	negative
eric	negative
erik	negative
erinnern	negative
erinnerung	negative
erkennen	negative
erkenntnis	negative
erklären	negative
erklärung	negative
erkunden	positive
erkältung	negative
erlangen	negative
erlauben	negative
erleben	positive
erlebnis	negative
erledigen	negative
erleichtern	negative
ermitteln	negative
ermittler	negative
ermittlung	negative
ermöglichen	negative
ern	negative
erneuerbare	negative
erneut	negative
ernst	negative
ernsthaft	negative
ernten	negative
ernähren	negative
ernährung	negative
erobern	positive
erotik	positive
erotisch	positive
erreichbar	negative
erreichen	negative
erreicht.	negative
errichten	negative
ers	positive
ersatz	negative
erscheinen	negative
erschießen	negative
erschrecken	negative
erschreckend	negative
erschüttern	negative
ersetzen	negative
erst	negative
erstaunlich	negative
erste	negative
erstellen	negative
erstklassig	positive
erstmal	positive
erstmals	positive
ertragen	negative
erwachen	positive
erwachsen	positive
erwachsene	negative
erwarten	negative
erwartung	negative
erweitern	negative
erweiterung	negative
erwerben	negative
erwin	positive
erwischen	negative
erwägen	negative
erwählen	negative
erwähnen	negative
erwähnung	negative
erwünscht	positive
erzeugen	negative
erziehen	negative
erzieher	negative
erziehung	negative
erzielen	negative
erzählen	positive
eröffnen	positive
eröffnung	positive
es	positive
escort	positive
espresso	positive
ess	negative
essen	positive
esslingen	positive
et	positive
etc.	negative
etwa	negative
etwas	positive
eu	negative
euer	positive
eur	negative
euro	negative
eurokrise	negative
europa	negative
europaweit	negative
europe	positive
europäisch	negative
eurozone	negative
eva	positive
even	negative
event	positive
events	negative
eventuell	positive
ever	positive
evil	negative
evolution	negative
evtl	positive
evtl.	positive
ewig	positive
ewigkeit	positive
ewm	negative
ex	negative
exakt	negative
excel	negative
existenz	negative
existieren	negative
exklusiv	negative
experiment	negative
experte	negative
explodieren	negative
explosion	negative
export	negative
express	positive
extern	negative
extra	positive
extrem	negative
ey	negative
eyes	negative
ez	negative
ezb	negative
f	negative
f.	negative
f1	negative
f95	negative
fa	negative
fabian	positive
face	negative
facebook	negative
facepalm	negative
fach	positive
facharzt	negative
fachen	negative
fachkraft	positive
fact	negative
facts	positive
fahne	negative
fahrbahn	negative
fahren	positive
fahren|führen	negative
fahrer	negative
fahrrad	positive
fahrt	negative
fahrzeug	negative
fail	negative
fair	positive
fake	negative
fakt	negative
faktor	negative
faktum	negative
fall	negative
falle	negative
fallen	negative
fallend	negative
fallen|fällen	negative
fallen|gefallen	negative
falls	positive
falsch	negative
fame	negative
familie	positive
family	positive
fan	positive
fang	negative
fangen	positive
fantasie	negative
fantastisch	positive
fantasy	negative
faq	negative
far	negative
farbe	negative
farbig	positive
farm	negative
fashion	positive
fassade	negative
fassen	negative
fast	negative
faszinierend	negative
faul	negative
faust	negative
faut	negative
fav	positive
faven	positive
favorisieren	positive
favorit	negative
favs	negative
faz	negative
fazit	negative
fb	negative
fbi	negative
fc	negative
fca	negative
fcb	negative
fcbayern	negative
fcbfcb	positive
fcbfcn	negative
fcbjuv	negative
fcbnews	negative
fcbscf	positive
fcbwob	negative
fck	negative
fcn	positive
fcsp	negative
fdp	negative
fe	negative
feat	negative
feature	positive
features	negative
februar	negative
feed	positive
feedback	positive
feel	negative
feeling	negative
feels	negative
fehlen	negative
fehlend	negative
fehler	negative
feier	positive
feierabend	positive
feiern	positive
feiertag	positive
feier|feiern	positive
fein	positive
feind	negative
feld	negative
felge	negative
felix	positive
femen	negative
feminismus	negative
fenster	positive
ferien	positive
ferienhaus	negative
ferienwohnung	positive
fern	positive
fernbedienung	positive
fernsehen	negative
fernseher	negative
ferrari	positive
fertig	negative
fertigen	negative
fesseln	positive
fest	negative
festhalten	negative
festival	negative
festnahme	negative
festnehmen	negative
festnetz	negative
festplatte	positive
feststellen	negative
fetisch	positive
fett	negative
feucht	positive
feuchte	positive
feuer	negative
feuern	positive
feuerwehr	negative
ff	positive
ffm	positive
fh	negative
fi	positive
fiat	negative
ficken	negative
fieber	negative
fies	negative
fifa	negative
fight	negative
figur	negative
filiale	negative
film	negative
filmen	negative
filter	negative
final	positive
finale	negative
finanz	negative
finanzamt	negative
finanziell	negative
finanzieren	negative
finanzierung	negative
finanzkrise	negative
finanzminister	negative
finanznachrichten	negative
find	negative
finden	positive
finds	negative
finger	negative
fingern	negative
fink	negative
finnland	negative
fire	negative
firefox	negative
firma	negative
first	positive
fisch	positive
fischer	positive
fit	positive
fitness	positive
fitnessstudio	positive
fitnesstraining	negative
five	positive
fix	positive
flach	negative
flair	positive
flamme	negative
flasche	negative
flash	negative
flat	positive
flatrate	negative
flatrates	negative
flausch	positive
flauschig	positive
fleisch	negative
fleißig	positive
flensburg	positive
flexibel	positive
flexstrom	negative
flickr	negative
fliegen	negative
fliegend	negative
flieger	positive
fliege|fliegen	negative
fließen	negative
flirt	positive
flirten	positive
flo	positive
flohmarkt	positive
flop	negative
florian	positive
fluch	negative
flucht	negative
flug	positive
flughafen	negative
flugzeug	negative
flur	negative
fluss	negative
flyer	positive
fläche	negative
flüchten	negative
flüchtling	negative
flügel	negative
flüssig	negative
flüstern	negative
fm	positive
fo	positive
focus	negative
fokus	negative
folge	negative
folgen	positive
folgend	negative
folie	negative
follback	negative
follow	positive
follower	positive
followern	positive
followerpower	positive
followers	negative
fonds	negative
food	positive
football	positive
for	positive
force	negative
ford	negative
fordern	negative
forderung	negative
forever	positive
forex	negative
form	negative
format	negative
formel	negative
formel1	negative
formen	negative
formulieren	positive
forscher	negative
forschung	negative
fort	positive
fortschritt	negative
fortsetzung	negative
fortuna	negative
forum	negative
forward	positive
foto	positive
fotograf	positive
fotografie	negative
fotografieren	positive
fotze	negative
found	negative
foursquare	positive
fox	negative
foyer	negative
fpö	negative
fr	positive
fra	positive
fracking	negative
frage	positive
fragen	positive
fraktion	negative
france	negative
frank	negative
franke	negative
frankfurt	negative
frankfurter	negative
frankreich	negative
franz	negative
franziskus	negative
franzose	negative
französisch	negative
frau	negative
frauen	negative
frauenquote	negative
frauentausch	negative
freak	negative
frech	negative
frechheit	negative
free	negative
frei	positive
freiburg	negative
freie	positive
freiheit	negative
freikarte	positive
freitag	positive
freiwillig	positive
freizeit	positive
fremd	negative
fremde	positive
fremdgehen	negative
fresh	positive
fressen	negative
freude	positive
freuen	positive
freund	positive
freunden	positive
freundin	positive
freundlich	positive
freundschaft	positive
fri	negative
friday	negative
frieden	negative
friedlich	positive
friedrich	negative
friedrichshafen	negative
friedrichshain	positive
friend	negative
friends	negative
frieren	positive
frisch	positive
friseur	positive
frisur	positive
fritz	positive
froh	positive
from	negative
front	negative
frosch	negative
frucht	negative
frust	negative
fröhlich	positive
früh	negative
früher	negative
frühjahr	negative
frühjahrsputz	negative
frühling	positive
frühlingsfest	positive
frühlingsgefühl	positive
frühstück	positive
frühstücken	positive
fsv	negative
ft	negative
ft.	positive
ftw	negative
fu	negative
fuchs	negative
fuck	negative
fucking	negative
fukushima	negative
fulda	negative
full	positive
fun	positive
fund	negative
funk	positive
funken	negative
funktion	negative
funktionieren	negative
funktionierend	negative
funktionsfähig	positive
funny	negative
fur	positive
furchtbar	negative
fusion	positive
fussball	positive
fussballspiel	negative
futter	negative
future	negative
fuß	negative
fußball	negative
fußballer	negative
fähig	negative
fähigkeit	negative
fähre	negative
fällen	positive
färben	positive
fördern	negative
förderung	negative
fü	positive
fügen	negative
fühlen	negative
führen	negative
führend	negative
führer	negative
führerschein	positive
führung	negative
führungskraft	negative
füllen	negative
fünf	negative
fünft	negative
für	negative
fürchten	negative
fürn	negative
fürs	positive
fürth	negative
füttern	positive
f√ºr	negative
g	negative
g.	negative
ga	negative
gaat	negative
gabriel	negative
gabs	negative
gag	negative
gaga	negative
gak	positive
gala	positive
galatasaray	negative
galaxy	positive
galerie	negative
galle	negative
gambling	negative
game	positive
gameinsight	negative
gameplay	positive
gamer	negative
games	negative
gaming	positive
gang	negative
gangster	negative
ganz	positive
ganze	positive
ganzheitlich	positive
gar	negative
garage	positive
garantie	negative
garantieren	negative
garantiert	positive
garde	positive
garen	positive
garnicht	negative
garten	positive
gas	negative
gast	negative
gauck	negative
gay	negative
gb	negative
gc	negative
ge	positive
geb	positive
geben	negative
geben.	negative
gebiet	negative
gebloggt	negative
gebot	negative
gebrauchen	negative
gebraucht	negative
geburt	negative
geburtstag	positive
geburtstagsparty	positive
gebären	negative
gebäude	negative
gebühr	negative
gedanke	positive
gedanken	positive
gedenken	negative
gedicht	positive
geduld	positive
gedächtnis	negative
geehrt	positive
geeignet	negative
gefahr	negative
gefallen	positive
gefangen	negative
gefavt	negative
gefecht	negative
gefunden	negative
gefährden	negative
gefährlich	negative
gefällig	negative
gefängnis	negative
gefühl	positive
gefühlt	positive
gegen	negative
gegend	negative
gegensatz	negative
gegenseitig	positive
gegenstand	negative
gegenstromanlagen	positive
gegenteil	negative
gegenwart	negative
gegenüber	negative
gegner	negative
gehalt	negative
geheim	negative
geheimdienst	negative
geheimdiät	negative
geheimnis	negative
geheimtip	negative
gehen	positive
gehirn	negative
gehn	positive
gehts	positive
geht’s	positive
gehören	negative
gehören|hören	negative
gehört	negative
geil	positive
geilen	positive
geist	negative
geistig	negative
gel	negative
gelassen	negative
gelaunt	positive
gelb	negative
geld	negative
geldanlage	negative
gelegenheit	positive
geliebt	positive
gelingen	negative
gellen	positive
gelsenkirchen	positive
gelten	negative
gelungen	positive
gema	negative
gemacht	negative
gemein	negative
gemeinde	negative
gemeinsam	positive
gemessen	negative
gemäß	negative
gemüse	positive
gemütlich	positive
gen	negative
genau	negative
genauso	negative
gender	negative
genehmigen	negative
general	positive
generation	negative
generell	negative
genial	positive
genie	negative
genießen	positive
genre	negative
gentleman	positive
genug	negative
genuss	positive
genügen	negative
genügend	negative
georg	negative
george	negative
gepflegt	positive
geplant	negative
gepostet	negative
geprüft	negative
gepäck	positive
ger	negative
gerade	negative
geraten	negative
geraten|raten	negative
gerecht	negative
gerechtigkeit	negative
gerhard	negative
gericht	negative
gering	negative
geringwertig	negative
german	negative
germany	negative
gern	positive
gerne	positive
geruch	negative
gerät	negative
geräusch	negative
gerücht	negative
ges	negative
gesagt	negative
gesamt	negative
gesamtpaket	negative
geschafft	negative
geschehen	negative
geschenk	positive
geschichte	negative
geschickt	positive
geschlecht	negative
geschlossen	negative
geschmack	negative
geschrieben	negative
geschwindigkeit	negative
geschwister	positive
geschäft	negative
geschäftsführer	negative
geschäftsstelle	positive
gesehn	negative
gesellschaft	negative
gesellschaftlich	negative
gesetz	negative
gesetzlich	negative
gesicht	negative
gespannt	positive
gespräch	positive
gestalten	positive
gestaltung	positive
gestehen	negative
gestern	positive
gestrig	negative
gesucht	positive
gesund	positive
gesundheit	negative
gesundheits	positive
get	positive
getinline	negative
getrennt	positive
getränk	positive
getting	negative
getweetet	negative
getwittert	negative
gewalt	negative
gewaltig	negative
gewerkschaft	negative
gewicht	negative
gewinn	negative
gewinnen	positive
gewinner	positive
gewinnspiel	positive
gewiss	negative
gewissen	negative
gewitter	positive
gewohnheit	negative
gewähr	negative
gewöhnen	negative
gez	negative
gezellig	positive
gezielt	negative
gg	negative
ghz	negative
gi	negative
gibts	positive
gibt’s	negative
gier	negative
gießen	negative
gif	negative
gift	negative
gigantisch	negative
girl	positive
girls	positive
girokonto	negative
git	positive
gitarre	positive
give	positive
gk	negative
gl	negative
gladbach	negative
glanz	positive
glas	negative
glass	negative
glatt	positive
glaube	negative
glauben	positive
gleich	negative
gleichen	negative
gleichstellung	negative
gleichzeitig	positive
gleis	negative
global	negative
glänzen	negative
glück	positive
glücken	positive
glücklich	positive
glückspilz	positive
glückwunsch	positive
gm	negative
gmbh	positive
gnihihi	negative
gntm	negative
go	positive
goal	positive
god	negative
goethe	negative
going	negative
gold	negative
golden	negative
goldmünze	positive
goldpreis	negative
golf	negative
gomez	negative
gone	negative
good	positive
goodnight	negative
google	negative
googles	negative
got	positive
gott	negative
gp	positive
gps	negative
gr	negative
gr.	negative
grab	negative
graben	positive
grad	positive
graf	negative
grafik	negative
grammatik	negative
grand	positive
grandios	positive
gras	negative
gratis	negative
gratulation	positive
gratulieren	positive
grau	positive
grausam	negative
graz	positive
great	positive
green	positive
greenpeace	negative
greet	positive
greifen	negative
greifswald	negative
grenze	negative
grenzen	negative
grey	negative
griechenland	negative
griechisch	negative
griff	negative
grill	positive
grillen	positive
grille|grillen	positive
grimm	positive
grinsen	positive
grob	negative
gronkh	positive
grosse	negative
group	positive
growin	negative
groß	negative
großartig	positive
großbritannien	negative
großstadt	positive
großzügig	positive
grund	negative
grundeinkommen	negative
grundlage	negative
grundschule	negative
grundstück	negative
grundsätzlich	negative
grund|gründen	negative
gruppe	negative
gruselig	negative
gruß	positive
größe	negative
grün	negative
gründen	negative
gründer	negative
gründung	negative
grüne	negative
grüßen	positive
gs	negative
gs4	negative
gsi	negative
gt	positive
gta	negative
guardiola	positive
gucken	negative
guide	positive
guido	positive
gummi	negative
gun	negative
gurke	negative
gustavo	negative
gustl	negative
gut	positive
gut.	negative
gutachten	negative
gute	positive
gute.	positive
guthaben	negative
gutschein	positive
gutscheincode	negative
gutten	positive
guy	negative
guys	negative
gw	negative
gyal	negative
gymnasium	negative
gysi	negative
gähnen	negative
gänsehaut	negative
göd	positive
gönnen	positive
görlitz	negative
gös	positive
göttingen	negative
göttlich	positive
götze	negative
gü	negative
gültig	negative
gündogan	negative
günstig	positive
günther	negative
güt	positive
güte	positive
gütersloh	negative
h	negative
h.	negative
h7n9	negative
h96	negative
ha	positive
haag	negative
haar	negative
haaren	negative
haarfarbe	positive
hab	negative
haben	positive
haben.	negative
habs	positive
hach	positive
hacken	negative
hacker	negative
had	negative
hafen	positive
haft	negative
haftbefehl	negative
hagen	positive
haha	negative
hahah	positive
hahaha	negative
hahahah	negative
hahahaha	negative
hahahahah	negative
hahahahaha	negative
hahn	negative
hai	negative
hain	negative
hair	positive
haken	negative
hala	positive
halb	positive
halbfinal	negative
halbfinale	positive
halbwegs	positive
halbzeit	negative
hall	positive
halle	negative
hallen	negative
halligalli	negative
hallo	positive
hals	negative
halt	negative
halten	negative
haltestelle	negative
haltung	negative
ham	negative
hamburg	positive
hamburger	negative
hameln	negative
hamm	negative
hammer	positive
hamster	positive
han	negative
hand	negative
handball	negative
handbuch	positive
handel	negative
handeln	negative
handelsblatt	negative
hands	negative
handtasche	negative
handwerk	positive
handwerker	positive
handy	negative
hangout	positive
hannover	negative
hans	negative
hansa	negative
happy	positive
harald	negative
hard	negative
hardcore	negative
hardware	negative
harlem	positive
harmlos	negative
harry	positive
hart	negative
hartz	negative
hartz4	negative
hartziv	negative
has	positive
hase	positive
hashtag	negative
hashtags	negative
hass	negative
hassen	negative
hast	positive
hasten	negative
hat.	negative
hate	negative
hater	negative
hats	negative
hauen	negative
haufe	negative
haul	positive
hauptbahnhof	negative
hauptsache	negative
hauptstadt	negative
hauptsächlich	negative
hauptversammlung	negative
haus	negative
hausaufgabe	positive
hausen	positive
hausfrau	positive
haushalt	negative
haustier	positive
haustür	negative
haut	negative
have	positive
hb	positive
hbf	positive
hd	positive
he	negative
head	negative
header	positive
headset	positive
heart	negative
heben	negative
heeft	positive
heels	negative
heft	negative
heftig	negative
hehe	positive
hehehe	positive
hei	positive
heide	positive
heidelberg	positive
heidi	positive
heil	negative
heilbronn	negative
heilen	negative
heilig	negative
heim	positive
heimarbeit	positive
heimat	negative
heimisch	negative
heimlich	positive
heimsieg	negative
heimspiel	negative
hein	positive
heinrich	negative
heinz	positive
heiraten	positive
heise	negative
heiter	positive
heizen	positive
heizung	positive
heiß	negative
heißen	negative
held	positive
helfen	negative
helfer	positive
hell	positive
hello	positive
helm	negative
helmut	negative
help	positive
hemd	positive
hend	positive
henry	positive
her	negative
heraus	negative
herausfinden	negative
herausforderung	negative
herb	negative
herbert	negative
herbst	negative
herd	negative
here	negative
herkommen	negative
hermann	negative
herne	positive
herr	positive
herrlich	positive
herrschen	negative
herstellen	negative
hersteller	negative
hertha	positive
herum	positive
herunter	negative
hervorragend	positive
herz	positive
herzen	positive
herzinfarkt	negative
herzlich	positive
hesch	negative
hessen	negative
hessisch	negative
het	negative
heuen	positive
heulen	negative
heuschnupfen	negative
heute	positive
heuteshow	negative
heutig	negative
heutzutage	negative
hey	positive
heynckes	negative
hh	positive
hi	positive
hier	positive
hiermit	positive
hifi	positive
high	positive
highlight	positive
hihi	positive
hihihi	positive
hildesheim	positive
hilfe	positive
hilfreich	negative
him	negative
himmel	positive
himym	negative
hin	positive
hinaus	negative
hinbekommen	negative
hinein	positive
hingehen	positive
hinlegen	negative
hinspiel	negative
hinten	negative
hinter	negative
hintergrund	negative
hinterher	negative
hinterlassen	negative
hintern	positive
hinweis	negative
hinweisen	negative
hinzu	negative
hinzufügen	negative
hip	negative
hipster	negative
hirn	negative
historisch	negative
hit	positive
hitler	negative
hitze	negative
hm	negative
hm.	positive
hmm	negative
hmmm	negative
hna	negative
ho	negative
hobbit	positive
hobby	positive
hoch	negative
hochgeladen	positive
hochladen	negative
hochschule	negative
hochwasser	negative
hochwertig	positive
hochzeit	positive
hocken	positive
hoeness	negative
hof	positive
hoffen	positive
hoffenheim	negative
hoffentlich	negative
hoffnung	negative
hoje	positive
hold	positive
holen	positive
holger	positive
holland	negative
hollande	negative
hollywood	negative
holstein	negative
holz	positive
home	negative
homepage	negative
homo	negative
homosexuell	negative
homöopathie	negative
honda	negative
honig	negative
hood	negative
hop	negative
hope	positive
hopp	negative
horizont	negative
horn	negative
horror	negative
horrorfilm	negative
horst	positive
hose	negative
hot	positive
hotel	positive
hours	negative
house	negative
how	negative
hp	negative
hpa	negative
hq	negative
hr	negative
hs	negative
hsv	positive
ht	negative
htc	negative
html	negative
htt	negative
http	negative
huawei	negative
huch	negative
hugo	negative
huh	negative
huhn	positive
huhu	positive
hui	positive
hum	negative
human	negative
hummels	negative
humor	negative
hund	positive
hundert	negative
hunger	negative
hungern	negative
hungrig	negative
hungry	negative
hunter	negative
hure	negative
hurensohn	negative
hurra	negative
hust	negative
husten	negative
hut	positive
hyp	negative
hype	negative
hypnose	negative
hä	negative
hälfte	negative
händler	negative
hängen	negative
hässlich	negative
hätt	negative
häufig	negative
hö	negative
höchstens	negative
höhe	negative
höherwertig	positive
höhle	negative
höhö	positive
hölle	negative
hörbuch	negative
hören	negative
hörwick	positive
hös	negative
hübsch	positive
hülle	negative
hündin	positive
hüpfen	positive
hüt	positive
hütte	positive
i	negative
i'll	negative
i'm	negative
i.	positive
ibktwit	negative
ibm	negative
ic	positive
ice	negative
ich	positive
ich.	negative
ichs	negative
ick	positive
icon	positive
id	positive
ideal	positive
idee	positive
idiot	negative
idol	positive
ie	negative
if	negative
ig	negative
ignorieren	negative
ih	negative
ihk	negative
ihr	positive
ii	negative
iii	negative
ik	negative
ikea	negative
il	positive
ilike	positive
illegal	negative
illner	negative
illusion	negative
im	negative
ima	negative
imac	positive
image	negative
immer	negative
immerhin	negative
immernoch	negative
immobilie	negative
immortalis	negative
impression	positive
impuls	negative
imwesten	positive
in	negative
indect	negative
indem	positive
index	negative
indie	positive
indien	negative
indisch	negative
individuell	positive
indonesien	negative
industrie	negative
infinit	negative
infinite	negative
info	negative
infografik	negative
informatik	negative
informatiker	negative
information	negative
informieren	negative
infrastruktur	negative
ingenieur	negative
ingolstadt	negative
inhalt	negative
ini	negative
initiative	negative
inkl	negative
inklusive	negative
inn	positive
innen	positive
innenminister	negative
innenstadt	positive
inner	negative
innerhalb	negative
innerlich	negative
innovation	negative
innovativ	positive
innsbruck	negative
insel	negative
inserat	negative
insgesamt	negative
insider	negative
insolvenz	negative
inspiration	positive
inspirieren	positive
instagram	positive
installation	negative
installieren	negative
institut	negative
instrument	negative
integration	positive
integrieren	negative
integriert	negative
intel	negative
intelligent	positive
intelligenz	negative
intensiv	positive
interaktiv	negative
interessant	negative
interessante	negative
interesse	negative
interessieren	negative
interessiert	positive
intern	negative
international	negative
internet	negative
internets	negative
interview	positive
interviewen	positive
into	positive
intro	positive
investieren	negative
investition	negative
investment	negative
investor	negative
inzwischen	negative
ion	negative
ios	negative
ip	negative
ipad	negative
ipadgames	negative
iphone	negative
iphonegames	negative
iphones	negative
ipod	negative
iq	negative
irak	negative
iran	negative
irgend	negative
irgendeine	negative
irgendetwas	negative
irgendjemand	positive
irgendwann	positive
irgendwas	negative
irgendwelche	negative
irgendwer	negative
irgendwie	negative
irgendwo	positive
irland	negative
iron	negative
ironie	negative
ironisch	negative
irre	negative
irren	negative
irrig	negative
is	negative
isch	negative
ish	negative
islam	negative
island	negative
israel	negative
israelisch	negative
isses	negative
isso	negative
ist.	negative
istanbul	negative
ists	positive
it	negative
italien	negative
italiener	negative
italienisch	negative
its	negative
itu	negative
itunes	negative
iv	negative
iwf	negative
iya	negative
j	negative
j.	negative
ja	negative
ja.	negative
jaa	negative
jaaa	positive
jaaaa	positive
jaaaaa	positive
jack	negative
jacke	negative
jacket	positive
jackson	negative
jade	positive
jagd	negative
jagen	negative
jah	negative
jahr	negative
jahrelang	negative
jahreszeit	positive
jahrhundert	negative
jahrzehnt	negative
jai	positive
jaja	negative
jam	positive
james	negative
jammern	negative
jan	positive
jana	positive
januar	negative
jap	positive
japan	negative
japanisch	negative
jarmen	negative
jarmon	negative
jason	positive
jauch	negative
java	positive
javi	negative
jay	positive
jazz	negative
jb	negative
jbb	negative
je	negative
jean	negative
jeans	positive
jede	positive
jedenfalls	negative
jederzeit	negative
jedesmal	negative
jedoch	negative
jegliche	negative
jemals	positive
jemand	positive
jen	negative
jena	negative
jennifer	positive
jenny	positive
jens	positive
jenseits	negative
jep	positive
jepp	positive
jesus	negative
jet	negative
jetz	positive
jetzt	positive
jeweils	negative
jij	negative
jim	negative
jmd	positive
jo	positive
joa	negative
joachim	negative
job	negative
jobangebot	positive
jobbörse	positive
jobbörsen	negative
jobcenter	negative
jobs	negative
joe	positive
joggen	positive
joghurt	positive
johann	negative
johannes	positive
john	negative
johnny	negative
joiz	negative
jonas	negative
jones	negative
jong	negative
jop	positive
josef	negative
journal	negative
journalismus	negative
journalist	negative
ju	positive
jubeln	negative
jubiläum	negative
jucken	negative
jude	negative
jugend	negative
jugendliche	negative
juhu	positive
juli	negative
julia	positive
julian	positive
jullie	negative
jung	positive
junge	negative
jungfrau	positive
jungs	positive
juni	negative
junior	positive
jup	positive
jupp	positive
jury	negative
jus	negative
juso	positive
just	positive
justin	negative
justiz	negative
juve	negative
juventus	negative
juvfcb	negative
jva	negative
jz	positive
jäger	negative
jährig	negative
jährige	negative
jährigen	negative
jähriger	negative
jähriges	negative
jährlich	negative
jörg	negative
jüdisch	negative
jürgen	negative
k	negative
k.	positive
ka	positive
kabel	negative
kack	negative
kacke	negative
kacken	negative
kader	negative
kaffee	positive
kai	negative
kaiser	negative
kaiserslautern	negative
kak	negative
kakao	positive
kalender	positive
kalorie	positive
kalt	negative
kamera	positive
kamin	positive
kaminofen	positive
kampagne	negative
kampf	negative
kamu	negative
kan	positive
kanada	negative
kanal	positive
kandidat	negative
kangen	negative
kaninchen	negative
kann.	positive
kanns	negative
kannste	positive
kanton	negative
kanzler	positive
kanzlerin	negative
kanzlerkandidat	negative
kapieren	negative
kapitalismus	negative
kapitel	negative
kapitän	negative
kaputt	negative
karl	negative
karlshagen	negative
karlsruhe	negative
karnin	negative
karriere	negative
karte	negative
kartoffel	negative
karton	positive
kasse	negative
kassel	negative
kassieren	negative
kaste|kasten	negative
kat	positive
katar	negative
katastrophe	negative
kate	positive
kategorie	negative
kater	negative
katholisch	negative
katze	positive
katzen	positive
kauen	negative
kauf	negative
kaufen	negative
kaufmann	negative
kaum	negative
kay	positive
kb	negative
ke	negative
keep	positive
kehren	negative
kei	negative
keine	negative
keks	positive
keller	negative
kelly	negative
kelturio	negative
ken	negative
kennen	positive
kennenlernen	positive
kenntnis	negative
kerl	negative
kern	negative
kerze	negative
kette	negative
kevin	negative
key	positive
kg	negative
ki	negative
kichern	negative
kick	negative
kicken	negative
kicker	negative
kid	negative
kiel	positive
kiffen	negative
kik	negative
kill	negative
killer	negative
kilo	positive
kilometer	negative
kim	negative
kind	negative
kinder	negative
kinderbetreuung	negative
kindergarten	negative
kindersitz	negative
kinderzimmer	negative
kindheit	negative
kindle	positive
king	positive
kino	negative
kippe	negative
kippen	negative
kirche	negative
kiss	positive
kissen	positive
kiste	negative
kit	positive
kita	negative
kitten	positive
kitty	negative
kk	negative
kl	positive
klage	negative
klagen	negative
klagenfurt	negative
klamotte	negative
klang	negative
klappe	negative
klappen	positive
klar	negative
klartext	negative
klasse	positive
klassik	negative
klassiker	negative
klassisch	negative
klatschen	negative
klauen	negative
klaus	negative
klausur	negative
klavier	positive
kleben	negative
kleid	positive
kleiderschrank	negative
kleidung	negative
klein	positive
kleinanzeige	positive
kleine	positive
kleinigkeit	negative
kleinkind	positive
klettern	positive
klick	positive
klicke	negative
klicken	positive
klicks	negative
klima	positive
klimawandel	negative
klingeln	positive
klingen	negative
klinik	negative
klischee	negative
klo	negative
klopfen	positive
kloppen	positive
kloster	positive
klub	negative
klug	positive
klum	negative
klären	negative
km	positive
kmu	negative
knacken	negative
knackig	positive
knallen	negative
knallhart	negative
knapp	negative
knast	negative
kneipe	positive
knie	negative
knochen	negative
knopf	positive
know	negative
knp	negative
knuddel	positive
knuddeln	positive
knuffig	negative
ko	negative
koalition	negative
koblenz	positive
koch	positive
kochen	positive
koffer	positive
kohl	negative
kohle	negative
kohlenhydrat	negative
koi	positive
kok	negative
kollege	positive
kollegin	positive
kollektion	negative
kolumne	negative
kom	negative
kombi	negative
kombination	negative
kombinieren	positive
komfort	positive
komfortabel	positive
komisch	negative
kommen	positive
kommend	positive
kommentar	negative
kommentator	negative
kommentieren	negative
kommissar	negative
kommission	negative
kommune	negative
kommunikation	negative
kommunizieren	negative
kompakt	negative
kompass	positive
kompetent	positive
kompetenz	negative
komplett	positive
komplex	negative
kompliment	positive
komplizieren	negative
kompliziert	negative
kompromiss	negative
komt	negative
kondition	negative
kondom	negative
konferenz	negative
konflikt	negative
kongress	negative
konjunktur	negative
konkret	negative
konkurrent	negative
konkurrenz	negative
konsequent	negative
konsequenz	negative
konservativ	negative
konsole	negative
konstanz	negative
konsum	negative
kontakt	positive
kontaktieren	positive
kontext	negative
konto	negative
kontrolle	negative
kontrollieren	negative
konzentration	negative
konzentrieren	negative
konzept	negative
konzern	negative
konzert	positive
kooperation	negative
kopf	negative
kopfhörer	negative
kopfkino	negative
kopfschmerz	negative
kopieren	negative
kopp	negative
korb	positive
korea	negative
koreanisch	negative
korrekt	positive
korrektur	negative
korrigieren	negative
korruption	negative
kosen|kosten	negative
koserow	negative
kosmetik	positive
kosovo	negative
kosten	negative
kostenfrei	negative
kostenlos	negative
kostenloser	negative
kosternlos	negative
kostüm	positive
kotzen	negative
kp	negative
kr	negative
krabbenburger	negative
krachen	negative
kraft	negative
kraftfahrzeug	negative
kraftwerk	negative
kram	negative
krank	negative
krankenhaus	negative
krankenkasse	negative
krankenpfleger	positive
krankenversicherung	negative
krankheit	negative
krass	negative
kratzen	negative
kraut	negative
krawatte	negative
kreativ	positive
kreativität	negative
krebs	negative
kredit	negative
kreditkarte	negative
krefeld	negative
kreis	negative
kreisfrei	negative
kretschmann	negative
kreuz	negative
kreuzberg	positive
kreuzfahrt	positive
kreuzung	negative
krieg	negative
kriegen	negative
krimi	negative
kriminell	negative
krise	negative
kristina	negative
kritik	negative
kritiker	negative
kritisch	negative
kritisieren	negative
kroatien	negative
krone	positive
kroos	negative
kräftig	positive
ku	negative
kuba	negative
kuchen	positive
kugel	negative
kugelschreiber	negative
kuh	negative
kulisse	positive
kult	negative
kultur	negative
kummer	positive
kumpel	positive
kunde	negative
kunst	positive
kunststoff	negative
kununu	negative
kur	positive
kurier	negative
kurs	negative
kurt	negative
kurve	positive
kurz	positive
kurzfristig	negative
kurzgeschichte	negative
kurzversion	negative
kuscheln	positive
kuss	positive
kut	negative
kv	negative
kw	negative
kz	negative
käfig	negative
kälte	negative
kämpfen	negative
kämpfer	negative
kärnten	negative
käse	negative
kätzchen	positive
köln	positive
kölner	negative
könig	negative
königin	positive
können	positive
körper	positive
körperlich	negative
köstlich	negative
küche	positive
kühl	positive
kühlen	negative
kühlschrank	positive
kümmern	positive
kündigen	negative
kündigung	negative
künftig	negative
künstler	negative
künstlich	negative
kürze	negative
kürzen	negative
kürzlich	negative
küssen	positive
l	negative
l.	positive
la	positive
label	negative
labern	negative
lachen	negative
lache|lachen	positive
lachflash	negative
lack	positive
lackieren	positive
lade	negative
ladegerät	negative
ladekabel	negative
laden	positive
lady	positive
lage	negative
lager	negative
lagi	negative
lahm	negative
lampe	negative
lan	positive
lana	positive
land	negative
landen	negative
landgericht	negative
landkreis	negative
landrat	negative
landschaft	negative
landtag	negative
lang	positive
lange	positive
langeweile	positive
langfristig	negative
langsam	negative
langweilen	positive
langweilig	negative
lanz	negative
laptop	negative
lara	positive
lars	positive
lasagne	positive
lassen	negative
last	positive
lastrt	negative
lasttweet	negative
late	negative
latein	positive
latte	positive
lau	negative
lauf	positive
laufen	negative
laufend	negative
launch	negative
laune	positive
laura	positive
laut	negative
lauten	negative
lauter	negative
lauterbach	negative
lautfm	negative
lautsprecher	negative
law	negative
lawak	negative
layout	negative
laß	positive
lcd	negative
ld	negative
le	positive
lea	positive
leadership	negative
league	negative
leaks	negative
leben	negative
lebend	negative
lebendig	positive
lebenslang	negative
lebensmittel	negative
lebensversicherung	negative
leck	positive
lecken	negative
lecker	positive
led	negative
leder	positive
lediglich	negative
lee	positive
leer	negative
left	negative
legal	negative
legen	negative
legend	positive
legende	positive
legends	negative
legendär	negative
leggings	negative
leggins	positive
lego	positive
lehnen	negative
lehren	negative
lehrer	negative
lehrerin	negative
leiche	negative
leicht	negative
leid	negative
leiden	negative
leidenschaft	positive
leider	negative
leihen	positive
leinwand	negative
leipzig	negative
leipziger	negative
leise	positive
leisten	negative
leistung	negative
leiten	negative
leiter	positive
leitung	negative
lena	positive
lenken	negative
leo	negative
lernen	positive
les	positive
lesbe	negative
lesbisch	positive
lese	negative
lesen	negative
lesenswert	negative
leser	negative
lesetip	negative
lesezone	positive
lese|lesen	negative
lesung	negative
let	negative
lets	positive
letsdance	negative
letta	positive
letzt	negative
letztens	positive
let’s	negative
leuchten	positive
leute	negative
level	negative
leverkusen	negative
lewandowski	positive
lewis	positive
leyen	negative
lg	positive
li	negative
liberal	negative
licht	positive
lidl	negative
lie	negative
lieb	positive
liebe	positive
lieben	positive
liebevoll	positive
liebe|lieben	positive
liebhaber	positive
liebling	positive
liebste	positive
lied	positive
liefern	negative
lieferung	negative
liegen	negative
lieve	positive
life	positive
lifestyle	positive
liga	negative
light	negative
like	positive
liked	negative
liken	positive
likes	negative
lil	positive
lila	negative
limit	positive
line	positive
linie	negative
link	negative
linke	negative
linkedin	negative
linken	negative
links	negative
linux	negative
linz	negative
lippe	positive
lisa	positive
liste	negative
listen	negative
list|liste	negative
liter	negative
literatur	negative
little	positive
live	positive
livecam	negative
livestream	negative
liveticker	negative
livetracking	negative
living	positive
lizenz	negative
lkw	negative
lmao	negative
lo	positive
lob	positive
lobby	negative
loben	positive
location	positive
loch	negative
locken	positive
locker	positive
logik	negative
logisch	negative
logistik	negative
logitech	positive
logo	negative
lohn	negative
lohnen	negative
lokal	negative
london	negative
long	positive
look	positive
looking	positive
lord	negative
los	positive
losen	negative
losgehen	negative
loslassen	negative
loswerden	negative
lothar	negative
lotto	negative
louis	negative
lounge	positive
love	positive
low	positive
lp	positive
lpt	positive
lptlive	negative
lptrop	positive
lt	negative
lte	negative
lu	positive
luca	positive
lucasarts	negative
lucke	negative
lucky	negative
luder	negative
ludwig	negative
ludwigsburg	negative
ludwigshafen	positive
luft	positive
luftdr	negative
luftdruck	negative
lufthansa	negative
luiz	negative
lukas	positive
lumia	negative
lust	positive
lustig	negative
lutschen	negative
luven	negative
luxembourg	positive
luxemburg	negative
luxus	positive
luzern	negative
lw	negative
lyrics	negative
lächeln	positive
lächerlich	negative
ländernetz	negative
länge	positive
längst	negative
lärm	negative
lästern	negative
lästig	negative
läufer	positive
löschen	negative
lösen	negative
lösung	negative
löwe	negative
lübeck	positive
lücke	negative
lüftung	negative
lüge	negative
lügen	negative
lüge|lügen	negative
m	negative
m.	negative
m1ö	positive
m2	negative
mac	positive
macbook	negative
machbar	negative
mache	negative
machen	positive
machen.	negative
macher	positive
machs	positive
macht	negative
machts	positive
macklemore	negative
mad	negative
made	negative
madrid	negative
mafia	negative
magazin	positive
magdeburg	negative
magen	negative
magic	positive
magie	negative
magisch	positive
mah	positive
mahlzeit	positive
mahnen	negative
mai	negative
mail	positive
mails	negative
main	negative
mainstream	negative
mainz	positive
mais	negative
maischberger	negative
make	positive
makes	negative
making	positive
mal	positive
malaga	negative
malen	positive
maler	positive
mali	negative
mallorca	negative
mama	positive
mami	positive
man	negative
management	negative
manager	negative
manche	negative
manchester	negative
manchmal	negative
mandzukic	negative
manga	positive
mangel	negative
mangelhaft	negative
mangelnd	negative
mann	positive
mannheim	positive
mannschaft	negative
manor	negative
mans	negative
manu	positive
manuel	positive
map	positive
maps	positive
marathon	negative
marc	positive
marcel	negative
marco	positive
marcus	negative
margaret	negative
maria	positive
marie	positive
mario	positive
mark	negative
marke	negative
marketing	positive
markieren	negative
markt	negative
markt.	negative
marktplatz	negative
markus	positive
mars	positive
martin	negative
martinez	negative
martínez	negative
mary	negative
mas	positive
masa	positive
maschine	negative
maske	negative
maskulin	positive
massage	positive
masse	negative
massiv	negative
master	positive
match	negative
mate	positive
material	negative
mathe	negative
mathematik	negative
matratze	positive
matt	positive
matthias	positive
mau	negative
mauer	negative
maul	negative
maus	positive
max	positive
maximal	positive
may	negative
maybe	positive
maß	negative
maßnahme	negative
mb	positive
mbit	negative
mc	positive
mcdonalds	positive
mcfbvb	negative
mdr	negative
me	negative
meckern	negative
mecklenburg	negative
med	negative
media	negative
mediathek	negative
medikament	negative
medion	negative
mediterran	positive
medium	negative
medizin	negative
medizinisch	negative
meer	positive
meerschweinchen	positive
meet	positive
meeting	positive
mega	negative
meh	negative
mehr	negative
mehrere	negative
mehrfach	negative
mehrheit	negative
mei	negative
meier	negative
mein	positive
meinen	negative
meinung	negative
meist	negative
meiste	positive
meistens	negative
meister	positive
meistern	negative
meisterschaft	negative
meld	positive
melden	positive
meldung	negative
melodie	negative
memory	positive
men	negative
menge	negative
menno	negative
mensch	negative
menschen	negative
menschenrecht	negative
menschheit	negative
menschlich	negative
mention	positive
mentions	negative
menü	positive
mer	positive
mercedes	negative
merci	positive
merhaba	negative
merkel	negative
merken	negative
merkwürdig	negative
message	negative
messe	negative
messen	negative
messenger	positive
messer	negative
messi	negative
met	negative
metal	negative
metall	negative
meter	negative
methode	negative
metro	negative
mexiko	negative
meyer	negative
mg	positive
mh	negative
mhm	positive
mi	positive
mia	negative
miami	positive
miasanmeister	negative
miasanmia	positive
micha	positive
michael	positive
michel	negative
michelle	negative
micro	negative
microsoft	negative
mies	negative
miete	negative
mieten	positive
mieter	negative
mietwohnung	positive
mike	positive
mikro	positive
milan	negative
milch	negative
militär	negative
milliarde	negative
million	negative
millionlotto	negative
millionär	negative
mimen	positive
mimimi	negative
min	negative
min.	negative
mind	positive
minden	negative
minderwertig	negative
mindestens	negative
mindestlohn	negative
mine	negative
minecraft	negative
mini	positive
minimal	negative
minister	negative
ministerin	negative
ministerpräsident	negative
mint	positive
minus	negative
minute	negative
mio	negative
mio.	negative
mir	negative
mis	negative
mischen	negative
mischung	negative
miss	negative
miss50percent	positive
missbrauch	negative
missbrauchen	negative
mission	negative
misslich	negative
mist	negative
mit	negative
mitarbeiter	negative
mitarbeiterin	positive
mitbekommen	negative
mitbewohner	positive
mitbringen	positive
miteinander	positive
mitfahrgelegenheit	positive
mitglied	negative
mitleid	negative
mitm	negative
mitmachen	positive
mitmensch	negative
mitnehmen	positive
mitspielen	negative
mittag	positive
mittagesse	positive
mittagspause	positive
mitte	negative
mitteilen	negative
mittel	negative
mittelalter	negative
mittelstand	negative
mitten	positive
mitternacht	negative
mittler	negative
mittlerweile	negative
mittwoch	positive
mix	negative
mixen	positive
ml	negative
mm	negative
mm.	negative
mn	negative
mo	negative
mobbing	negative
mobil	negative
mobil|mobile	positive
mod	positive
mode	negative
model	negative
modelbuzz	negative
modell	negative
moderator	negative
modern	positive
modisch	positive
modul	negative
modus	negative
moin	positive
mollath	negative
mom	positive
moment	positive
momentan	negative
mon	negative
monat	negative
monatlich	negative
mond	negative
money	negative
monitor	positive
monsanto	negative
monster	negative
montag	positive
montag|montage	negative
montieren	positive
moon	negative
moral	negative
moralisch	negative
mord	negative
more	negative
morgan	negative
morgen	positive
morgenpost	negative
morgens	positive
morgig	negative
morning	positive
moskau	negative
most	positive
motiv	negative
motivation	positive
motivieren	positive
motiviert	positive
motor	negative
motorola	negative
motorrad	negative
motorsport	negative
motto	negative
mourinho	negative
move	positive
movie	negative
mozilla	negative
mp	negative
mp3	negative
mr	negative
mr.	negative
mrd.	negative
ms	negative
mt	positive
mtv	negative
mu	negative
much	negative
muffis	negative
muller	negative
multi	negative
multimedia	negative
multiplayer	negative
mulu	negative
mum	negative
mumble	positive
munchen	negative
mund	negative
munich	negative
muschi	negative
museum	positive
music	positive
musical	negative
musicalradiode	negative
musik	positive
musikalisch	positive
musiker	negative
musikmesse	negative
musikvideo	positive
musikwunsch	negative
muskel	negative
muskelkater	negative
muslime	negative
muss	positive
must	positive
muster	negative
mut	negative
mutig	positive
mutmasslich	negative
mutter	negative
muttertag	positive
mutti	positive
mv	negative
my	negative
mystery	positive
mythos	negative
m²	positive
málaga	negative
mächtig	negative
mädchen	negative
mädel	positive
mähen	positive
männlich	negative
märchen	negative
märz	negative
mässig	negative
möbel	positive
mögen	positive
möglich	negative
möglicherweise	negative
möglichkeit	negative
möglichst	negative
mönchengladbach	negative
mörder	negative
müde	negative
müdigkeit	negative
mühe	positive
mülheim	negative
müll	negative
müller	negative
münchen	positive
münchner	positive
mündlich	negative
münster	negative
münze	negative
müssen	positive
mütze	positive
n	negative
n.	negative
n24	negative
na	positive
nac	negative
nach	negative
nachbar	positive
nachbarin	positive
nachdem	negative
nachdenken	positive
nachfolger	negative
nachfrage	negative
nachfragen	positive
nachhaltig	negative
nachhaltigkeit	negative
nachher	positive
nachhilfe	negative
nachholen	positive
nachlesen	negative
nachmittag	positive
nachname	negative
nachrangig	negative
nachricht	negative
nachrichten	negative
nachschauen	negative
nacht	negative
nachteil	negative
nachti	positive
nachträglich	positive
nachts	negative
nachvollziehen	negative
nachwuchs	positive
nackt	negative
nagel	positive
nagellack	positive
nah	negative
nahe	negative
nahezu	negative
nahrung	negative
nahrungseinheiten	positive
naiv	negative
naja	negative
nak	negative
name	negative
namens	negative
nano	negative
narbe	negative
narcissists	negative
nase	negative
nass	negative
nation	negative
national	negative
nationalspieler	negative
nato	negative
natur	negative
natürlich	positive
navi	positive
nazi	negative
nba	positive
nd	negative
ndr	negative
nebel	negative
neben	negative
nebenan	positive
nebenbei	positive
nebenjob	positive
nebenverdienst	negative
neckar	negative
nee	negative
need	positive
neee	negative
negativ	negative
nehm	positive
nehmen	negative
nei	negative
neid	negative
neidisch	negative
nein	negative
nein.	negative
nem	positive
nen	negative
nennen	negative
neon	negative
neonazi	negative
ner	negative
nerd	negative
nerven	negative
nervig	negative
nerv|nerven	negative
nervös	negative
nett	positive
network	positive
netz	negative
netzneutralität	negative
netzpolitik	negative
netzteil	negative
netzwerk	negative
neu	negative
neubau	negative
neue	positive
neuendorf	negative
neugierig	positive
neuheit	negative
neuigkeit	negative
neukunde	negative
neukölln	negative
neulich	positive
neumarkt	negative
neun	negative
neururer	positive
neuseeland	positive
neuss	negative
neustadt	negative
neustart	negative
neutral	positive
neuwertig	negative
neuwied	negative
never	negative
new	positive
news	positive
newsletter	negative
newsticker	negative
newstweet	negative
next	positive
nexus	negative
ng	negative
nhl	negative
ni	negative
niall	positive
nic	negative
nice	positive
nicht	negative
nicht.	negative
nichtmal	negative
nichtmehr	negative
nichts	negative
nick	negative
nicken	positive
nico	positive
nicole	positive
nid	negative
nie	negative
nieder	negative
niederbayern	negative
niederlage	negative
niederlande	negative
niederländisch	negative
niedersachse	negative
niedersachsen	negative
niederschlag	negative
niedlich	negative
niedrig	negative
niedrigwasser	negative
niemals	negative
niemand	negative
niesen	negative
niet	negative
nigga	negative
niggas	negative
night	positive
nih	negative
nike	positive
nikeplus	positive
nikon	negative
nimmer	negative
nina	positive
ninja	negative
nintendo	negative
nirgends	negative
nirgendwo	negative
nit	negative
niveau	negative
nk	negative
nl	negative
nlp	negative
no	negative
noch	negative
nochmal	positive
nochmals	negative
nog	positive
nokia	negative
nom	negative
nominieren	positive
non	negative
nope	negative
nord	negative
norden	negative
nordhessen	negative
nordkorea	negative
nordrhein	negative
nordsee	negative
normal	positive
normalerweise	negative
norwegen	negative
not	negative
note	negative
notebook	negative
notfall	negative
notieren	positive
notiz	positive
notwendig	negative
november	negative
now	negative
nowplaying	negative
np	negative
npd	negative
nr	positive
nr.	negative
nrw	negative
nsu	negative
ntv	negative
nu	positive
nudel	negative
nuh	negative
null	negative
nummer	negative
nun	positive
nur	negative
nuss	negative
nutella	negative
nutte	negative
nutz	negative
nutzen	negative
nutzer	negative
nutzung	negative
nw	negative
nylon	positive
nzz	negative
nä	negative
nächste	positive
nähe	positive
nähen	positive
näher	positive
nämlich	negative
nö	negative
nöd	positive
nötig	negative
nüchtern	negative
nürnberg	negative
nützen	negative
nützlich	negative
o	negative
o.	negative
o2	negative
ob	positive
obama	negative
oben	positive
ober	negative
oberbayern	negative
oberfläche	negative
oberhausen	positive
oberpfalz	negative
objekt	positive
objektiv	negative
oblivion	negative
obs	positive
obst	negative
obwohl	negative
och	negative
od	negative
ode	negative
oder	negative
oderso	negative
of	positive
ofen	negative
off	negative
offen	positive
offenbach	positive
offenbar	negative
offensichtlich	negative
office	positive
official	negative
offiziell	negative
offline	negative
offshore	negative
offshoreleaks	negative
oft	negative
og	positive
oh	negative
oha	negative
ohh	negative
ohhh	negative
ohja	negative
ohje	negative
ohne	negative
ohnehin	negative
ohr	negative
ohrring	positive
ohrwurm	positive
ok	positive
ok.	positive
okay	negative
oke	positive
okey	positive
oki	positive
okru	negative
oktober	negative
old	negative
oldenburg	positive
oldtimer	negative
ole	negative
olg	negative
oliver	negative
olle	negative
olli	positive
olympisch	negative
om	positive
oma	positive
omfg	negative
omg	negative
omggf	positive
omggggg	negative
on	positive
one	positive
onkel	negative
online	negative
onlineshop	negative
only	negative
oo	negative
ook	negative
op	negative
opa	negative
opel	negative
open	negative
opening	positive
oper	negative
operation	negative
opfer	negative
opfern	negative
opposition	negative
ops	negative
optik	negative
optimal	positive
optimieren	negative
optimistisch	negative
option	negative
optisch	negative
or	positive
orange	negative
ordentlich	positive
ordner	positive
ordnung	negative
orf	negative
organisation	negative
organisieren	positive
orgasmus	positive
original	positive
orr	negative
orrr	negative
ort	negative
ortsunabhängig	negative
oscar	positive
osnabrück	negative
ost	negative
osten	negative
osterei	positive
osterhase	positive
ostermontag	positive
ostern	positive
ostsee	negative
others	negative
ots	negative
ottmar	negative
otto	negative
our	positive
out	negative
outdoor	positive
outfit	positive
outlet	positive
over	positive
ovp	negative
oz	negative
ozean	negative
p	positive
p.	positive
pa	negative
paar	positive
pack	negative
packen	negative
packmas	positive
packung	negative
pad	negative
paderborn	negative
page	negative
pagi	positive
paid4	negative
paket	negative
pakistan	negative
panasonic	negative
panda	negative
panik	negative
panne	negative
panorama	negative
panzer	negative
papa	positive
paper	positive
papier	negative
papst	negative
par	negative
paradies	negative
paradise	positive
parallel	negative
parfum	negative
parfüm	negative
paris	negative
park	positive
parken	negative
parkendem	negative
parkett	positive
parkplatz	negative
parlament	negative
parodie	positive
part	negative
partei	negative
parteitag	negative
partie	negative
partner	positive
partnerprogramm	negative
partnerschaft	positive
party	positive
pas	positive
pascal	negative
pass	negative
passagier	negative
passen	positive
passend	positive
passieren	negative
passiv	negative
passwort	negative
patch	negative
patent	negative
patient	negative
patrick	negative
paul	negative
pauli	positive
pause	positive
pausen	positive
pay	negative
paypal	negative
pc	negative
pdf	negative
pe	positive
peace	negative
pech	negative
peene	negative
peer	negative
pegel	negative
pegelmv	positive
peinlich	negative
peking	negative
penis	negative
pennen	negative
penner	negative
people	negative
pep	positive
per	positive
perfect	positive
perfekt	positive
performance	positive
permanent	negative
person	negative
personal	negative
perspektive	negative
persönlich	negative
persönlichkeit	negative
pervers	negative
pestizid	negative
peter	positive
petition	negative
petra	positive
peugeot	negative
pfalz	negative
pfarrer	negative
pfeifen	negative
pferd	positive
pferdefleisch	negative
pff	negative
pfff	negative
pflanze	positive
pflanzen	positive
pflanze|pflanzen	negative
pflege	negative
pflegen	positive
pfleger	positive
pflicht	negative
pforzheim	positive
pfui	negative
pfund	negative
phantasie	negative
phase	positive
phil	negative
philip	positive
philipp	negative
philosophie	negative
phoenix	negative
phone	negative
photo	negative
photoshop	negative
photovoltaik	negative
php	positive
physik	positive
phänomen	negative
pi	positive
pic	positive
pics	positive
pille	negative
pilot	negative
pilz	negative
pin	negative
pinguin	negative
pink	negative
pinkeln	negative
pinterest	negative
pirat	negative
piraten	negative
piratenpartei	negative
piratinnenkon	negative
piss	negative
pissen	negative
pizza	positive
pjöngjang	negative
pk	negative
pkw	negative
plakat	negative
plan	positive
planen	negative
planet	negative
planung	negative
plastik	negative
platt	negative
platte	positive
plattform	negative
platz	negative
platzen	negative
platzvergabe	negative
play	positive
player	positive
playing	negative
playlist	positive
playoff	negative
playoffs	positive
plays	positive
playstation	negative
please	positive
pleite	negative
pls	positive
plugin	positive
plus	negative
plz	negative
plötzlich	negative
pm	negative
po	negative
pocher	negative
podcast	negative
point	positive
pointe	negative
pokal	positive
pokemon	negative
poker	negative
pokémon	negative
pol	negative
polen	negative
police	negative
politik	negative
politiker	negative
politisch	negative
polizei	negative
polizist	negative
pollen	negative
polnisch	positive
polo	positive
polster	negative
pommes	negative
pony	positive
pool	positive
pop	negative
popcorn	positive
porn	positive
porno	negative
pornos	negative
porsche	negative
port	positive
portal	negative
portfolio	negative
portion	negative
portugal	negative
position	negative
positiv	positive
post	negative
poste	positive
posten	negative
poster	positive
postet	negative
postkarte	positive
posts	negative
potential	negative
potentiell	negative
potenzial	negative
potsdam	negative
potter	positive
pour	positive
power	positive
pp	negative
ppl	negative
ppm	negative
pr	negative
prag	positive
praktikant	negative
praktikum	negative
praktisch	positive
prall	positive
prangern	negative
praxis	negative
pre	positive
preis	negative
preisgünstig	positive
preisvergleich	negative
preiswert	positive
preis|preisen	positive
premier	positive
premiere	positive
premium	positive
prepaid	positive
presse	negative
pressekonferenz	negative
pressemeldung	negative
pressemitteilung	negative
pressen	negative
presseplätze	negative
preview	negative
prima	positive
primzahl	negative
print	negative
prinz	positive
prinzessin	positive
prinzip	negative
priorität	negative
privat	positive
private	negative
privatsphäre	negative
pro	positive
pro7	negative
probe	negative
proben	positive
probieren	positive
problem	negative
problemlos	negative
produkt	negative
produktion	negative
produktiv	positive
produzieren	negative
prof	negative
professionell	positive
professor	negative
profi	positive
profil	negative
profilbild	positive
profitieren	negative
prognose	negative
programm	negative
programmieren	negative
project	positive
projekt	negative
projektleiter	negative
promi	negative
promis	negative
promo	positive
prompt	positive
propaganda	negative
prosieben	negative
prost	positive
protest	negative
protestieren	negative
protokoll	negative
provider	negative
provision	negative
provozieren	negative
prozent	negative
prozess	negative
prozessor	negative
präsentation	negative
präsentieren	negative
präsident	negative
prüfen	negative
prüfung	positive
prügeln	negative
ps	positive
ps3	negative
ps4	negative
psg	negative
psy	negative
psychiatrie	negative
psychisch	negative
psychologie	negative
public	positive
publikum	negative
puh	negative
pulli	negative
pullover	negative
puls	negative
punk	negative
punkt	positive
punkten	negative
puppe	negative
pur	negative
pushen	negative
pussy	negative
put	negative
putin	negative
putzen	positive
pvp	positive
pärchen	negative
pünktlich	positive
q	positive
q.	negative
qm	negative
qq	negative
qr	positive
qual	negative
quali	negative
qualifikation	negative
qualität	negative
quartal	negative
quasi	negative
quatsch	negative
quatschen	positive
que	positive
queen	positive
quelle	negative
quer	negative
quest	positive
quiz	negative
quoka	positive
quot	negative
quote	negative
quotejetzt	negative
quälen	positive
r	positive
r.	negative
ra	negative
raab	negative
rabatt	negative
rache	negative
racing	negative
rad	negative
radfahren	positive
radfahrer	negative
radikal	negative
radio	negative
radtour	positive
rafael	negative
rahmen	negative
raider	negative
rain	positive
rainer	positive
rakete	negative
ralf	negative
ram	negative
rammstein	positive
ran	negative
rand	negative
random	negative
rang	negative
rangeln	positive
ranking	negative
rap	negative
rapide	negative
rapper	negative
rar	negative
rasch	negative
rasen	negative
rasen|rasten	negative
rasieren	positive
rassismus	negative
rassistisch	negative
rat	negative
raten	negative
ratet	positive
ratgeber	negative
rathaus	negative
ratschlag	negative
ratte	negative
rau	positive
rauch	negative
rauchen	positive
raum	positive
raus	negative
rausgehen	positive
rauskommen	negative
ravensburg	negative
raw	negative
ray	positive
razzia	negative
rb	negative
rbb	negative
re	positive
read	negative
reader	negative
ready	positive
reagieren	negative
reaktion	negative
real	positive
realisieren	positive
realistisch	negative
reality	negative
realität	negative
rebell	negative
receiver	positive
rechen	negative
recherche	negative
rechnen	negative
rechner	positive
rechnung	negative
recht	negative
rechtfertigen	negative
rechtlich	negative
rechts	negative
rechtsanwalt	negative
rechtschreibung	negative
rechtstext	negative
rechtzeitig	positive
recht|rechte	negative
recht|rechts	negative
recklinghausen	negative
record	positive
red	positive
redakteur	negative
redaktion	positive
rede	positive
reden	negative
rede|reden	positive
reduzieren	negative
reduziert	negative
referat	positive
reform	negative
regal	negative
rege	negative
regel	negative
regelmässig	negative
regeln	negative
regelung	negative
regel|regeln	negative
regen	positive
regenbogen	positive
regenmenge	negative
regensburg	negative
regieren	negative
regierung	negative
regierungsbezirk	negative
regime	negative
region	negative
regional	negative
regionalliga	negative
regisseur	positive
registrieren	negative
regnen	positive
regulieren	negative
reiben	negative
reich	negative
reichen	negative
reichtum	negative
reich|reiche|reichen	negative
reif	positive
reifen	negative
reihe	negative
reihen	negative
rein	negative
reinigen	negative
reinigung	negative
reinschauen	positive
reis	negative
reise	positive
reisen	positive
reise|reisen	negative
reitbeteiligung	positive
reiten	positive
reißen	negative
rekord	negative
relativ	positive
release	negative
relevant	negative
religion	negative
religiös	negative
remember	negative
remis	negative
remix	negative
renault	positive
rendite	negative
rennen	positive
renovieren	positive
rente	negative
rentner	negative
reparatur	negative
reparieren	positive
report	negative
reportage	negative
reporter	negative
republik	negative
research	positive
reservieren	negative
resort	positive
respekt	negative
rest	positive
restaurant	positive
restlich	positive
retro	negative
retten	negative
rettung	negative
retweet	positive
retweeten	positive
retweetet	positive
retweets	negative
reus	negative
reuter	negative
reutlingen	positive
review	negative
revolution	negative
rewe	negative
rezension	negative
rezept	positive
rhein	negative
rheinland	negative
ribery	negative
ribéry	negative
ricardo	positive
rich	positive
richard	negative
richten	negative
richter	negative
richtig	positive
richtige	negative
richtlinie	negative
richtung	negative
riechen	negative
riese	negative
riesen	negative
riesig	negative
right	negative
rihanna	negative
rindu	negative
ring	negative
ringen	negative
rio	negative
rip	negative
risiko	negative
ritter	negative
rl	positive
rmdbvb	negative
road	negative
robbe	negative
robert	negative
robin	negative
roboter	negative
robust	negative
rock	negative
rocken	positive
rofl	negative
roger	negative
rohstoff	negative
roland	positive
rolf	negative
rolle	negative
rollen	negative
rollenspiel	negative
roller	negative
rom	negative
roma	negative
roman	negative
romantik	positive
romantisch	positive
ronaldo	positive
ronny	positive
room	negative
rosa	negative
rose	positive
rosemarie	negative
rostock	positive
rot	negative
roth	negative
rothenberger	negative
rotwein	positive
round	negative
roundup	negative
route	negative
router	negative
royal	positive
rp	negative
rp13	positive
rs	positive
rss	negative
rt	positive
rtl	negative
rtl2	negative
rts	positive
rucksack	negative
ruden	negative
ruf	negative
rufen	positive
ruhe	positive
ruhen	positive
ruhig	positive
ruhr	positive
ruhrgebiet	positive
rum	negative
rumlaufen	negative
rummenigge	negative
run	negative
rund	negative
runde	positive
rundschau	negative
running	positive
runtastic	negative
runter	negative
russe	negative
russisch	positive
russland	negative
rutschen	negative
rwe	negative
ryan	negative
ryck	negative
rätsel	negative
räumen	negative
rösler	negative
rüber	positive
rückblick	positive
rücken	negative
rückenschmerz	negative
rückkehr	negative
rückspiel	negative
rücktritt	negative
rückwärts	positive
rüge|rügen	negative
rüsten	negative
s	positive
s.	positive
s04	negative
s2	positive
s21	negative
s3	negative
s4	negative
sa	negative
saal	negative
saarbrücken	negative
saarland	negative
saatgut	negative
sabine	positive
sach	negative
sachbearbeiter	negative
sache	negative
sachen	negative
sachse	positive
sachsen	negative
sack	negative
sad	negative
safari	negative
saft	negative
sagen	positive
sage|sagen	negative
sags	positive
sahne	positive
saison	negative
salah	negative
salat	negative
sale	positive
sales	positive
salz	negative
salzburg	negative
sam	negative
sama	negative
same	negative
sami	positive
samislimani	positive
sammeln	positive
sammer	negative
sammler	positive
sammlung	negative
samstag	positive
samsung	negative
samt	negative
san	negative
sand	negative
sandra	positive
sanft	positive
sanieren	negative
sanierung	negative
sanktion	negative
santana	negative
sap	negative
sar	negative
sarah	positive
sascha	positive
sassnitz	negative
sat	negative
sat1	negative
satire	negative
satt	negative
saturn	negative
satz	positive
sau	negative
sauber	positive
sauer	negative
saufen	positive
saugen	negative
sauna	positive
say	negative
sb	positive
sbb	negative
sbk	negative
sc	negative
sch	negative
schaaf	negative
schade	negative
schaden	negative
schaf	negative
schaffen	negative
schal	positive
schalen|schalten	negative
schalk	negative
schalten	negative
schande	negative
scharf	negative
schat	negative
schatje	positive
schatten	negative
schatz	positive
schatzi	positive
schau	positive
schauen	positive
schaufensterpuppe	negative
schaun	positive
schaus	positive
schauspieler	negative
schauspielerin	negative
schau|schauen	negative
scheibe	negative
scheiden	negative
schein	negative
scheinbar	negative
scheinen	negative
scheitern	negative
scheiße	negative
scheißen	negative
schenken	positive
scherz	negative
scherzen	negative
scheußlich	negative
schicht	positive
schick	positive
schicken	positive
schicksal	negative
schieben	negative
schiedsrichter	negative
schief	negative
schiesserei	negative
schießen	negative
schiff	negative
schild	negative
schimmel	negative
schimpfen	negative
schiri	negative
schlaf	positive
schlafen	positive
schlaflos	positive
schlafzimmer	positive
schlag	negative
schlagen	negative
schlager	positive
schlagzeile	negative
schlagzeilen	negative
schlampe	negative
schlampe|schlampen	negative
schlange	negative
schlank	positive
schlau	positive
schlaubi	negative
schlecht	negative
schleichen	positive
schleswig	negative
schlicht	negative
schließen	negative
schließlich	positive
schlimm	negative
schlimme	negative
schloss	positive
schlucken	negative
schlumpf	negative
schluss	negative
schlüssel	positive
schmadtke	negative
schmal	negative
schmecken	negative
schmeißen	negative
schmerz	negative
schmerzen	negative
schmetterling	positive
schmid	negative
schmidt	negative
schmieren	negative
schminken	positive
schmuck	positive
schmunzeln	positive
schmutzig	negative
schnappen	positive
schnaps	positive
schnauze	negative
schnee	positive
schneiden	negative
schneider	positive
schneien	positive
schnell	positive
schnitt	negative
schnitzel	positive
schnäppchen	positive
scho	negative
schock	negative
schocken	negative
schoko	positive
schokolade	positive
schon	positive
schonen	positive
schonmal	positive
school	negative
schrank	positive
schrecken	negative
schrecklich	negative
schrei	negative
schreiben	positive
schreibtisch	positive
schreien	positive
schreiner	negative
schrift	negative
schriftlich	negative
schriftsteller	negative
schritt	negative
schrott	negative
schräg	negative
schröder	negative
schufa	negative
schuh	negative
schuld	negative
schule	negative
schulen	negative
schultag	positive
schulter	negative
schulung	positive
schulz	positive
schuss	negative
schutz	negative
schwaben	negative
schwach	negative
schwachsinn	negative
schwanger	negative
schwangerschaft	negative
schwanz	negative
schwarz	negative
schwarze	negative
schwarzwald	negative
schweden	negative
schwedisch	negative
schweigen	negative
schweiger	negative
schwein	negative
schweinsteiger	negative
schweiz	negative
schweizer	negative
schwer	negative
schwerin	negative
schwerpunkt	negative
schwert	positive
schwester	negative
schwierig	negative
schwierigkeit	negative
schwimmbad	positive
schwimmen	positive
schwitzen	negative
schwul	negative
schwule	negative
schwung	negative
schwäbisch	negative
schwäche	negative
schwören	positive
schädlich	negative
schäfer	negative
schämen	negative
schätzen	negative
schäuble	negative
schön	positive
schöne	positive
schönheit	positive
schüchtern	negative
schüler	negative
schülerin	positive
schülervz	negative
schütteln	negative
schützen	negative
science	positive
score	negative
screen	negative
screenshot	positive
screenshots	negative
sd	negative
se	negative
sea	positive
search	negative
season	negative
sebastian	negative
sechs	negative
second	positive
secret	negative
security	positive
see	negative
seehofer	negative
seele	positive
segen	positive
seh	negative
sehen	negative
sehenswert	positive
sehnen	positive
sehnsucht	positive
sehr	positive
sein	negative
sein.	negative
seit	negative
seitdem	negative
seite	negative
seiten	negative
seitensprung	positive
sek	negative
sekt	positive
sekunde	negative
selb	negative
selbe	negative
selber	negative
selbst	negative
selbstanzeige	negative
selbstmord	negative
selbstverständlich	negative
selbständig	positive
selena	negative
selten	negative
seltsam	negative
semester	negative
semifinal	negative
seminar	negative
sen	negative
senat	negative
send	positive
senden	positive
sender	negative
sendung	negative
senior	negative
senken	negative
sensation	positive
sensationell	negative
seo	negative
september	negative
serbien	negative
serie	negative
series	negative
seriös	positive
server	negative
service	positive
servus	positive
sessel	positive
session	positive
set	positive
setzen	negative
seufzen	positive
sex	positive
sexchat	positive
sexismus	negative
sexkontakte	positive
sexuell	negative
sexy	positive
sg	negative
sge	negative
sgfbvb	negative
sh	negative
shake	positive
shanghai	negative
shaqiri	positive
share	negative
she	positive
sherlock	negative
shirt	positive
shit	negative
shitstorm	negative
shooter	negative
shooting	positive
shop	positive
shoppen	positive
shopping	positive
shoppingqueen	positive
shops	negative
short	negative
shorts	positive
shot	negative
show	positive
si	negative
sic	negative
sich	negative
sicher	positive
sicherheit	negative
sicherlich	negative
sichern	negative
sicht	negative
sichtbar	negative
sichten	negative
sick	negative
side	positive
sido	negative
sie	negative
sieben	negative
sieg	negative
siegen	negative
sieger	negative
siehe	positive
siehste	positive
siehts	positive
siemens	negative
sie|sie	positive
signal	negative
silber	positive
silver	positive
sim	positive
simcity	negative
simon	negative
simpel	positive
simplymaxx	negative
simpsons	positive
sims	positive
simulator	positive
sin	negative
sind.	negative
singen	negative
single	positive
sinken	negative
sinn	negative
sinnen	positive
sinnlich	positive
sinnlos	negative
sinnvoll	negative
sipplingen	negative
sir	negative
siri	negative
sis	positive
sit	positive
site	positive
situation	negative
sitz	positive
sitzen	positive
sitzplatz	positive
sitzung	negative
siz	negative
skandal	negative
skat	positive
ski	positive
sklave	negative
sky	negative
skybuli	negative
skycl	negative
skype	positive
skypen	positive
skyrim	negative
slapen	negative
sleep	negative
slender	negative
slogan	negative
slowenien	negative
sm	negative
smart	positive
smartphone	negative
smartphones	negative
smh	negative
smile	positive
smiley	positive
sms	positive
smurfsvillage	positive
snapchat	negative
so	negative
so.	negative
sobald	positive
soccer	positive
social	negative
socialmedia	negative
socke	negative
soeben	negative
sofa	positive
sofort	positive
sofortig	positive
soft	negative
software	negative
sogar	negative
sogenannt	negative
sohn	negative
solang	negative
solange	negative
solar	negative
solche	negative
soldat	negative
solidarität	negative
solide	positive
solingen	negative
soll	negative
sollen	positive
solo	positive
solutions	negative
some	negative
somit	positive
sommer	positive
sommerferien	positive
sommerreifen	negative
sonderangebot	negative
sondern	negative
song	positive
songtext	negative
sonne	positive
sonnen	positive
sonnenbrand	negative
sonnenbrille	positive
sonnenschein	positive
sonnenstrahl	positive
sonnenuntergang	positive
sonnig	positive
sonntag	positive
sonntagsmodus	negative
sonst	negative
sonstig	negative
sony	negative
soo	negative
soon	positive
sooo	negative
soooo	positive
sooooo	positive
sophie	positive
sorge	negative
sorgen	negative
sorge|sorgen	positive
sorry	negative
sorte	negative
sortieren	negative
soso	negative
soul	negative
sound	positive
soundcloud	negative
soundtrack	positive
source	negative
souverän	negative
soviele	negative
sowas	negative
soweit	positive
sowie	negative
sowieso	negative
sowohl	positive
sozial	negative
sozusagen	positive
sp	negative
spa	positive
space	positive
spain	negative
spam	negative
spanien	negative
spanier	negative
spanisch	negative
spannen	negative
spannend	positive
spannung	negative
sparen	negative
sparer	negative
spargel	positive
sparkasse	positive
spazieren	positive
spaziergang	positive
spaß	positive
spd	negative
spdbpt	negative
special	positive
speed	positive
speicher	negative
speichern	negative
spektakulär	negative
spekulation	negative
spenden	positive
spende|spenden	negative
sperma	positive
sperre	negative
sperren	negative
spezial	negative
spezialist	negative
speziell	positive
spiegel	negative
spiegeln	negative
spiel	negative
spielbericht	negative
spielen	negative
spieler	negative
spielplatz	positive
spieltag	negative
spielzeug	negative
spiel|spielen	negative
spinne	negative
spinnen	negative
spitz	positive
spitze	negative
spoiler	negative
spon	negative
spongebob	negative
sponsor	positive
spontan	positive
sport	positive
sport1	negative
sportler	negative
sportlich	positive
spot	negative
spotify	negative
spox	negative
sprache	negative
sprachen.	negative
sprachlos	negative
sprechen	negative
sprecher	negative
sprengen	negative
spring	positive
springen	positive
spritzen	negative
spruch	positive
sprung	negative
spucken	negative
spur	negative
spurwechsel	negative
spur|spuren	negative
spät	negative
spätestens	negative
spö	negative
spüren	negative
sr	negative
srf	negative
sry	negative
ss	negative
ssnhd	negative
st	negative
st.	negative
sta	negative
staat	negative
staatlich	negative
staatsanwaltschaft	negative
stabil	negative
stadion	negative
stadt	negative
stadtrat	negative
stadtteil	positive
staffel	negative
stage	positive
stahl	negative
stahlbrode	negative
stalker	negative
stammen	negative
stammtisch	negative
stand	negative
standard	positive
standort	negative
star	positive
starbucks	positive
stardesign	negative
stardoll	negative
stark	negative
starren	positive
start	positive
starten	negative
startseite	positive
startup	positive
statement	negative
station	negative
statistik	negative
statt	negative
stattdessen	positive
stattfinden	negative
status	negative
stau	negative
staub	negative
staubsauger	negative
staunen	positive
stay	positive
std	negative
std.	negative
ste	negative
steak	positive
steam	negative
stechen	positive
steckdose	negative
stecken	negative
stefan	positive
stehen	negative
stehend	negative
stehlen	negative
steiermark	negative
steigen	negative
steigend	negative
steigern	negative
stein	positive
steinbrück	negative
stelle	positive
stellen	negative
stellenangebot	negative
stellenanzeige	negative
stellenmarkt	negative
stelle|stellen	negative
stellung	negative
stellungnahme	negative
stephan	positive
sterben	negative
stern	negative
sternchen	positive
sternzeichen	negative
stets	negative
steuer	negative
steuerbetrug	negative
steuerflucht	negative
steuerhinterzieher	negative
steuerhinterziehung	negative
steuern	negative
steueroase	negative
steuersünder	negative
steuerzahler	negative
steve	negative
sticken	negative
sticker	negative
stift	positive
stiftung	negative
stil	positive
still	positive
stille	positive
stilvoll	positive
stimme	negative
stimmen	negative
stimme|stimmen	negative
stimmung	positive
stinken	negative
stirn	negative
stock	negative
stocken	negative
stockend	negative
stocker	negative
stockfotos	negative
stoff	negative
stolpern	negative
stolz	positive
stop	negative
stopfen	negative
stoppen	negative
store	negative
stories	negative
story	negative
stoßen	negative
str.	negative
strafe	negative
straftat	negative
strahlen	positive
strahlend	positive
stralsund	negative
strand	positive
strategie	negative
straße	negative
straßenbahn	negative
stream	negative
streaming	negative
strecke	negative
street	negative
streich	negative
streicheln	positive
streichen	negative
streifen	negative
streik	negative
streiken	negative
streit	negative
streiten	positive
streng	negative
stress	positive
stressig	positive
strip	negative
strippers	negative
strom	negative
stromanbieter	negative
stronach	negative
struktur	negative
strumpfhose	positive
student	positive
studentin	positive
studie	negative
studieren	positive
studierende	negative
studie|studium	negative
studio	negative
studium	negative
stufe	negative
stuhl	positive
stunde	negative
stunden	negative
stundenlang	positive
stunde|stunden	negative
sturm	negative
stute	positive
stuttgart	negative
stuttgarter	negative
style	negative
ständig	negative
stärke	negative
stärken	negative
stören	negative
störung	negative
stück	negative
stücken	negative
stürmen	negative
stürmer	negative
stürzen	negative
stützen	negative
su	positive
sub	negative
suche	positive
suchen	positive
suche|suchen	positive
suchmaschine	negative
suchmaschinen	negative
sucht	negative
suite	positive
sum	negative
summer	positive
sun	positive
sunday	negative
super	positive
supermarkt	negative
supernatural	negative
superstar	positive
supi	positive
suppe	positive
support	positive
surfen	negative
surfgeschwindigkeit	negative
survival	negative
susan	positive
susanne	positive
sushi	positive
suzuki	negative
sv	negative
sven	negative
svp	negative
sw	negative
swag	negative
sweet	positive
swiss	negative
swr	negative
sylvie	negative
symbol	negative
sympathisch	positive
syrien	negative
syrisch	negative
system	negative
sz	negative
szene	negative
sämtliche	negative
sänger	negative
sängerin	positive
sätzediedirniemandglaubt	negative
sü	negative
süchtig	negative
süd	positive
südafrika	negative
süden	negative
südkorea	negative
südlich	negative
südtirol	negative
südwesten	negative
sünde	negative
süß	positive
süße	positive
süßen	positive
t	negative
t.	negative
t3n	positive
ta	positive
tab	negative
tabelle	negative
tablet	negative
tablets	negative
tablett|tablette	negative
tafel	negative
tag	positive
tagebuch	negative
tagen	positive
tagesschau	negative
tagesspiegel	negative
tageszeitung	negative
tagsüber	positive
tagung	negative
tak	negative
take	positive
tal	negative
talent	positive
talk	negative
tank	negative
tanken	positive
tankstelle	negative
tante	negative
tanz	negative
tanzen	positive
tapfer	negative
tara	negative
tarif	negative
tasche	negative
taschenbuch	negative
tasse	positive
tastatur	positive
tat	negative
tatort	negative
tatsache	negative
tatsächlich	negative
tattoo	positive
tattoos	negative
taub	negative
taube	negative
tauchen	negative
tauen	negative
taugen	negative
tausch	negative
tauschen	positive
tausend	negative
tausende	negative
taxi	negative
taylor	negative
taz	negative
tb	negative
tc	positive
te	negative
tea	negative
team	positive
teamfollowback	positive
teaser	negative
tech	positive
technik	positive
techniker	negative
technisch	negative
techno	negative
technologie	negative
teddy	positive
tee	positive
teen	negative
teenager	negative
tegen	negative
teich	positive
teil	negative
teilen	positive
teilnahme	negative
teilnehmen	negative
teilnehmer	negative
teilweise	negative
teilzeit	positive
teilzeitstelle	negative
teil|teilen	negative
tel	negative
telefon	positive
telefonat	positive
telefonieren	positive
telekom	negative
tell	negative
teller	negative
tellows	negative
telmi	negative
temp	negative
temperatur	positive
tempo	negative
ten	negative
tendenz	negative
tennis	positive
teppich	positive
ter	negative
termin	positive
terraristik	negative
terrarium	positive
terrasse	positive
terror	negative
terroranschlag	negative
terrorist	negative
test	negative
testen	positive
testsieger	positive
teuer	negative
teufel	negative
texas	negative
text	negative
tg	positive
th	negative
thailand	positive
thank	positive
thanks	positive
that	positive
thatcher	negative
the	positive
theater	negative
thema	negative
theme	positive
theoretisch	negative
theorie	negative
therapie	negative
there	negative
these	negative
thevoicekids	negative
thiessow	positive
think	positive
thirsty	negative
this	negative
thomas	negative
thor	positive
thriller	negative
thrones	negative
thüringen	negative
thüringer	negative
ti	negative
ticken	positive
ticker	negative
ticket	positive
tief	positive
tiefe	negative
tier	negative
tierisch	negative
tiger	negative
til	negative
tim	negative
time	positive
timeline	negative
timen	positive
times	positive
timmendorf	negative
tina	positive
tip	negative
tippen	negative
tirol	negative
tirol2013	negative
tiroler	negative
tisch	positive
titan	negative
titel	positive
titten	positive
titty	negative
tja	negative
tk	negative
tl	positive
tl.	positive
to	positive
toast	negative
tobias	negative
toch	negative
tochter	positive
tod	negative
today	negative
todd	negative
todesstrafe	negative
together	positive
toi	positive
toilette	negative
tokio	negative
toleranz	negative
toll	positive
tollen	positive
tom	positive
tomate	negative
tomb	negative
tommy	positive
ton	negative
toni	positive
tonight	negative
tonne	negative
too	negative
tool	negative
tools	negative
top	positive
topf	negative
topmodel	negative
topthemen	negative
tor	negative
torte	positive
torwart	negative
tot	negative
total	negative
tote	negative
totprügeln	positive
tottenham	negative
touch	negative
tour	positive
tourismus	negative
tourist	negative
town	positive
toyota	negative
tp	negative
tr	negative
track	positive
trading	negative
tradition	negative
traditionell	positive
traffic	negative
tragen	positive
tragisch	negative
trailer	negative
trainer	negative
trainieren	positive
training	positive
transfer	negative
transfermarkt	negative
translate	negative
transparent	positive
transparenz	negative
transport	negative
trauen	negative
trauer	negative
trauern	negative
traum	positive
traumhaft	positive
traurig	negative
travel	positive
treff	positive
treffen	positive
treffen|triefen	positive
treffer	negative
treffpunkt	negative
treiben	negative
trek	negative
trend	negative
trends	negative
trennen	negative
trennung	negative
treppe	positive
treten	negative
treu	positive
tribez	negative
trick	negative
trier	negative
trikot	positive
trinken	positive
trio	negative
trip	negative
trocken	positive
troll	negative
trollen	negative
tropfen	negative
trotz	negative
trotzdem	positive
truppe	negative
try	positive
tränen	positive
träne|tränen	negative
träumen	positive
trü	negative
ts	negative
tschechien	negative
tschüss	positive
tsg	negative
tsv	negative
tt	negative
tu	positive
tube	negative
tuh	negative
tumblr	positive
tun	negative
tunnel	negative
turbo	positive
turin	positive
turm	negative
turnen	negative
turnier	positive
tutorial	positive
tv	negative
tw	negative
tweet	positive
tweetdeck	negative
tweete	negative
tweeten	positive
tweets	positive
twilight	negative
twitter	positive
twittere	positive
twitterer	positive
twittermädchen	negative
twittern	positive
twittert	negative
two	negative
twoff	positive
twonn2013	positive
typ	negative
typisch	negative
tz	negative
täglich	negative
täter	negative
tätig	negative
täuschen	negative
tödlich	negative
töten	negative
tübingen	positive
tür	positive
türe	positive
türke	negative
türkei	negative
türkisch	negative
tüte	negative
tüv	negative
u	negative
u.	negative
u23	positive
uber	negative
ubersetzen	negative
ubuntu	negative
ucl	negative
ucldraw	negative
udo	negative
uf	negative
uff	negative
ugh	negative
uh	negative
uhl	negative
uhr	positive
uhrzeit	negative
ui	positive
uit	negative
uk	negative
ukraine	negative
uli	negative
ulm	negative
ulrich	negative
ultimate	negative
ultimativ	positive
ultra	negative
um	negative
umarmen	positive
umarmung	positive
umbau	negative
umbringen	negative
umdrehen	positive
umfangreich	negative
umfassend	negative
umfeld	negative
umfrage	negative
umgang	negative
umgebung	positive
umgehen	negative
umgekehrt	negative
ums	positive
umsatz	negative
umschuldung	negative
umsetzen	negative
umsetzung	negative
umso	negative
umsonst	negative
umstand	negative
umsteigen	positive
umstellen	negative
umstritten	negative
umwelt	negative
umziehen	positive
umzug	negative
un	positive
unabhängig	negative
unabhängigkeit	negative
unangenehm	negative
unbedingt	positive
unbekannt	negative
unbekannte	positive
unbenutzt	negative
unbezahlbar	negative
uncool	negative
und	negative
under	negative
undercover	negative
undso	negative
unendlich	positive
unentschieden	negative
unerfreulich	negative
unerträglich	negative
unerwartet	negative
unfair	negative
unfall	negative
unfallmeldung	negative
unfassbar	negative
unfollow	negative
ungarn	negative
ungefähr	negative
ungeschnitten	negative
ungewöhnlich	negative
unglaublich	negative
unglück	negative
unglücklich	negative
ungünstig	negative
unheimlich	negative
uni	negative
union	negative
united	positive
universal	negative
universität	negative
universum	negative
unklar	negative
unkompliziert	positive
unmöglich	negative
unnötig	negative
uno	negative
unrecht	negative
unruhe	negative
unschuldig	negative
unser	negative
unsicher	negative
unsichtbar	negative
unsinn	negative
unten	negative
unter	negative
untergang	negative
untergehen	negative
unterhalten	positive
unterhaltsam	positive
unterhaltung	positive
unterlegen	negative
unterliegen	negative
unterm	positive
unternehmen	negative
unternehmer	negative
unterricht	negative
unterscheiden	negative
unterschied	negative
unterschiedlich	negative
unterschreiben	negative
unterschrift	negative
unterschätzen	negative
unterstützen	negative
unterstützung	positive
untersuchen	negative
untersuchung	negative
unterweg	negative
unterwegs	positive
unterwäsche	positive
unterzeichnen	negative
unverbindlich	negative
unvergesslich	positive
unverändert	negative
unwichtig	negative
unzensiert	negative
unzufrieden	negative
up	positive
update	negative
updates	negative
upload	negative
ups	negative
uptime	negative
ur	negative
urban	positive
urheberrecht	negative
urlaub	positive
ursache	negative
ursprünglich	negative
ursula	negative
urteil	negative
urteilen	negative
us	negative
usa	negative
usb	negative
usd	negative
use	negative
user	negative
usw	negative
usw.	negative
uu	negative
uuml	negative
uvm	negative
uwe	negative
v	negative
v.	negative
va	positive
vaart	negative
vagina	negative
vampir	negative
van	negative
vanavond	positive
var	negative
variante	negative
vater	negative
vbt	negative
vc	positive
vds	negative
vdsl50	negative
ve	negative
vegan	positive
vegas	negative
vegetarier	negative
vegetarisch	positive
venezuela	negative
ver	negative
verabschieden	positive
veranstalten	negative
veranstaltung	negative
verantwortlich	negative
verantwortung	negative
verarschen	negative
verarscht	negative
verband	negative
verbergen	negative
verbesser	negative
verbessern	negative
verbesserung	negative
verbieten	negative
verbinden	positive
verbindung	negative
verborgen	negative
verbot	negative
verboten	negative
verbrauchen	negative
verbraucher	negative
verbrechen	negative
verbreiten	negative
verbrennen	negative
verbringen	positive
verdacht	negative
verdammen	negative
verdammt	negative
verderben	negative
verdi	negative
verdienen	negative
verdient	positive
verdorben	negative
verdrängen	negative
verdächtig	negative
verdächtige	negative
verdächtige|verdächtigen	negative
verein	negative
vereinen	positive
verfahren	negative
verfassen	negative
verfassung	negative
verfassungsschutz	negative
verfolgen	negative
verfügbar	negative
verfügen	negative
verfügung	negative
vergangen	negative
vergangenheit	negative
vergeben	negative
vergehen	positive
vergessen	negative
vergewaltigen	negative
vergewaltigung	negative
vergleich	negative
vergleichen	negative
vergnügen	positive
verhaften	negative
verhalten	negative
verhandeln	negative
verhandlung	negative
verheiraten	positive
verhindern	negative
verhungern	negative
verhältnis	negative
verkackt	negative
verkauf	negative
verkaufen	positive
verkehr	negative
verkehren	negative
verkehrsinfo	negative
verkehrsmeldung	negative
verkehrsrecht	negative
verkehrsunfall	negative
verklagen	negative
verkäufer	negative
verkünden	negative
verlag	negative
verlangen	negative
verlassen	positive
verlaufen	positive
verlegen	negative
verleihen	negative
verletzen	negative
verletzt	negative
verletzte	negative
verletzung	negative
verlieben	negative
verliebt	positive
verlieren	negative
verlierer	negative
verloren	negative
verlosen	positive
verlosung	positive
verlust	negative
verlängern	negative
verlängerung	negative
vermeiden	negative
vermessen|vermissen	positive
vermieten	positive
vermieter	negative
vermissen	positive
vermitteln	negative
vermuten	negative
vermutlich	negative
vermögen	negative
vernichten	negative
vernunft	negative
vernünftig	positive
verpacken	positive
verpackung	negative
verpassen	negative
verpflichten	negative
verpflichtung	negative
verpissen	negative
verraten	negative
verrecken	negative
verrücken	negative
verrückt	positive
vers	negative
versagen	negative
versand	negative
versauen	negative
versaut	negative
verschenken	negative
verschicken	negative
verschieben	negative
verschieden	negative
verschlafen	negative
verschwenden	negative
verschwinden	negative
versehen	negative
versehentlich	positive
versenden	negative
versicherung	negative
version	positive
versorgen	positive
versprechen	negative
verspäten	negative
verspätung	positive
verstand	positive
verstecken	negative
verstehen	negative
versterben	negative
verständlich	negative
verständnis	negative
verstärkung	positive
versuch	positive
versuchen	positive
versucht	negative
verteidigen	negative
verteilen	negative
vertrag	negative
vertragen	negative
vertrauen	negative
vertreiben	negative
vertreten	negative
vertreter	negative
vertrieb	negative
verursachen	negative
verurteilen	negative
verwalten	negative
verwaltung	negative
verwandeln	negative
verwechseln	negative
verweigern	negative
verwenden	negative
verwendung	negative
verwirren	negative
verwirrt	negative
verwöhnen	positive
very	negative
verzeichnis	negative
verzeihen	negative
verzichten	negative
verzweifeln	negative
verzweifelt	negative
verändern	negative
verändert	negative
veränderung	negative
veröffentlichen	negative
veröffentlichung	negative
vettel	negative
vfb	positive
vfbscf	negative
vfl	negative
vghd	negative
vhs	negative
vi	negative
via	negative
victoria	positive
video	positive
videochat	negative
videos	positive
videospiel	negative
videoüberwachung	negative
vie	positive
viel	negative
viele	positive
vielfalt	negative
vielleicht	positive
vielseitig	positive
vienna	negative
vier	positive
viert	negative
viertel	negative
viertelfinale	negative
view	negative
villa	negative
vintage	positive
vinyl	negative
vip	positive
virtua	positive
virtuell	negative
virus	negative
visier	negative
vision	negative
visum	positive
vita	positive
vitamin	negative
viva	negative
vll	positive
vllt	positive
vllt.	positive
vlog	positive
vlt	positive
vo	negative
vodafone	negative
vodka	negative
vogel	negative
vogelgrippe	negative
voice	positive
voicekids	negative
voir	positive
vol	negative
volk	negative
volker	negative
volksbank	negative
volksbegehren	negative
volkswagen	negative
voll	negative
vollbringen	negative
vollendet.	positive
vollkommen	negative
vollständig	negative
vollzeit	positive
vollzeitstelle	negative
volumen	negative
volvo	positive
von	negative
vor	negative
vorab	negative
vorallem	negative
voran	positive
vorarlberg	negative
voraus	negative
voraussichtlich	negative
vorbei	positive
vorbereiten	positive
vorbereitung	negative
vorbestellen	positive
vorbild	negative
vorerst	negative
vorfreude	positive
vorgehen	negative
vorgestern	negative
vorhanden	negative
vorher	negative
vorhersage	negative
vorhin	positive
vorkommen	negative
vorlage	negative
vorlesen	negative
vorlesung	positive
vorm	positive
vormittag	positive
vorn	negative
vorname	positive
vorne	negative
vorpommern	negative
vorrat	negative
vorratsdatenspeicherung	negative
vorschau	negative
vorschlag	positive
vorschlagen	positive
vorsicht	negative
vorsichtig	negative
vorsitzende	negative
vorsorge	negative
vorsprung	negative
vorstand	negative
vorstellen	negative
vorstellung	negative
vorteil	positive
vortrag	negative
vorurteil	negative
vorwurf	negative
vorzeitig	negative
vote	positive
votebilbo	negative
voten	positive
voting	negative
vou	positive
vous	positive
vox	negative
vs	negative
vs.	negative
vw	negative
vögeln	positive
völlig	negative
w	positive
w.	negative
wa	positive
waage	negative
wach	positive
wachen	positive
wachsen	negative
wachstum	negative
wackeln	negative
waffe	negative
wagen	negative
wagner	positive
wah	negative
wahl	negative
wahlkampf	negative
wahlprogramm	negative
wahnsinn	negative
wahnsinnig	positive
wahr	negative
wahrheit	negative
wahrscheinlich	negative
wait	negative
wal	negative
wald	negative
walk	positive
walking	positive
wall	negative
walter	negative
wan	negative
wand	negative
wandel	negative
wandern	positive
wanderung	negative
wandgestaltung	negative
wange	positive
wann	positive
wanna	positive
wanne	negative
want	negative
ware	negative
warentest	positive
warm	negative
warnemünde	positive
warnen	negative
warnow	negative
warnstreik	negative
warnung	negative
wars	negative
warte	negative
warten	positive
wartezimmer	negative
warte|warten	negative
warum	negative
was	positive
waschen	positive
waschmaschine	negative
washington	negative
wasn	negative
wasser	negative
wassern	negative
wat	negative
watch	negative
watching	negative
watt	negative
watzke	negative
way	positive
waz	negative
wc	positive
wdr	negative
we	positive
web	negative
webber	negative
webcam	negative
webcamsex	negative
webdesign	positive
weben	negative
weber	positive
webinar	negative
webmaster	positive
webseite	negative
webseiten	negative
website	negative
websites	negative
webverzeichnis	negative
webvideopreis	negative
wechsel	negative
wechseln	negative
wecken	positive
wecker	positive
wedding	positive
weder	negative
week	negative
weekend	positive
weer	negative
weet	negative
weg	negative
wegen	negative
weh	negative
wehe	positive
wehen	negative
wehren	negative
wei	positive
weib	negative
weiblich	positive
weich	positive
weichen	negative
weihnachten	positive
weil	negative
weile	positive
weilen	positive
weils	negative
weimar	negative
wein	positive
weinen	negative
weis	positive
weise	negative
weisen	negative
weisheit	positive
weit	negative
weiter	positive
weiterbildung	negative
weitergehen	negative
weiterhin	negative
weiterlesen	negative
weitermachen	positive
weiß	positive
weißen	negative
weko	negative
wel	negative
welche	positive
welcome	positive
welle	negative
wellen	negative
wellness	positive
welpe	negative
welt	negative
weltall	negative
weltkrieg	negative
weltmeister	positive
weltraum	positive
welttag	negative
weltweit	negative
wembley	positive
wen	negative
wenden	positive
wenig	negative
wenige	negative
weniger	negative
wenigste	negative
wenigstens	positive
wenn	negative
wenns	negative
wer	positive
werben	negative
werbespot	negative
werbung	negative
werd	positive
werden	negative
werden.	negative
werder	negative
were	negative
werfen	negative
werk	negative
werkstatt	negative
werkzeug	negative
werner	negative
wert	negative
werten	negative
wertvoll	positive
wesen	negative
wesentlich	negative
weser	negative
weshalb	negative
west	negative
westerwelle	negative
weste|westen	negative
westfale	positive
westfalen	negative
westlich	negative
wettbewerb	negative
wette	positive
wetten	positive
wetter	positive
wettern	negative
wetterstation	negative
wette|wetten	negative
wg	positive
wg.	negative
what	negative
whats	positive
whatsapp	positive
when	negative
where	positive
whirlpool	positive
white	negative
who	negative
why	negative
wi	positive
wichsen	negative
wichtig	negative
wichtigste	positive
wid	positive
wider	positive
widerlich	negative
widersprechen	negative
widerstand	negative
widerwärtig	negative
widmen	positive
wie	negative
wieder	positive
wiederholen	negative
wiederholung	negative
wiedersehen	positive
wiegen	positive
wien	negative
wiener	negative
wiesbaden	negative
wiese	negative
wieso	negative
wieviele	negative
wifi	negative
wii	negative
wiki	negative
wikipedia	negative
wil	negative
wild	negative
wilhelm	negative
wille	negative
willem	negative
william	positive
willkommen	positive
wilt	negative
win	positive
wind	negative
winden	negative
windows	negative
winken	positive
winter	negative
winzertechnik	positive
wir	positive
wirds	positive
wireless	positive
wirken	negative
wirklich	negative
wirklichkeit	negative
wirksam	negative
wirkung	negative
wirtschaft	negative
wirtschaftlich	negative
wismar	negative
wissen	negative
wissenschaft	negative
wissenschaftler	negative
wissenschaftlich	negative
wit	negative
with	positive
wittow	positive
witz	negative
witzig	negative
wkwk	negative
wlan	positive
wm	negative
wo	negative
woah	negative
woanders	positive
wobei	negative
woche	negative
wochen	positive
wochenende	positive
wochenstart	positive
wodka	negative
wofür	negative
woher	negative
wohin	positive
wohl	positive
wohlfühlen	positive
wohlstand	negative
wohnen	positive
wohnung	positive
wohnwagen	positive
wohnzimmer	positive
wolf	negative
wolff	negative
wolfgang	negative
wolfsburg	negative
wolgast	negative
wolke	negative
wolkig	negative
wollen	positive
woman	positive
women	positive
womit	positive
womöglich	negative
wonder	negative
wonderful	positive
woran	negative
worauf	negative
word	positive
wordpress	positive
work	positive
workout	positive
workshop	positive
world	positive
wort	negative
worteausderkindheit	negative
worum	positive
wotan	negative
wovon	positive
wow	positive
wozu	positive
wp	negative
wphg	negative
wrestlemania	positive
wtf	negative
wulff	negative
wund	negative
wunde	negative
wunder	negative
wunderbar	positive
wundern	negative
wunderschön	positive
wundervoll	positive
wunsch	positive
wuppertal	negative
wurd	negative
wurm	negative
wurst	negative
wurzel	negative
wut	negative
wwdc	negative
wwe	negative
www	negative
wählen	negative
wähler	negative
währen	negative
während	positive
währung	negative
wär	negative
wärme	positive
wärmen	positive
wärs	negative
wäsche	positive
wü	negative
wünschen	positive
würd	positive
würde	negative
würstchen	negative
württemberg	negative
würzburg	positive
wütend	negative
x	positive
x.	negative
x2	positive
x2f	negative
x3	positive
xbox	negative
xd	positive
xi	negative
xing	negative
xl	positive
xml	negative
xoxo	positive
xx	negative
xxl	positive
xxx	positive
xxxx	positive
y	positive
ya	positive
yahoo	negative
yamaha	positive
yay	positive
ye	positive
yea	negative
yeah	positive
yep	positive
yes	positive
yg	negative
yo	positive
yoga	positive
yolo	negative
york	negative
you	negative
young	positive
your	negative
youtube	negative
youtuber	positive
yt	negative
yu	negative
yugioh	negative
yuh	positive
yung	negative
z	negative
z.	negative
zacken	negative
zahl	negative
zahlen	negative
zahlreich	negative
zahn	negative
zahnarzt	negative
zalando	negative
zart	positive
zauberhaft	positive
zaubern	positive
zaun	negative
zb	negative
zdf	negative
ze	negative
zehn	negative
zei	negative
zeichen	negative
zeichnen	positive
zeichnung	negative
zeigen	negative
zeihen	positive
zeihen|ziehen	negative
zeile	negative
zeit	positive
zeitalter	negative
zeitpunkt	negative
zeitreise	negative
zeitschrift	negative
zeitung	negative
zelda	positive
zensur	negative
zentral	negative
zentrum	negative
zerbrechen	negative
zero	negative
zerstören	negative
zertifikat	negative
zettel	negative
zeug	negative
zeuge	negative
zeugen	negative
zh	positive
zi	positive
zib2	negative
ziehen	negative
ziel	negative
ziemlich	negative
zigarette	negative
zimmer	positive
zimmern	negative
zin	negative
zins	negative
zitat	negative
zitieren	negative
zitrone	positive
zittern	negative
zo	negative
zocken	positive
zoll	negative
zombie	negative
zombies	negative
zone	negative
zoo	positive
zschäpe	negative
zu	negative
zubehör	negative
zucker	negative
zuckerberg	negative
zudem	negative
zuerst	negative
zufall	negative
zufolge	negative
zufrieden	positive
zufällig	positive
zug	negative
zugang	negative
zugeben	negative
zugleich	negative
zugreifen	negative
zugriff	negative
zuhause	positive
zuhören	positive
zukunft	negative
zukünftig	negative
zulassen	negative
zulegen	positive
zuletzt	negative
zumba	positive
zumindest	negative
zunehmen	negative
zunehmend	negative
zunge	negative
zunächst	negative
zurecht	negative
zurzeit	negative
zurück	positive
zurücktreten	negative
zur√ºckgeben	negative
zus	negative
zusammen	positive
zusammenarbeit	negative
zusammenfassung	negative
zusammenhang	negative
zuschauen	positive
zuschauer	negative
zuschlagen	positive
zusehen	positive
zustand	negative
zustehen	negative
zustimmen	negative
zustimmung	negative
zusätzlich	positive
zutaten	positive
zuverlässig	positive
zuviele	negative
zuvor	negative
zwang	negative
zwangsräumung	negative
zwar	negative
zweck	negative
zwei	positive
zweifel	negative
zweifeln	negative
zweimal	positive
zweit	positive
zweite	negative
zwerg	negative
zwickau	negative
zwilling	negative
zwingen	negative
zwischen	negative
zwischendurch	positive
zwitschern	positive
zwölf	negative
zypern	negative
zählen	negative
zünden	positive
zürcher	negative
zürich	negative
{	negative
|	positive
}	positive
~	positive
	negative
§	negative
°	negative
°c	negative
·	negative
ä	negative
ägypten	negative
äh	negative
ähm	positive
ähnlich	negative
ändern	negative
änderung	negative
ära	negative
ären	negative
ärger	negative
ärgerlich	negative
ärgern	positive
ärztin	negative
ätzend	negative
äußer	negative
äußern	negative
äußerst	negative
ö	negative
öffentlich	negative
öffentlichkeit	negative
öffnen	positive
öfter	negative
öfters	positive
öh	negative
öhm	negative
öko	negative
ökologisch	positive
öl	negative
öpnv	negative
österreich	negative
österreicher	negative
österreichisch	negative
övp	negative
özil	positive
ü	negative
übel	negative
üben	negative
über	negative
überall	negative
überarbeiten	negative
überbewerten	negative
überblick	negative
überfall	negative
überfallen	negative
überflüssig	negative
überfordern	negative
übergeben	positive
übergewicht	negative
überhaupt	negative
überholen	negative
überlassen	negative
überleben	negative
überlegen	positive
übermorgen	negative
übernahme	negative
übernehmen	negative
überprüfen	negative
überragend	positive
überraschen	positive
überraschend	negative
überraschung	positive
überreden	positive
übers	positive
übersehen	negative
übersetzen	negative
übersetzung	negative
übersicht	negative
überstehen	positive
übertragen	negative
übertragung	negative
übertreffen	negative
übertreiben	negative
überwachen	negative
überwachung	negative
überwinden	negative
überzeugen	positive
überzeugt	positive
üblich	negative
übrig	positive
übrigens	positive
übung	negative
üfa	negative
ümit	negative
‏	positive
→	positive
■	negative
▪	negative
►	negative
☀	positive
★	negative
☺	positive
♡	positive
♥	positive
♥♥	positive
♥♥♥	positive
♪	negative
♫	negative
✌	positive
✔	negative
❤	positive
❤❤	positive
❤❤❤	positive
➽	positive
